bigram,overall,he/him,she/her,they/them,he/they,she/they,multiple,pronoun list
**BIO_COUNT**,5444623,84145,120445,17905,9573,16282,2288,250638
of the,125138,2089,2009,277,153,227,42,4797
in the,97824,1423,1777,228,128,176,30,3762
i am,83551,1082,1406,291,106,202,36,3123
my own,80545,4096,5722,337,186,338,50,10729
are my,63782,2937,4033,230,118,249,38,7605
i love,61501,875,1492,225,110,184,28,2914
for the,57910,767,1008,123,60,78,16,2052
to be,52222,941,1187,149,113,140,22,2552
is a,52093,531,713,98,54,95,16,1507
gmail com,50608,1354,1248,282,172,260,22,3338
to the,46375,499,597,89,39,79,16,1319
just a,44381,1071,892,191,171,156,46,2527
i like,37890,1521,1527,295,168,273,43,3827
if you,35516,649,674,140,70,89,33,1655
the world,35439,442,545,64,27,68,10,1156
on the,35294,663,700,91,71,78,21,1624
lover of,35206,840,1821,115,59,117,19,2971
is the,34286,329,388,57,28,40,8,850
https //t,32468,871,622,108,58,71,18,1748
high school,31899,116,143,8,4,9,2,282
is my,31412,614,991,136,76,139,17,1973
trying to,31175,876,961,152,92,114,15,2210
and the,30366,511,573,61,30,50,10,1235
with a,30016,567,728,120,64,96,18,1593
i'm a,29358,577,598,131,56,72,25,1459
official twitter,27930,47,17,7,1,1,1,74
and i,27798,573,629,143,76,85,25,1531
husband father,27737,423,4,1,4,0,1,433
am a,27442,287,347,69,21,44,10,778
and a,26694,459,602,81,37,58,18,1255
i have,26342,581,753,122,66,104,20,1646
the best,26283,253,260,26,20,26,11,596
we are,25601,86,167,16,8,17,5,299
in a,25072,523,845,149,62,115,16,1710
opinions are,24899,1509,1792,111,62,125,10,3609
for a,24660,446,479,63,40,49,14,1091
follow me,23234,244,246,46,23,40,8,607
real estate,23085,27,37,0,1,0,0,65
all things,22481,322,574,49,20,37,7,1009
of a,22171,499,578,79,67,62,10,1295
of my,21978,515,690,72,47,77,11,1412
https //www,21873,328,259,62,28,31,12,720
father of,21157,311,5,4,6,0,2,328
here to,20892,349,517,99,45,79,9,1098
here for,20579,312,593,63,38,72,8,1086
this is,20367,429,630,109,50,98,23,1339
tweets are,20312,708,947,52,23,51,6,1787
to my,20053,260,427,65,36,53,7,848
looking for,19839,327,291,69,32,29,9,757
at the,19741,350,450,52,26,41,5,924
to make,19712,443,403,65,34,51,6,1002
fan of,19631,579,596,54,31,41,6,1307
from the,19294,266,224,36,27,34,6,593
i do,19212,547,565,145,82,113,26,1478
with the,18717,237,281,45,10,33,7,613
university of,18651,240,292,16,10,12,2,572
video games,18513,1380,790,169,108,151,24,2622
want to,18461,294,359,46,26,60,8,793
of all,18460,360,429,70,24,42,9,934
the official,18338,44,19,3,2,0,2,70
content creator,18048,454,289,84,39,72,3,941
my life,17957,195,385,39,19,36,12,686
in my,17921,308,512,74,34,60,10,998
have a,17766,338,420,77,33,49,14,931
love my,17764,130,222,29,16,20,1,418
http //www,17709,134,135,7,10,15,1,302
not a,17611,365,459,80,41,55,7,1007
me on,17500,209,268,52,31,38,8,606
you can,17097,215,325,64,31,48,12,695
love to,17078,154,193,25,19,15,4,410
http //twitch,17000,783,341,114,83,71,18,1410
for all,16978,185,306,22,16,19,3,551
life is,16758,121,257,24,14,19,3,438
i’m a,16687,255,407,71,44,59,15,851
twitter account,16531,81,59,11,4,3,2,160
be a,16070,364,469,64,30,66,9,1002
a lot,16037,700,962,148,81,139,18,2048
living in,15656,320,356,45,25,25,2,773
i can,15613,269,292,55,24,36,7,683
author of,15495,439,865,45,20,50,8,1427
views are,15007,742,1273,64,32,59,11,2181
owner of,14728,198,240,43,24,33,8,546
mom of,14531,0,676,8,0,27,4,715
all the,14482,227,421,41,31,26,7,753
sports fan,14339,217,150,2,7,3,1,380
do not,14252,403,546,154,66,88,14,1271
a good,13944,246,310,44,27,40,6,673
like to,13849,298,379,52,28,60,9,826
director of,13817,336,413,14,13,14,2,792
account for,13663,142,160,43,22,31,5,403
member of,13542,334,311,42,23,38,2,750
you are,13541,174,258,41,20,37,5,535
welcome to,13454,164,246,52,21,45,5,533
class of,13282,153,114,8,8,3,4,290
check out,13111,228,236,48,22,44,7,585
at a,12913,202,269,30,20,28,8,557
to get,12893,193,179,28,19,23,1,443
and more,12848,210,182,26,20,20,8,466
social media,12837,198,379,28,16,28,2,651
on my,12768,219,309,43,26,42,4,643
is to,12745,62,100,11,5,8,0,186
what i,12640,179,248,30,11,22,7,497
it is,12413,103,151,14,8,10,8,294
what you,12403,94,145,8,4,11,5,267
as a,12355,210,231,40,18,21,6,526
dm me,12354,227,198,65,29,40,5,564
account of,12333,106,46,11,20,10,6,199
i make,12301,616,512,147,81,114,26,1496
mother of,12197,7,398,12,1,14,0,432
founder of,12040,172,193,24,11,21,2,423
twitch affiliate,11994,784,633,121,81,135,14,1768
new york,11907,153,133,5,7,4,3,305
i don't,11812,325,329,69,35,47,16,821
i just,11812,281,362,63,36,58,6,806
i will,11807,181,251,38,25,28,8,531
married to,11801,300,385,70,21,45,14,835
of 2,11797,79,240,4,2,7,1,333
but i,11767,251,377,65,26,49,9,777
who loves,11752,235,288,36,27,30,8,624
is not,11600,146,193,23,19,19,6,406
just here,11386,163,289,47,23,43,6,571
of 3,11367,73,173,6,3,6,2,263
and my,11319,161,289,37,19,27,7,540
lives matter,11300,1306,1870,256,147,241,45,3865
to a,11286,154,266,17,11,19,4,471
i don’t,11267,178,316,46,19,40,9,608
on a,11207,214,251,37,29,30,10,571
dm for,11189,259,225,72,50,45,11,662
18 only,11136,875,466,261,155,147,48,1952
with my,11132,160,261,35,15,34,3,508
the most,11017,99,131,16,8,16,1,271
host of,10992,401,216,30,20,26,1,694
to help,10964,97,65,13,3,10,3,191
for my,10908,225,270,46,34,41,4,620
by the,10894,169,201,36,24,31,2,463
out of,10858,167,246,18,22,30,16,499
a time,10845,130,192,20,12,19,7,380
a little,10622,222,397,34,32,43,5,733
you want,10612,168,162,27,18,27,6,408
my family,10567,47,85,2,0,4,0,138
are not,10497,195,190,27,10,14,3,439
black lives,10456,1216,1845,239,138,233,44,3715
to do,10338,193,205,29,21,28,7,483
will be,10244,241,193,43,30,28,10,545
i was,10159,152,227,31,14,33,2,459
out now,10035,165,215,29,15,26,5,455
i want,10027,163,283,38,19,39,4,546
wife mom,9778,0,403,2,0,8,0,413
u s,9764,75,80,3,1,1,3,163
interested in,9711,282,319,20,19,20,6,666
father husband,9507,233,0,1,2,0,3,239
at http,9504,284,147,32,18,15,6,502
ceo of,9495,114,127,19,7,15,2,284
of life,9469,76,126,14,1,6,2,225
/ /,9433,127,198,33,36,42,5,441
one of,9413,137,126,17,14,23,1,318
my name,9348,211,213,59,24,46,14,567
music and,9272,258,202,32,24,27,8,551
the way,9255,95,138,13,5,14,1,266
http //instagram,9227,161,193,26,15,25,2,422
is an,9190,84,93,19,3,12,3,214
name is,9093,220,217,68,33,45,15,598
dedicated to,9001,12,35,4,2,0,1,54
year old,8985,255,202,78,41,39,19,634
business owner,8959,49,122,7,2,14,0,194
of god,8958,19,60,2,1,6,0,88
to see,8889,113,142,18,10,25,3,311
i play,8825,499,255,65,49,62,10,940
to live,8800,95,188,33,7,13,2,338
are mine,8774,518,628,30,21,34,4,1235
love the,8759,54,96,7,5,8,1,171
and all,8758,192,214,22,18,24,6,476
wife mother,8737,1,197,0,0,2,1,201
be the,8649,109,151,8,9,16,3,296
out my,8588,179,202,45,20,41,4,491
creator of,8573,328,258,53,28,51,5,723
call me,8506,315,383,166,65,97,27,1053
i also,8496,349,233,46,34,44,10,716
like a,8450,179,268,44,24,35,7,557
on twitch,8391,342,245,47,26,47,10,717
you know,8356,147,183,34,14,22,4,404
of two,8313,94,175,3,2,10,2,286
animal lover,8308,63,319,6,0,14,2,404
husband dad,8300,218,0,1,1,0,1,221
born and,8298,92,111,5,0,8,1,217
believe in,8288,94,139,8,5,7,3,256
i'm just,8264,211,192,42,24,32,13,514
husband and,8262,147,16,1,5,0,0,169
are a,8255,47,55,9,4,8,0,123
games and,8191,629,311,100,55,57,21,1173
about the,8099,134,194,19,7,14,1,369
to have,8096,101,106,25,8,9,3,252
state university,8084,80,88,8,3,3,0,182
r i,8074,24,28,8,3,4,1,68
are the,8064,86,119,8,9,16,0,238
i know,8019,145,203,38,14,31,5,436
live in,7909,98,124,9,12,11,2,256
software engineer,7851,640,246,45,20,38,11,1000
more than,7851,93,159,13,3,14,3,285
to me,7843,167,256,52,18,36,10,539
years old,7732,339,261,52,44,42,33,771
husband to,7708,162,0,1,8,0,1,172
i p,7660,17,21,3,3,2,0,46
my best,7655,182,312,61,19,48,7,629
lot of,7651,331,412,71,37,55,10,916
part of,7651,147,141,12,15,13,3,331
i’m just,7646,109,194,41,14,31,4,393
twitch streamer,7606,343,323,68,41,58,12,845
mom to,7605,3,461,4,0,15,3,486
for life,7577,71,131,16,1,8,4,231
and other,7571,317,207,46,22,19,9,620
me for,7548,129,137,34,15,29,6,350
this account,7500,142,135,28,24,25,9,363
make it,7466,85,127,18,10,9,2,251
can be,7446,144,117,25,24,24,7,341
mental health,7433,202,539,53,20,50,8,872
life and,7433,55,80,10,3,7,1,156
sports and,7432,91,53,4,2,1,2,153
i tweet,7405,265,316,42,18,31,5,677
you have,7389,106,107,17,11,11,4,256
for you,7378,62,105,13,11,9,5,205
follower of,7372,32,37,4,2,1,0,76
passionate about,7332,96,284,7,7,13,0,407
to know,7282,67,103,15,6,9,1,201
follow my,7276,110,106,30,14,13,1,274
graphic designer,7191,262,305,45,29,38,7,686
the future,7185,69,82,7,7,16,1,182
and raised,7157,78,91,5,0,5,1,180
on instagram,7148,81,186,30,9,28,5,339
no dms,7131,28,222,11,1,7,1,270
how to,7127,135,165,30,17,26,2,375
by day,7121,267,329,30,9,41,2,678
my tweets,7114,229,211,26,15,12,3,496
on ig,7041,53,154,25,8,22,3,265
family and,6900,25,34,2,1,1,0,63
a better,6896,137,153,10,12,12,1,325
dog mom,6888,4,787,7,1,36,4,839
the only,6847,94,101,16,10,17,2,240
full time,6817,149,241,46,26,34,6,502
i write,6809,381,496,80,34,64,6,1061
in life,6793,69,78,6,7,9,1,170
and love,6789,54,104,18,17,7,4,204
if i,6783,127,200,35,20,35,4,421
link below,6756,73,120,13,9,23,1,239
just trying,6743,165,221,48,21,40,2,497
when i,6742,128,164,30,19,27,4,372
of your,6697,76,110,13,7,12,5,223
home of,6692,28,21,5,4,3,1,62
living life,6690,41,60,7,1,7,0,116
me and,6686,61,77,15,4,12,1,170
with me,6662,81,151,21,9,18,6,286
there is,6652,82,115,12,5,6,1,221
for more,6623,53,81,15,14,8,2,173
me i,6598,68,105,24,8,23,1,229
a new,6579,80,84,12,4,10,0,190
i'm not,6518,162,140,31,12,16,5,366
looking to,6512,101,54,14,15,10,1,195
have to,6488,90,108,10,7,9,4,228
a guy,6488,173,11,2,15,0,6,207
that i,6477,133,135,20,9,17,5,319
specializing in,6471,46,68,5,3,4,1,127
working on,6464,354,238,47,26,27,10,702
have fun,6452,71,60,15,4,8,2,160
the link,6434,63,84,15,5,18,2,187
on twitter,6428,161,112,16,13,18,2,322
in this,6419,85,161,21,13,19,3,302
born in,6398,87,75,12,6,8,3,191
the time,6359,172,190,38,15,21,7,443
twitter page,6358,11,11,0,0,0,0,22
happily married,6357,86,119,11,2,9,1,228
me to,6355,106,126,37,13,21,4,307
i live,6325,88,127,19,10,6,3,253
no one,6306,123,145,12,11,18,7,316
de la,6298,3,11,1,0,0,0,15
need to,6267,70,100,19,8,12,2,211
that is,6254,76,100,8,8,13,3,208
music lover,6242,113,208,11,11,11,0,354
los angeles,6235,76,67,5,8,10,0,166
god first,6232,11,23,0,0,3,0,37
one day,6230,109,108,16,13,19,3,268
the same,6227,101,132,15,7,13,5,273
for fun,6217,133,113,24,7,13,7,297
be kind,6204,187,337,24,10,30,2,590
every day,6201,80,114,9,4,4,2,213
all of,6181,88,108,20,7,15,3,241
twitter of,6176,21,12,4,1,5,0,43
mom wife,6168,1,416,0,0,6,0,423
follow back,6149,69,77,10,3,7,3,169
all my,6146,139,174,27,13,25,4,382
for your,6145,69,64,11,2,6,0,152
in love,6139,98,259,32,21,47,3,460
raised in,6130,67,75,3,0,7,2,154
dog lover,6075,84,203,8,2,4,1,302
fan and,5968,129,80,14,4,4,5,236
i’m not,5939,102,167,25,11,26,3,334
on youtube,5934,130,72,9,14,13,2,240
in your,5927,86,112,21,14,12,0,245
i enjoy,5911,167,106,17,8,14,3,315
http //bit,5906,121,107,10,6,9,2,255
wife and,5900,29,125,5,0,2,1,162
love and,5886,60,145,14,8,14,6,247
when you,5875,44,66,10,4,10,0,134
a man,5850,92,25,12,6,9,2,146
advocate for,5849,110,233,7,5,10,4,369
is what,5839,42,82,4,2,6,3,139
fan account,5830,139,723,35,17,41,8,963
of jesus,5829,24,30,1,0,4,0,59
http //youtube,5820,168,65,17,13,6,2,271
i believe,5802,64,132,7,7,6,3,219
god family,5800,4,4,0,0,0,0,8
official account,5758,8,17,1,3,2,1,32
you will,5755,73,62,14,9,10,3,171
star wars,5752,445,292,27,18,31,10,823
your own,5742,46,62,4,6,7,1,126
of 4,5676,32,64,7,0,2,0,105
to find,5653,82,97,13,7,15,2,216
going to,5638,98,125,26,5,12,1,267
make a,5636,77,117,15,6,15,3,233
god is,5625,22,19,2,1,2,0,46
as well,5608,96,77,12,9,9,2,205
the truth,5548,15,40,4,1,5,0,65
the people,5543,66,80,12,5,9,2,174
those who,5523,48,64,8,1,4,1,126
the university,5521,69,67,3,4,2,0,145
a big,5516,130,114,28,10,14,6,302
who is,5498,90,103,26,18,21,7,265
and father,5461,90,2,0,3,0,0,95
so i,5447,92,157,26,13,14,3,305
you need,5445,63,85,19,5,7,0,179
not the,5423,130,144,11,8,10,4,307
of our,5419,23,33,5,2,2,0,65
jesus christ,5410,14,15,1,0,4,0,34
i think,5401,145,196,27,22,28,5,423
your life,5398,37,59,5,3,4,0,108
cash app,5397,45,81,19,11,11,2,169
follow us,5397,4,6,1,1,0,0,12
we have,5376,39,47,1,0,3,0,90
news and,5342,23,25,2,0,1,1,52
pfp by,5322,881,551,243,205,168,37,2085
https //linktr,5315,116,112,35,22,21,4,310
i got,5311,92,91,19,10,12,1,225
dad husband,5299,217,0,1,0,0,0,218
do it,5290,56,80,8,3,12,1,160
youtube channel,5287,64,36,3,3,8,1,115
tweet about,5282,226,251,21,18,14,1,531
too much,5260,269,325,60,34,39,7,734
coach at,5257,9,17,0,0,0,0,26
i follow,5246,91,79,10,8,17,2,207
to learn,5230,93,94,7,8,8,0,210
the right,5206,65,60,12,2,3,2,144
artist and,5204,248,293,111,48,56,23,779
my favorite,5201,100,154,17,5,18,1,295
coming soon,5187,59,67,16,9,9,0,160
pop culture,5180,198,374,14,8,17,3,614
your favorite,5180,76,84,30,12,17,3,222
father to,5177,63,0,0,1,1,0,65
opinions my,5163,441,562,34,18,40,4,1099
also a,5154,155,126,16,14,15,5,331
a great,5092,39,53,5,2,5,2,106
dms open,5090,470,179,73,72,40,14,848
proud father,5082,57,0,3,1,0,0,61
into the,5079,140,226,27,12,28,3,436
sometimes i,5066,246,338,58,37,56,10,745
talk about,5058,200,272,45,27,45,2,591
us at,5058,4,1,2,0,0,0,7
to your,5037,25,55,5,4,7,1,97
all opinions,5034,296,445,38,16,31,4,830
on all,5034,41,44,6,4,11,1,107
all about,5023,47,60,7,2,3,2,121
art and,5010,238,267,86,58,50,16,715
it all,5007,52,98,12,5,5,3,175
help you,5000,19,13,3,0,1,0,36
am the,4997,73,75,19,4,15,2,188
- -,4971,174,173,56,28,79,4,514
for me,4961,61,92,12,10,10,5,190
video game,4956,419,194,48,33,32,10,736
views my,4936,322,632,24,20,25,4,1027
better than,4928,78,89,6,2,7,1,183
small business,4919,24,93,6,2,9,0,134
not endorsements,4913,84,96,7,1,4,2,194
on here,4903,131,122,17,11,20,3,304
my wife,4883,85,68,18,3,11,4,189
to play,4881,137,76,6,6,9,1,235
by night,4858,212,234,25,9,31,2,513
focused on,4854,60,61,4,2,8,0,135
used to,4851,173,156,9,13,17,6,374
based in,4841,63,74,8,5,11,1,162
years of,4839,46,26,15,5,7,5,104
co-host of,4835,358,215,28,12,17,4,634
im a,4833,63,61,19,12,14,3,172
life to,4822,17,29,2,0,3,0,51
page of,4821,7,7,0,0,1,0,15
love you,4799,45,127,20,4,16,1,213
guy who,4795,192,4,2,9,0,3,210
and not,4787,142,116,16,6,14,3,297
try to,4786,145,92,16,10,13,4,280
my heart,4785,47,155,13,6,25,1,247
my opinions,4775,241,206,19,12,20,0,498
professor of,4773,160,205,11,1,9,0,386
part time,4763,114,150,39,23,25,5,356
i work,4740,153,120,17,6,17,3,316
m s,4728,48,70,5,10,4,2,139
located in,4710,8,9,3,1,1,1,23
n o,4698,8,14,1,2,1,0,26
you don't,4694,61,75,16,7,10,2,171
time to,4694,69,62,11,6,5,2,155
subscribe to,4685,31,24,2,2,2,0,61
//www instagram,4679,62,51,3,4,3,4,127
to you,4673,55,62,13,2,15,2,149
head coach,4671,10,8,1,0,0,0,19
father and,4660,56,0,0,1,0,0,57
to all,4655,80,86,13,4,5,1,189
die hard,4650,15,13,2,1,3,1,35
and music,4641,164,110,23,15,15,7,334
president of,4634,82,93,9,3,6,1,194
and proud,4611,98,100,35,15,19,3,270
human rights,4606,271,374,41,18,39,9,752
writer and,4602,243,255,51,17,27,11,604
living the,4596,35,49,2,1,1,1,89
dad to,4591,162,0,2,4,0,1,169
nsfw 18,4581,365,143,86,53,47,20,714
all i,4581,60,121,31,10,30,4,256
the new,4578,53,47,6,4,5,1,116
around the,4562,26,23,5,2,5,0,61
you to,4534,37,59,11,5,8,0,120
of christ,4534,13,12,1,2,3,0,31
listen to,4512,105,100,18,11,18,1,253
own and,4506,246,193,18,12,14,3,486
do you,4503,64,86,15,6,19,0,190
loves to,4503,58,85,10,6,9,4,172
all around,4502,147,125,18,16,17,6,329
united states,4502,17,19,3,0,1,0,40
a m,4497,42,46,3,3,4,0,98
in all,4488,38,72,6,8,8,0,132
just an,4479,98,96,27,14,8,4,247
i post,4474,181,172,52,33,32,1,471
dad of,4473,103,0,0,3,0,2,108
in that,4454,123,125,7,1,5,4,265
committed to,4453,24,58,4,1,6,0,93
free to,4426,144,111,33,23,14,4,329
being a,4404,91,109,10,13,15,2,240
love with,4395,76,179,21,18,39,2,335
the year,4385,60,65,7,3,4,0,139
find me,4383,96,174,17,10,20,3,320
believer in,4383,53,145,5,2,5,1,211
me a,4380,101,110,24,8,18,1,262
to say,4376,97,102,18,4,14,4,239
know what,4374,86,127,20,10,22,4,269
//www youtube,4373,51,21,4,6,1,0,83
supporter of,4362,71,97,10,6,4,0,188
i say,4352,91,89,21,5,20,1,227
love god,4343,7,16,1,0,1,0,25
we can,4337,52,66,2,6,6,7,139
http //linktr,4332,147,143,26,16,24,5,361
work in,4324,138,203,20,5,12,1,379
just your,4319,137,127,29,18,16,6,333
of it,4318,65,81,12,5,9,1,173
the internet,4311,216,176,31,21,23,3,470
good time,4310,52,106,16,7,15,3,199
are you,4310,63,84,9,6,11,0,173
is life,4306,62,75,8,4,14,2,165
and sports,4303,40,30,5,1,0,0,76
new to,4292,113,82,11,16,11,1,234
school of,4288,61,82,4,2,3,0,152
but not,4254,135,125,20,11,23,1,315
the good,4252,45,81,6,3,11,3,149
you do,4251,35,54,4,4,3,0,100
love of,4247,56,85,10,3,9,2,165
the latest,4243,4,4,0,0,0,0,8
child of,4233,26,70,13,4,10,2,125
phd student,4229,297,567,56,26,50,5,1001
as i,4219,76,95,13,11,14,0,209
full of,4215,82,166,33,13,24,3,321
through the,4215,41,47,8,6,8,3,113
make the,4213,98,105,15,7,8,1,234
business inquiries,4212,202,120,23,18,24,3,390
you don’t,4206,67,89,13,6,9,1,185
way to,4204,46,57,7,2,5,0,117
i'm an,4193,115,131,24,13,15,7,305
to follow,4191,77,63,17,10,15,0,182
let me,4186,79,86,20,7,11,0,203
and have,4185,50,61,10,5,9,1,136
financial advice,4177,3,8,0,2,0,0,13
up to,4174,55,45,9,3,7,1,120
the one,4168,51,54,6,4,10,2,127
com http,4164,88,84,19,9,16,1,217
and i'm,4155,100,119,31,15,16,2,283
go to,4152,58,94,12,4,8,1,177
to talk,4142,120,123,30,10,12,0,295
lots of,4127,184,250,33,21,37,5,530
with an,4117,87,110,17,8,5,3,230
obsessed with,4088,132,326,44,17,36,9,564
the next,4083,38,37,7,0,5,0,87
me if,4073,99,73,21,8,11,3,215
is good,4069,45,38,6,6,5,4,104
san diego,4069,43,48,3,3,1,1,99
live life,4054,13,23,4,2,2,0,44
bay area,4050,79,90,7,7,9,1,193
love is,4049,79,214,12,6,9,0,320
social justice,4045,165,353,45,15,29,6,613
to keep,4034,51,88,9,4,4,0,156
source for,4032,6,3,0,1,0,0,10
has been,4028,29,21,5,1,2,1,59
i hate,4022,92,129,11,8,16,5,261
who likes,4013,186,113,44,27,24,5,399
know me,4012,78,80,26,12,15,1,212
i get,3996,68,115,19,10,15,1,228
friends and,3995,56,44,14,7,5,2,128
a girl,3990,11,190,17,4,19,2,243
on this,3990,71,92,23,12,9,1,208
that order,3985,112,108,6,1,3,3,233
my mind,3985,53,104,10,8,16,0,191
am an,3984,56,70,15,7,4,3,155
the real,3973,36,42,5,3,8,0,94
basketball coach,3965,4,4,0,1,0,0,9
kind of,3958,116,151,30,19,11,1,328
us army,3956,37,21,3,1,0,0,62
state of,3951,39,53,12,4,7,0,115
about it,3941,126,145,23,13,15,2,324
am not,3921,63,77,7,6,15,1,169
have been,3908,57,39,4,3,4,1,108
a few,3897,81,63,3,3,6,1,157
family man,3894,34,0,0,0,2,0,36
with your,3893,21,37,8,4,4,0,74
like the,3890,87,122,19,7,13,3,251
love all,3884,47,77,7,2,5,2,140
award winning,3882,60,60,10,5,6,1,142
where i,3879,100,116,19,10,15,1,261
passion for,3877,50,66,9,4,4,1,134
football coach,3875,5,1,0,0,0,0,6
my youtube,3870,41,31,4,0,3,0,79
no minors,3866,453,305,135,117,73,26,1109
army veteran,3841,38,30,2,1,0,0,71
cancer survivor,3835,54,133,6,2,9,0,204
to share,3834,50,45,10,4,8,1,118
twitter for,3823,34,40,7,6,5,2,94
most of,3821,112,84,12,9,11,6,234
ready to,3821,44,80,19,5,7,2,157
co-founder of,3820,132,105,13,5,10,2,267
the fullest,3817,11,13,1,0,0,0,25
what it,3811,23,48,3,3,6,2,85
feel free,3802,139,101,34,21,13,4,312
things i,3794,112,134,26,21,26,4,323
who i,3786,47,65,8,4,2,1,127
cat mom,3782,1,768,19,0,91,5,884
ask me,3782,120,153,35,14,31,6,359
out the,3774,30,52,4,1,4,2,93
me in,3764,69,111,9,5,24,0,218
i need,3760,58,86,15,6,14,4,183
us on,3753,5,6,1,1,0,0,13
and make,3752,94,74,15,8,13,4,208
link in,3752,28,31,14,0,11,2,86
the greatest,3751,23,22,0,2,2,1,50
the day,3743,58,54,8,7,5,2,134
can do,3732,37,55,9,3,2,2,108
the first,3732,38,43,4,2,5,0,92
that loves,3730,49,37,7,6,8,2,109
page for,3722,13,11,5,3,0,1,33
head of,3709,131,96,3,7,8,0,245
middle school,3709,31,111,1,2,3,1,149
keep it,3707,28,39,5,4,2,1,79
the lord,3705,7,10,1,0,1,0,19
assistant professor,3703,189,273,6,5,12,0,485
a real,3703,60,65,13,6,6,0,150
https //onlyfans,3692,25,36,14,6,4,1,86
back to,3690,36,59,4,5,3,0,107
fun and,3689,45,38,8,4,1,1,97
family friends,3674,7,26,0,0,0,0,33
in bio,3673,101,101,42,30,40,3,317
for our,3673,10,26,1,2,3,1,43
and do,3669,134,122,15,8,13,3,295
thank you,3667,56,70,15,6,11,3,161
to create,3664,28,32,9,3,6,0,78
my country,3663,5,10,1,0,0,0,16
i help,3657,48,44,2,2,4,1,101
not to,3656,64,93,15,8,16,0,196
up for,3656,53,56,3,4,10,1,127
the end,3655,51,71,10,3,12,0,147
so much,3653,60,112,12,4,10,1,199
las vegas,3649,17,24,1,0,2,0,44
nft collector,3640,7,17,0,1,0,0,25
the game,3637,39,29,8,6,4,2,88
from a,3612,61,68,18,7,11,3,168
life in,3610,32,65,6,0,1,2,106
to meet,3606,67,50,8,6,12,2,145
a beautiful,3605,16,37,0,2,6,0,61
4 13,3582,3,10,0,0,0,0,13
lover and,3579,65,113,9,8,9,0,204
the dream,3570,27,36,3,0,0,0,66
to go,3568,35,58,5,3,7,2,110
pok mon,3565,328,172,42,49,29,5,625
proud to,3559,27,42,3,2,2,0,76
that you,3556,40,55,7,3,4,0,109
just another,3546,112,90,20,10,12,1,245
need help,3546,7,6,2,0,0,0,15
god bless,3536,2,2,0,0,0,0,4
health and,3535,26,70,1,3,3,0,103
mission is,3535,0,1,1,0,0,0,2
people and,3526,53,71,7,5,4,0,140
and you,3526,54,53,8,5,10,1,131
master of,3525,103,95,16,5,9,2,230
of me,3523,70,76,14,6,12,1,179
work hard,3521,10,19,1,0,0,0,30
on your,3520,58,52,4,6,5,1,126
a long,3517,39,85,5,4,11,2,146
best friend,3514,73,75,16,2,5,3,174
my employer,3506,210,232,22,8,10,5,487
world traveler,3505,25,86,0,1,0,0,112
expressed are,3499,166,145,7,4,5,5,332
icon by,3495,607,506,291,145,157,43,1749
of music,3494,93,88,10,6,5,1,203
the love,3488,35,81,6,4,8,3,137
you like,3487,75,75,8,10,9,3,180
love me,3485,40,47,15,6,7,0,115
day at,3483,42,57,9,6,5,2,121
mom and,3481,4,156,1,0,6,0,167
ph d,3480,113,202,13,3,13,3,347
talk to,3478,116,134,36,7,20,5,318
i draw,3472,291,354,137,73,90,21,966
about my,3470,80,213,33,13,22,0,361
this world,3468,53,63,6,6,4,0,132
writer for,3464,207,127,17,9,9,1,370
to love,3459,62,82,11,4,7,3,169
i stream,3458,175,98,29,22,26,9,359
me at,3458,85,97,22,8,9,5,226
politics and,3456,166,134,14,10,5,3,332
of three,3454,27,62,3,1,1,1,95
up and,3452,60,37,7,4,7,1,116
food and,3445,74,92,14,3,6,1,190
in new,3444,52,59,3,3,2,0,119
they are,3442,50,58,6,5,10,0,129
you get,3440,43,39,6,5,7,1,101
proud american,3436,9,3,0,1,0,1,14
and video,3435,218,130,36,26,32,2,444
as the,3434,53,47,5,0,1,2,108
get the,3433,32,54,9,2,7,1,105
do what,3428,26,59,7,2,6,1,101
a small,3422,41,79,12,2,5,1,140
follow for,3421,54,47,9,7,12,1,130
20 years,3410,59,44,10,16,4,8,141
music producer,3402,66,20,18,12,7,1,124
of things,3398,156,188,38,15,24,5,426
financial advisor,3385,5,4,0,0,0,0,9
your average,3381,96,94,19,8,9,6,232
hip hop,3376,28,26,2,2,3,0,61
just me,3375,26,46,5,5,4,1,87
i’m here,3373,44,94,13,10,12,6,179
join us,3372,3,2,3,1,0,0,9
was a,3370,69,88,13,7,11,1,189
in our,3369,20,19,3,0,1,0,43
have the,3365,52,62,8,6,9,2,139
//www twitch,3360,85,40,15,9,12,4,165
and family,3354,14,19,1,1,1,0,36
with you,3353,49,71,8,3,10,2,143
the usa,3353,23,16,3,0,1,0,43
is for,3350,70,68,9,7,8,1,163
my thoughts,3349,68,105,8,11,15,0,207
because i,3345,73,79,12,8,6,0,178
the us,3338,39,39,2,4,3,0,87
grad student,3328,163,354,31,24,40,7,619
focus on,3322,40,51,6,4,3,1,105
world of,3317,44,39,9,2,3,1,98
bit of,3314,92,111,13,11,15,4,246
student of,3314,54,75,7,1,6,0,143
my kids,3313,23,59,0,0,0,1,83
click the,3312,24,39,4,2,11,0,80
working to,3310,51,74,6,2,1,0,134
all views,3308,151,308,24,8,21,4,516
god and,3301,11,20,1,1,0,2,35
phd candidate,3300,245,493,24,22,40,3,827
the moon,3294,31,88,12,3,15,0,149
the great,3287,37,42,3,0,2,1,85
my way,3285,56,67,8,4,11,2,148
common sense,3284,11,31,0,0,0,1,43
the life,3282,16,28,6,0,0,0,50
long time,3276,44,68,5,7,10,3,137
d d,3271,579,383,102,49,65,12,1190
has a,3264,62,65,5,11,6,1,150
the city,3264,22,31,2,1,1,1,58
writer of,3262,231,345,31,16,29,5,657
people who,3258,40,47,1,4,2,2,96
a fan,3255,58,91,9,5,7,0,170
living my,3254,19,48,8,1,4,2,82
me up,3252,68,40,6,4,4,1,123
likes to,3248,117,84,27,13,16,0,257
is no,3246,39,56,3,3,2,2,105
no matter,3246,26,37,2,0,5,0,70
https //youtu,3245,27,29,1,2,6,3,68
not financial,3242,3,4,0,1,0,0,8
what is,3236,47,47,7,3,3,5,112
to take,3236,35,48,4,6,12,0,105
- i,3234,188,159,35,25,21,5,433
my friends,3234,107,83,19,12,20,3,244
new account,3231,31,41,6,4,7,0,89
la vida,3228,7,19,1,0,3,0,30
music is,3222,44,65,6,1,0,1,117
have no,3217,64,109,20,10,15,5,223
s s,3217,9,33,6,4,1,0,53
should be,3211,76,79,9,7,10,2,183
at heart,3205,61,110,9,4,3,2,189
love for,3204,36,88,10,6,8,2,150
is in,3203,40,41,9,5,9,1,105
- http,3186,91,44,11,10,8,0,164
stan account,3183,143,313,21,28,37,5,547
a very,3179,69,86,17,6,12,2,192
christ follower,3178,11,16,0,0,1,0,28
each other,3175,129,110,14,11,12,2,278
gamer and,3175,146,94,15,11,7,3,276
crypto enthusiast,3174,4,7,0,1,0,0,12
movies and,3165,131,88,9,2,9,1,240
a proud,3164,23,33,4,0,3,1,64
not my,3155,143,133,14,7,8,3,308
and be,3155,50,67,8,4,6,0,135
digital marketing,3154,25,63,0,2,2,1,93
best life,3152,24,52,8,2,2,1,89
man of,3150,46,4,2,2,0,0,54
city of,3148,16,24,1,0,0,0,41
up in,3145,40,53,7,4,9,0,113
personal account,3142,197,250,39,19,21,7,533
you love,3141,33,63,8,4,9,0,117
yahoo com,3137,32,25,5,6,8,0,76
any pronouns,3135,32,20,32,9,6,5,104
us for,3135,1,3,0,0,0,1,5
at https,3130,92,37,6,0,1,3,139
are open,3127,206,123,41,34,32,5,441
account is,3121,110,103,34,18,23,8,296
tweets in,3121,19,20,1,1,3,0,44
to work,3118,41,40,4,5,6,1,97
having fun,3112,42,32,3,5,5,1,88
you think,3109,48,58,9,5,8,0,128
will not,3109,40,72,5,2,7,1,127
don't know,3106,78,78,15,10,13,2,196
to our,3103,8,8,0,1,1,0,18
of an,3100,58,92,12,1,12,1,176
long live,3095,20,21,4,1,1,0,47
student at,3088,153,184,21,11,19,4,392
board member,3088,98,120,8,3,5,1,235
of this,3087,43,75,9,5,10,1,143
of http,3086,78,35,6,2,6,0,127
red sox,3078,38,42,1,0,4,0,85
air force,3076,28,24,1,1,2,0,56
for over,3076,9,6,0,0,0,0,15
and get,3073,25,27,6,2,2,1,63
like it,3071,47,47,6,5,6,0,111
anime and,3068,155,147,37,11,30,4,384
dog dad,3065,295,2,4,17,0,2,320
don’t know,3058,66,98,10,6,14,4,198
if you're,3053,114,82,24,9,15,9,253
i'm the,3052,69,74,15,6,10,0,174
wife to,3051,1,169,2,0,5,1,178
to become,3048,47,52,9,3,6,1,118
is your,3045,16,23,5,2,0,0,46
does not,3039,40,55,5,5,3,0,108
http //discord,3038,73,37,12,8,8,0,138
get to,3036,37,46,9,6,2,0,100
is all,3027,29,59,5,4,3,4,104
a world,3019,36,59,8,6,8,0,117
make you,3018,41,62,9,3,1,2,118
just be,3016,59,75,14,7,14,1,170
all day,3014,42,49,7,2,4,0,104
a life,3014,30,49,3,3,3,1,89
public health,3013,75,256,13,2,11,3,360
open to,3009,91,56,22,15,13,6,203
husband of,3007,101,0,0,1,0,0,102
if you’re,3006,61,89,23,12,11,7,203
life i,3006,32,43,4,1,1,0,81
our mission,3006,0,1,0,0,0,0,1
i guess,3004,154,116,37,28,18,3,356
follow this,3003,4,4,1,2,1,0,12
and an,3001,66,65,9,4,2,3,149
join the,3001,22,21,3,4,4,1,55
the united,2996,14,10,2,1,1,0,28
san francisco,2993,49,41,5,1,3,0,99
hi i'm,2991,119,215,66,33,48,15,496
avid reader,2987,45,206,5,1,8,1,266
down to,2986,36,32,8,6,7,2,91
i'm here,2985,62,51,18,10,6,2,149
voice actor,2982,377,146,48,61,41,8,681
the universe,2975,61,66,7,6,13,2,155
look at,2974,62,67,9,2,16,1,157
christian husband,2969,11,0,0,0,0,0,11
things that,2967,82,88,9,4,13,0,196
sports fanatic,2961,25,16,0,0,1,0,42
son of,2957,69,3,2,2,0,1,77
not be,2955,63,66,6,5,9,2,151
my dog,2952,54,193,7,4,8,6,272
wife of,2951,2,147,3,1,7,2,162
love music,2949,35,35,6,3,4,0,83
football and,2947,17,16,2,0,0,0,35
a bit,2945,112,120,29,13,17,6,297
known as,2937,65,70,17,11,20,2,185
i hope,2937,64,70,10,13,11,3,171
an artist,2935,85,123,40,22,29,13,312
craft beer,2934,61,57,2,2,3,0,125
banner by,2931,557,248,137,83,96,26,1147
pro wrestling,2927,120,37,7,8,8,1,181
good vibes,2927,36,39,10,9,10,1,105
and to,2926,38,48,6,6,2,0,100
new yorker,2924,77,158,2,1,7,0,245
born raised,2914,33,90,1,0,5,1,130
views expressed,2912,126,119,4,3,10,1,263
world is,2909,46,56,8,7,3,2,122
st louis,2909,29,30,3,0,1,1,64
got a,2906,54,73,10,4,12,0,153
you can't,2903,41,55,4,3,1,0,104
i only,2902,64,94,13,4,16,0,191
of 1,2896,15,45,1,2,2,0,65
and i’m,2893,59,96,18,14,16,5,208
30 years,2890,16,28,1,0,4,1,50
army vet,2888,38,27,4,0,0,0,69
enthusiast and,2887,124,95,21,7,13,4,264
college of,2885,27,50,4,1,2,1,85
change the,2883,30,50,5,1,2,2,90
enjoy the,2883,20,34,3,2,5,2,66
tweet us,2881,0,0,0,0,0,0,0
the rest,2879,43,61,5,4,2,1,116
add me,2878,49,16,7,3,5,1,81
about me,2876,37,62,11,4,11,1,126
big fan,2872,111,152,18,6,10,1,298
http //facebook,2872,3,19,1,1,0,0,24
for business,2871,90,47,10,7,10,0,164
wants to,2870,82,77,14,13,11,5,202
enough to,2869,64,75,7,7,7,0,160
the american,2869,26,21,2,0,0,0,49
creative director,2868,73,57,11,3,6,0,150
my passion,2866,31,49,4,5,5,0,94
give me,2861,65,74,12,6,11,3,171
much more,2861,27,57,6,2,9,0,101
books and,2855,78,225,14,8,13,3,341
do the,2845,65,60,9,4,6,2,146
a living,2830,93,78,18,7,10,2,208
fantasy football,2827,30,9,0,0,0,0,39
proud member,2825,47,52,13,4,7,0,123
just want,2823,77,70,10,4,17,0,178
in nyc,2820,62,86,9,5,4,2,168
the power,2820,30,47,7,1,6,1,92
to travel,2819,17,30,2,1,1,0,51
i talk,2818,120,169,20,13,29,2,353
to 3,2818,25,51,1,0,1,0,78
college student,2816,136,116,30,27,13,4,326
side of,2816,60,62,9,8,11,3,153
love life,2814,5,16,0,1,2,0,24
here are,2813,138,112,6,4,7,7,274
it out,2808,49,61,7,10,14,2,143
at all,2806,53,49,12,5,8,1,128
up with,2804,38,54,5,3,6,0,106
to build,2800,25,22,3,2,0,0,52
digital artist,2797,167,247,76,44,66,8,608
to read,2797,31,124,10,1,8,1,175
proud mom,2796,0,105,1,0,3,0,109
school district,2796,6,13,0,0,0,0,19
the sun,2791,26,75,14,7,10,0,132
fighting for,2787,62,110,5,6,5,0,188
now i,2783,71,71,9,10,4,0,165
some of,2779,64,44,9,5,6,1,129
work for,2775,59,52,5,2,3,4,125
to provide,2775,6,4,3,0,0,0,13
political junkie,2774,61,83,1,1,0,1,147
science and,2773,91,107,8,3,4,3,216
all your,2772,18,36,1,0,5,1,61
give up,2771,12,27,3,1,3,0,46
my new,2762,38,34,11,0,2,0,85
loving life,2760,12,22,0,1,1,0,36
and lover,2758,64,110,9,2,9,2,196
we all,2755,44,45,8,1,2,1,101
is just,2754,43,72,12,2,11,1,141
be happy,2753,22,43,4,1,4,0,74
18 nsfw,2751,180,111,42,41,27,10,411
well as,2747,33,25,5,5,5,1,74
am i,2746,74,104,21,8,15,1,223
me out,2745,45,42,5,5,7,2,106
always be,2740,31,52,3,3,5,0,94
sports enthusiast,2738,19,27,1,1,1,0,49
a simple,2737,48,38,10,4,6,1,107
sense of,2733,36,64,5,0,6,1,112
it was,2731,37,60,5,5,4,0,111
//www facebook,2724,5,7,1,0,0,0,13
trump supporter,2723,1,6,0,0,0,0,7
don’t be,2722,47,56,7,5,9,1,125
help tweet,2721,0,0,0,0,0,0,0
job tweets,2719,0,0,0,0,0,0,0
tweets my,2718,129,282,10,7,10,1,439
affiliated with,2718,37,33,3,2,6,1,82
to give,2718,22,42,1,3,2,1,71
teacher and,2716,43,60,0,1,4,2,110
b s,2715,62,73,8,6,8,0,157
addicted to,2714,74,91,9,3,7,0,184
http //onlyfans,2713,21,38,18,5,4,1,87
thoughts are,2708,123,189,19,6,18,1,356
and friends,2708,21,18,2,3,2,0,46
life with,2705,23,40,4,1,4,0,72
the u,2705,21,24,0,1,1,1,48
but you,2704,55,55,9,4,11,7,141
my twitter,2702,64,82,13,2,11,0,172
too many,2700,160,249,36,13,32,4,494
are all,2700,57,105,6,3,5,2,178
i see,2700,22,48,5,2,6,2,85
my views,2699,123,173,13,5,10,3,327
executive director,2696,66,94,1,1,2,1,165
make me,2696,34,86,8,5,8,3,144
with all,2696,30,52,8,1,3,1,95
who are,2696,21,23,3,3,1,0,51
department of,2696,21,9,1,0,0,0,31
over the,2694,28,45,5,5,4,1,88
for geo-targeted,2689,0,0,0,0,0,0,0
at careerarc,2689,0,0,0,0,0,0,0
and everything,2688,40,38,6,6,3,1,94
proud dad,2686,37,0,0,0,0,1,38
need a,2683,45,61,12,2,5,0,125
the heart,2677,22,23,1,1,1,0,48
we do,2675,17,30,3,2,3,2,57
to change,2673,26,44,3,2,5,0,80
other things,2668,158,127,16,20,9,5,335
estate agent,2666,2,6,0,0,0,0,8
by a,2662,52,57,8,6,6,2,131
of 5,2661,13,33,1,0,0,0,47
and opinions,2660,124,119,7,7,4,2,263
you and,2659,26,34,7,4,5,2,78
get it,2658,20,35,4,0,4,0,63
will never,2655,22,38,8,2,6,3,79
all tweets,2654,91,111,6,4,10,0,222
all that,2654,44,60,9,4,3,0,120
a mom,2647,1,91,1,0,3,0,96
heart of,2646,32,37,4,3,2,0,78
serving the,2645,6,7,0,0,1,0,14
get a,2641,41,50,5,5,9,1,111
people to,2639,29,22,3,1,1,1,57
a huge,2638,47,55,9,6,7,3,127
a passion,2637,35,56,7,4,2,1,105
i go,2636,71,90,23,21,17,7,229
- the,2636,29,35,6,3,7,0,80
twitter is,2632,65,70,15,4,12,1,167
you see,2632,37,44,7,4,1,4,97
and now,2630,42,55,4,2,8,3,114
may be,2618,104,70,23,15,24,4,240
lo que,2618,3,6,2,0,1,0,12
m a,2617,37,77,7,2,7,2,132
wanna be,2616,59,98,15,6,11,1,190
real life,2615,54,88,13,1,10,0,166
penn state,2613,44,60,3,0,4,0,111
https //youtube,2609,32,13,4,0,0,1,50
not necessarily,2601,86,72,2,2,2,5,169
if u,2600,26,46,25,7,13,1,118
manager for,2597,93,76,9,7,11,0,196
health care,2593,25,61,4,1,1,0,92
the beach,2593,17,35,6,2,5,1,66
it to,2590,31,42,5,4,1,0,83
education and,2589,19,34,1,2,0,0,56
philippians 4,2589,3,6,0,0,0,0,9
my personal,2588,66,81,11,4,6,3,171
dallas cowboys,2588,9,8,0,0,0,0,17
must be,2586,39,28,10,0,9,0,86
not an,2585,68,60,15,3,10,3,159
i really,2582,77,112,16,10,16,7,238
on http,2578,70,36,15,1,7,3,132
and life,2565,25,33,2,0,0,0,60
and social,2563,60,100,13,2,7,0,182
powered by,2562,30,44,7,4,3,2,90
wrestling fan,2558,83,44,2,4,4,3,140
across the,2556,16,14,1,2,0,0,33
at home,2553,49,67,4,4,3,0,127
open for,2552,131,86,31,20,23,2,293
my art,2551,155,257,99,43,86,10,650
i would,2551,34,85,12,2,8,2,143
of many,2546,120,140,24,13,9,5,311
made in,2545,20,44,4,1,2,1,72
the things,2541,58,94,4,2,9,3,170
there are,2541,46,46,5,4,2,1,104
just like,2539,60,57,8,6,13,5,149
kids and,2531,20,46,1,0,0,0,67
become a,2524,36,47,8,2,5,1,99
player for,2523,58,18,7,5,3,2,93
if it,2519,36,37,6,4,7,1,91
now on,2519,36,30,8,3,4,3,84
way of,2518,39,65,2,3,3,1,113
you can’t,2518,29,53,10,2,9,0,103
mother grandmother,2512,0,32,0,0,0,0,32
social worker,2507,41,209,17,7,12,0,286
for some,2507,40,40,7,6,5,0,98
where you,2503,16,35,2,4,3,0,60
of you,2501,47,64,8,7,9,0,135
the last,2501,48,53,6,0,7,1,115
you the,2500,13,18,1,0,1,1,34
to improve,2499,34,19,5,0,1,0,59
we provide,2498,0,0,0,0,0,0,0
and sometimes,2497,120,153,28,16,28,2,347
is love,2494,58,177,8,2,8,1,254
little bit,2493,56,100,4,6,10,1,177
hit me,2492,49,18,6,3,2,1,79
i’m the,2486,39,59,6,7,6,1,118
see the,2486,19,27,1,0,3,1,51
human being,2482,62,76,15,7,7,2,169
a person,2480,70,83,32,13,14,1,213
center for,2477,30,35,3,0,0,0,68
to an,2476,41,52,2,1,1,1,98
life long,2475,16,28,2,0,1,0,47
boy mom,2470,0,87,2,0,3,0,92
out on,2467,44,40,7,4,8,3,106
to support,2463,25,38,1,6,8,1,79
dad and,2460,59,1,0,2,0,2,64
power of,2458,21,41,7,1,5,0,75
adult content,2457,34,31,13,8,6,2,94
daughter sister,2457,0,91,1,0,0,0,92
and loving,2456,22,29,5,1,3,1,61
enjoying life,2453,17,12,1,0,1,0,31
software developer,2452,207,48,12,7,5,2,281
and play,2451,100,73,23,9,10,4,219
but the,2449,27,44,6,7,3,0,87
god fearing,2448,4,3,0,0,0,0,7
right now,2442,66,87,8,5,5,1,172
ohio state,2440,25,42,0,1,2,0,70
who you,2439,30,35,4,2,8,1,80
new orleans,2435,24,39,5,1,1,0,70
hosted by,2434,10,9,0,0,0,4,23
mother wife,2429,0,101,1,0,2,0,104
than you,2427,55,74,12,4,3,1,149
proud of,2426,33,46,10,1,8,1,99
and we,2420,19,21,6,2,3,3,54
comic book,2418,175,59,10,12,6,2,264
we will,2406,9,20,2,2,4,0,37
in progress,2405,54,156,16,8,19,3,256
of new,2404,30,26,3,0,1,0,60
associate professor,2403,102,130,4,1,6,0,243
things and,2402,104,134,18,16,18,2,292
jesus is,2400,7,6,0,0,0,0,13
like my,2399,48,60,11,8,14,0,141
father grandfather,2399,14,0,0,0,0,0,14
new england,2398,38,45,7,3,2,0,95
be your,2396,38,71,7,4,12,2,134
out here,2395,40,74,10,3,10,2,139
health advocate,2394,66,210,19,4,16,1,316
state alum,2391,22,50,1,0,2,0,75
america first,2389,1,0,0,0,0,0,1
dms are,2388,160,78,24,27,15,3,307
of one,2388,33,43,4,0,5,0,85
the community,2387,7,13,3,0,0,0,23
college football,2387,13,6,0,0,0,0,19
my love,2386,31,134,7,2,12,1,187
was born,2386,25,20,3,6,4,1,59
https //discord,2385,46,22,5,8,4,1,86
fan since,2385,30,29,0,1,3,1,64
son brother,2385,24,1,0,0,0,0,25
mission to,2384,15,23,1,0,1,1,41
care about,2383,52,65,10,10,5,0,142
place to,2383,18,30,4,1,4,0,57
working in,2380,78,86,9,2,7,2,184
a dream,2380,14,39,4,5,3,2,67
we offer,2380,0,0,0,0,0,0,0
in god,2378,4,8,0,0,0,1,13
the state,2376,23,17,5,2,4,0,51
oh and,2375,47,48,7,3,5,1,111
waiting for,2373,44,87,7,4,3,0,145
what we,2373,18,31,2,0,1,0,52
and crypto,2371,7,4,0,1,1,1,14
retweets are,2369,64,44,6,4,5,2,125
of people,2368,32,52,4,5,3,1,97
for it,2367,42,40,4,6,4,2,98
vote blue,2366,9,44,0,0,0,0,53
the other,2364,51,49,9,8,4,4,125
i feel,2352,48,64,4,8,3,0,127
opinions mine,2351,239,327,21,5,24,3,619
as you,2351,39,40,8,1,5,2,95
years in,2351,21,18,1,1,1,0,42
i try,2348,102,66,9,6,11,3,197
tweets about,2346,136,130,10,10,7,1,294
king of,2346,86,16,15,7,2,2,128
and good,2343,51,52,9,5,8,1,126
in texas,2343,25,28,5,1,2,0,61
just living,2343,19,23,4,0,4,0,50
voice of,2340,47,16,4,3,6,1,77
a woman,2338,14,62,8,0,14,0,98
a full,2338,14,27,5,2,4,0,52
play games,2337,128,71,25,11,19,5,259
with no,2337,33,41,8,4,5,0,91
to 2,2334,20,78,2,1,6,1,108
director at,2332,69,66,2,5,5,0,147
a difference,2332,18,40,1,2,0,0,61
tired of,2330,30,54,11,1,2,0,98
but i'm,2327,60,69,19,9,5,3,165
a free,2326,9,20,3,1,4,0,37
on facebook,2326,6,16,2,0,0,0,24
play video,2322,136,80,16,18,10,2,262
will always,2321,33,39,6,2,5,1,86
my world,2321,7,23,5,0,2,1,38
dogs and,2319,49,117,6,3,4,0,179
my husband,2319,31,65,4,2,3,0,105
a gamer,2316,64,30,11,4,7,1,117
navy veteran,2316,33,17,2,1,0,1,54
yes i,2313,57,77,14,8,15,2,173
the outdoors,2308,24,35,1,1,1,1,63
tell me,2306,63,74,11,4,5,2,159
to stay,2305,20,42,6,2,3,0,73
profile pic,2296,277,169,61,28,32,10,577
manager at,2295,82,72,6,2,4,1,167
your heart,2295,39,45,10,5,3,1,103
take a,2295,20,36,6,2,3,0,67
know how,2294,43,77,15,5,15,2,157
and husband,2291,51,1,0,1,0,0,53
follow the,2291,7,22,0,1,0,0,30
crypto investor,2289,2,2,0,0,0,0,4
and business,2288,11,12,0,0,3,2,28
of us,2287,44,45,6,2,5,2,104
for everyone,2286,43,60,11,5,13,0,132
a place,2286,50,38,7,7,11,1,114
not affiliated,2285,30,31,3,1,4,1,70
your dreams,2285,19,29,5,7,2,1,63
but i’m,2284,47,67,5,12,17,1,149
podcast host,2281,61,63,7,3,6,2,142
girl who,2280,7,113,1,1,10,2,134
a dude,2280,80,4,1,10,0,0,95
like me,2279,34,37,8,3,5,1,88
thoughts and,2276,87,85,8,12,10,1,203
i could,2276,59,77,6,3,7,3,155
helping people,2276,14,13,0,1,0,0,28
crypto and,2271,5,1,1,0,0,0,7
is always,2270,22,39,6,3,5,0,75
your local,2268,113,118,35,29,34,3,332
opinions expressed,2265,114,81,5,3,2,7,212
in it,2263,37,48,3,2,7,2,99
daughter of,2261,2,92,2,0,5,0,101
be an,2258,54,74,13,4,9,1,155
reporter for,2257,40,72,3,1,2,0,118
from my,2256,52,53,9,3,6,2,125
who has,2256,31,30,9,7,5,0,82
gpa 3,2252,0,0,0,0,0,0,0
a professional,2250,38,32,5,3,4,2,84
makes me,2249,31,51,2,5,6,0,95
your business,2246,3,9,0,0,3,0,15
http //t,2245,18,7,0,3,0,0,28
teacher at,2244,20,48,0,3,2,0,73
fan i,2243,50,26,5,3,5,1,90
me with,2242,32,28,3,2,4,1,70
minors dni,2240,273,260,127,76,108,10,854
as an,2238,36,34,2,1,4,0,77
god 1st,2238,5,8,0,1,0,0,14
no dm's,2237,7,29,1,0,0,0,37
friendly neighborhood,2234,105,147,34,28,23,5,342
into a,2231,44,56,8,7,4,2,121
a day,2230,28,29,5,4,5,2,73
variety streamer,2226,149,119,24,14,37,2,345
in training,2226,112,118,19,17,22,6,294
everything i,2225,29,39,8,5,12,0,93
it's a,2223,42,29,5,3,5,1,85
i die,2222,43,46,4,4,7,1,105
live and,2221,17,30,6,2,0,1,56
leader in,2219,12,9,0,1,0,0,22
for free,2217,11,16,7,1,0,0,35
with us,2217,5,9,1,0,1,0,16
all in,2216,18,30,5,0,1,0,54
in an,2215,55,50,11,7,6,4,133
and enjoy,2211,21,10,4,0,3,1,39
good at,2210,105,78,24,9,11,1,228
not your,2210,29,66,7,1,3,1,107
and in,2210,28,37,2,3,3,1,74
an amazing,2209,28,30,4,1,2,0,65
some fun,2208,26,12,2,4,4,0,48
that are,2203,33,32,5,3,2,0,75
best of,2202,20,25,6,2,3,0,56
man who,2200,32,3,1,4,1,0,41
vice president,2198,31,42,3,0,3,0,79
new jersey,2196,20,14,1,2,2,1,40
to save,2193,19,47,1,1,4,0,72
goal is,2192,11,16,4,1,2,0,34
come to,2191,28,40,8,0,3,0,79
no dm’s,2186,5,31,0,0,1,0,37
country music,2185,10,14,0,0,3,0,27
with it,2184,23,42,4,6,5,2,82
coach and,2184,14,11,1,2,0,0,28
events and,2183,10,8,2,1,0,0,21
a financial,2181,4,4,0,0,0,0,8
b a,2180,51,59,13,5,7,0,135
the big,2178,44,48,8,4,4,1,109
hard to,2178,28,41,9,2,6,0,86
25 years,2178,31,23,12,4,3,2,75
and politics,2177,96,86,8,5,5,3,203
my opinion,2176,33,34,4,4,1,0,76
web developer,2175,124,47,9,6,5,0,191
we help,2174,2,3,0,0,0,0,5
a human,2172,62,107,21,6,17,3,216
north carolina,2172,22,13,1,0,1,0,37
candidate for,2170,73,61,4,4,2,0,144
fight for,2170,38,51,7,4,3,2,105
at your,2170,38,42,13,4,5,1,103
i stand,2170,39,35,5,3,7,0,89
to bring,2170,18,22,4,0,0,2,46
to serve,2169,10,12,0,0,3,0,25
always open,2166,167,46,33,24,14,1,285
i never,2159,33,57,11,7,5,1,114
send me,2157,41,52,18,11,12,2,136
always looking,2155,43,39,6,4,8,1,101
you in,2151,24,41,10,5,1,2,83
where the,2151,15,34,2,1,5,0,57
like you,2148,23,44,4,3,2,0,76
the top,2147,17,11,1,2,3,0,34
people with,2146,14,81,6,1,14,0,116
on our,2146,12,8,2,0,0,1,23
than i,2142,68,70,11,3,8,2,162
available on,2141,24,23,2,1,4,1,55
i used,2140,79,81,4,5,6,3,178
contact me,2140,33,29,4,10,5,3,84
of 2023,2138,15,14,2,0,0,0,31
nature lover,2137,31,110,3,3,6,0,153
at my,2137,56,58,12,6,7,1,140
and live,2136,21,17,2,1,1,0,42
we love,2134,11,19,2,1,2,2,37
taylor swift,2133,56,316,8,5,19,1,405
and stuff,2132,131,81,16,12,17,9,266
going on,2132,46,71,15,8,11,2,153
but a,2131,45,43,5,4,5,0,102
saved by,2131,4,14,0,0,0,0,18
a mission,2130,18,25,1,0,1,0,45
baseball coach,2129,5,0,0,0,0,0,5
than a,2126,36,56,5,5,4,1,107
our website,2124,1,0,0,0,0,1,2
it’s a,2122,24,51,4,2,6,0,87
things in,2120,37,42,4,3,3,0,89
i use,2119,70,85,28,8,12,5,208
to laugh,2118,12,38,6,1,6,0,63
texas a,2118,28,28,1,0,0,0,57
new twitter,2118,5,10,4,0,0,0,19
to put,2116,55,46,7,11,8,2,129
all you,2113,22,48,5,1,3,0,79
and their,2110,14,22,3,1,2,0,42
and always,2105,33,56,10,6,6,3,114
business and,2099,13,11,2,0,1,0,27
i take,2098,51,74,15,6,8,0,154
and our,2097,9,19,0,2,2,0,32
make music,2096,105,42,17,15,14,3,196
director for,2095,75,65,4,3,4,0,151
recording artist,2095,11,5,1,2,2,0,21
u of,2093,39,67,5,3,8,1,123
you a,2090,18,42,8,3,6,1,78
get your,2090,29,38,2,0,3,0,72
i can't,2089,38,50,6,5,4,0,103
grew up,2089,28,34,0,0,1,0,63
here i,2088,46,62,13,1,9,1,132
how you,2088,16,29,5,0,0,0,50
of love,2086,38,67,12,9,13,3,142
me the,2085,33,40,7,5,3,2,90
country and,2085,10,6,0,0,1,0,17
world a,2082,64,62,5,4,5,0,140
a book,2075,44,82,8,4,9,1,148
the name,2075,43,34,10,4,3,1,95
time with,2073,17,13,1,1,0,0,32
for booking,2072,7,7,9,3,0,1,27
https //instagram,2070,8,17,2,1,3,0,31
is where,2069,45,62,10,5,10,0,132
personal trainer,2069,22,12,1,1,1,0,37
official page,2069,1,4,1,0,0,0,6
the past,2067,25,19,3,0,2,0,49
find the,2064,18,19,3,0,4,1,45
the world's,2063,18,11,3,0,2,1,35
of texas,2062,18,26,0,1,0,0,45
me or,2061,31,25,4,2,7,0,69
of america,2058,11,16,1,2,0,0,30
to watch,2057,31,28,6,1,3,1,70
time for,2056,22,37,2,2,1,0,64
all platforms,2056,13,14,3,0,5,0,35
love sports,2052,10,5,1,1,0,0,17
you should,2051,52,61,3,5,8,3,132
and some,2049,67,48,3,6,4,4,132
other stuff,2048,133,86,13,9,7,2,250
rest in,2048,11,22,1,1,3,0,38
commissions open,2047,167,258,115,52,91,9,692
i support,2045,37,44,8,2,4,2,97
it up,2044,29,34,5,3,2,3,76
love it,2043,10,25,4,0,4,0,43
a writer,2041,68,116,8,9,16,3,220
i find,2040,40,28,5,7,6,0,86
twitter feed,2040,9,10,1,0,0,0,20
what to,2039,53,45,5,7,11,3,124
you with,2039,7,22,1,0,1,0,31
what the,2038,36,47,5,7,10,0,105
and then,2038,32,50,7,3,6,3,101
and only,2038,27,36,3,3,2,0,71
stand up,2038,23,28,4,0,2,0,57
small town,2037,13,51,6,1,2,2,75
kansas city,2037,16,20,2,0,0,0,38
so you,2036,23,36,4,3,5,0,71
nothing to,2033,19,33,6,4,5,1,68
you make,2033,15,36,1,2,2,0,56
of books,2032,61,205,10,3,3,1,283
hard working,2032,0,3,0,0,0,0,3
been a,2031,12,28,1,0,2,0,43
enjoy life,2029,15,10,3,0,2,0,30
to god,2029,7,15,0,0,1,1,24
and your,2027,26,19,3,2,1,2,53
access to,2027,11,34,0,1,2,0,48
future of,2027,19,21,0,1,1,0,42
at least,2026,64,86,17,7,12,2,188
it i,2026,30,45,10,4,2,2,93
care of,2025,24,39,4,1,5,1,74
of art,2024,69,66,11,6,12,0,164
on earth,2024,17,36,5,1,0,0,59
is better,2024,20,26,3,2,3,2,56
a podcast,2022,52,27,5,1,2,3,90
graphic design,2018,64,81,13,14,13,2,187
your friendly,2016,82,122,24,22,14,5,269
time i,2016,43,52,7,3,8,2,115
all trades,2013,63,46,17,5,15,0,146
to write,2012,63,92,11,10,11,1,188
world and,2012,25,35,5,2,0,0,67
l a,2010,17,29,1,1,2,1,51
you wanna,2008,49,43,14,6,7,1,120
and most,2008,31,21,3,1,0,0,56
is our,2008,9,13,1,1,0,0,24
specialize in,2008,5,10,2,0,0,0,17
to come,2007,16,33,2,1,1,0,53
video editor,2006,182,75,21,16,19,1,314
in san,2006,26,17,0,1,4,0,48
i’m an,2004,35,53,16,6,9,0,119
the art,2003,31,37,6,4,8,0,86
better place,2001,46,56,3,4,3,0,112
that will,2001,14,23,6,1,1,1,46
and art,1999,74,92,21,16,21,4,228
for people,1998,21,39,5,5,0,0,70
the light,1996,19,40,7,2,5,1,74
yr old,1993,34,51,14,18,12,5,134
don't like,1993,31,36,4,4,5,1,81
my business,1993,6,25,2,0,5,0,38
0 gpa,1993,0,0,0,0,0,0,0
and just,1992,30,39,8,2,4,0,83
ask for,1988,44,44,17,17,7,2,131
dm to,1987,30,23,6,4,8,1,72
have an,1984,47,50,10,4,9,2,122
it in,1984,29,35,6,5,6,1,82
christian conservative,1984,0,2,0,0,0,0,2
lives in,1983,38,34,10,5,3,0,90
i retweet,1981,109,96,17,13,18,5,258
i be,1981,26,33,9,7,5,0,80
can i,1980,31,59,6,1,9,0,106
in real,1979,19,28,2,0,7,0,56
nft enthusiast,1979,0,19,0,0,0,0,19
and community,1978,24,31,4,1,3,2,65
climate change,1975,62,99,6,1,11,0,179
do i,1974,37,41,11,4,17,2,112
find out,1974,19,28,7,3,2,0,59
proud husband,1972,26,0,0,1,0,0,27
learn more,1970,10,10,0,1,2,0,23
i dont,1968,35,28,11,7,9,3,93
variety of,1967,26,22,9,0,1,0,58
the man,1966,23,10,1,2,1,0,37
she her,1964,0,0,2,0,0,0,2
1a 2a,1961,0,0,1,0,0,0,1
to use,1960,41,55,12,6,13,3,130
and writer,1959,108,100,22,7,17,2,256
twitch http,1958,80,46,7,11,5,1,150
cat dad,1957,354,2,19,39,1,3,418
to enjoy,1957,22,22,2,1,3,1,51
cat lover,1956,55,162,12,4,13,2,248
old account,1956,15,17,4,2,3,0,41
travel and,1953,13,32,3,0,2,0,50
your mind,1951,21,18,1,3,4,1,48
4 0,1951,1,0,0,0,0,0,1
would be,1950,32,60,5,1,6,3,107
up on,1950,27,41,5,3,5,0,81
my bio,1950,35,27,8,3,6,1,80
for those,1950,19,29,4,1,2,1,56
in la,1949,42,56,6,3,3,0,110
cats and,1948,59,197,14,6,20,4,300
com for,1947,31,30,5,6,9,2,83
the arts,1947,22,52,3,2,2,0,81
this page,1946,20,18,8,3,7,1,57
i may,1945,50,57,13,7,8,3,138
a bad,1945,45,58,14,0,12,0,129
all over,1945,14,29,1,4,4,0,52
https //bit,1944,35,27,8,3,6,0,79
love jesus,1942,9,15,0,0,0,0,24
the process,1941,14,15,0,1,0,0,30
a community,1941,7,5,0,0,1,0,13
https //twitter,1940,60,50,14,8,14,1,147
soon to,1939,34,44,11,4,4,3,100
navy vet,1937,28,14,2,2,1,0,47
philly sports,1936,29,31,1,1,2,0,64
elementary school,1936,13,21,2,2,0,0,38
don't have,1935,36,45,7,4,3,1,96
he is,1935,19,8,1,0,3,1,32
by my,1934,55,61,12,13,13,4,158
a father,1934,17,2,0,2,0,0,21
me about,1932,123,178,37,18,33,4,393
photographer and,1932,48,47,9,5,3,1,113
us navy,1929,21,8,3,2,0,0,34
tweeting about,1927,79,91,5,3,4,1,183
graduate of,1926,34,27,0,2,2,0,65
of sports,1926,16,14,0,1,1,0,32
and anime,1925,134,84,11,8,16,2,255
of them,1924,49,38,10,4,6,2,109
it for,1924,29,32,2,1,7,2,73
i wanna,1923,41,56,9,4,9,1,120
work with,1923,24,29,4,2,7,0,66
listening to,1922,59,73,7,5,14,3,161
a mother,1922,2,27,1,0,2,0,32
to two,1921,24,68,1,0,1,2,96
people in,1921,22,18,5,4,1,3,53
help people,1920,25,13,0,0,1,0,39
mother and,1920,3,24,1,0,0,0,28
and also,1919,64,68,17,8,13,0,170
faith family,1919,1,2,0,0,0,0,3
no dm,1918,2,18,1,0,1,0,22
link to,1915,38,35,10,4,12,0,99
s army,1914,12,5,0,0,0,0,17
can make,1912,26,29,2,1,2,0,60
it’s not,1911,27,49,7,3,6,1,93
an american,1911,16,18,1,0,0,0,35
jack of,1909,57,30,17,5,6,0,115
children and,1908,6,20,1,0,1,0,28
political science,1907,84,68,5,5,7,3,172
i still,1907,50,58,11,4,4,2,129
live for,1905,13,34,10,0,2,0,59
know the,1905,19,27,4,0,2,0,52
marketing and,1905,10,25,0,2,0,0,37
my soul,1904,29,64,8,3,9,0,113
have some,1900,26,25,2,4,6,0,63
my head,1899,47,66,11,6,7,1,138
i had,1897,32,53,4,1,4,1,95
to twitter,1897,27,32,3,4,3,1,70
boston sports,1897,36,32,0,1,0,0,69
computer science,1895,100,38,6,2,3,1,150
my website,1895,29,33,10,2,6,0,80
time and,1895,24,32,6,6,2,1,71
person who,1894,47,56,16,7,9,0,135
to this,1893,32,32,6,4,0,0,74
to figure,1890,52,85,16,4,11,1,169
the stars,1890,33,85,6,2,14,0,140
focusing on,1889,44,37,1,2,2,1,87
positive vibes,1889,13,27,0,2,0,0,42
the country,1889,9,11,0,2,0,0,22
mommy to,1886,1,31,0,0,0,0,32
we make,1886,7,5,2,0,2,3,19
is real,1885,33,80,10,3,11,0,137
everything is,1885,30,46,3,3,4,0,86
when the,1883,31,30,5,2,7,0,75
grade teacher,1882,8,51,1,1,0,0,61
reality tv,1881,59,116,4,4,3,1,187
my son,1881,13,18,2,1,4,0,38
icloud com,1881,6,1,0,3,1,0,11
espa ol,1880,49,52,9,7,5,2,124
services to,1879,1,4,0,0,0,0,5
based on,1878,15,22,1,1,3,0,42
de los,1876,2,5,0,0,0,0,7
history and,1875,63,56,6,4,3,1,133
it's not,1875,37,30,4,2,5,2,80
1 of,1874,12,16,0,0,4,0,32
message me,1871,35,25,9,4,6,0,79
mother to,1871,0,68,2,0,3,0,73
happy to,1870,47,51,9,7,5,1,120
in chicago,1870,37,44,2,1,3,0,87
not in,1868,48,52,5,2,2,0,109
school in,1867,6,12,1,0,1,0,20
btc eth,1866,3,1,0,0,0,0,4
tell you,1865,22,42,6,2,5,0,77
coffee and,1863,52,129,14,4,18,0,217
about sports,1863,37,36,1,1,1,1,77
- https,1863,41,22,5,3,2,1,74
is everything,1863,12,18,1,1,4,1,37
save the,1862,37,64,8,3,8,0,120
off the,1861,26,24,1,1,0,1,53
owner and,1861,22,22,2,2,1,0,49
the south,1860,20,41,3,0,3,1,68
singer songwriter,1859,8,27,1,2,3,0,41
available for,1858,53,71,14,7,11,1,157
building a,1858,18,16,2,0,3,0,39
of course,1855,28,38,2,1,3,0,72
stuff and,1853,147,90,25,14,14,4,294
our country,1851,1,7,1,0,0,0,9
designer and,1850,99,67,17,6,11,1,201
life of,1849,14,21,2,1,1,0,39
do your,1849,8,10,3,3,0,0,24
i can’t,1848,29,52,9,8,11,0,109
laid back,1848,10,1,1,0,1,0,13
an independent,1847,5,3,2,0,2,0,12
gaming and,1845,76,27,9,9,5,2,128
my only,1840,23,46,6,3,6,0,84
en la,1839,6,4,0,0,1,0,11
design and,1838,55,27,3,3,2,2,92
it and,1838,25,15,2,3,2,1,48
san antonio,1838,11,17,1,0,1,0,30
twitch partner,1836,103,114,6,8,7,0,238
phd in,1836,65,120,5,7,12,1,210
peace love,1836,17,30,2,3,4,0,56
willing to,1835,42,39,8,3,7,0,99
working with,1835,19,26,3,0,1,0,49
founded in,1835,1,1,0,0,0,0,2
pretty much,1834,58,52,14,7,10,0,141
don't be,1833,54,43,14,5,7,2,125
public schools,1833,10,35,0,1,1,0,47
having a,1831,44,56,6,2,17,1,126
a regular,1831,28,23,3,0,3,1,58
me gusta,1831,5,8,0,2,2,0,17
talking about,1830,70,87,16,6,9,0,188
cat lady,1828,2,379,4,0,18,1,404
the making,1828,21,40,8,3,3,0,75
is that,1827,28,47,8,2,5,0,90
a wife,1824,4,30,0,0,0,0,34
let the,1823,16,27,4,0,5,0,52
collection of,1823,17,26,4,2,2,0,51
catch me,1821,34,37,7,3,4,0,85
in between,1821,25,42,3,3,3,1,77
us to,1820,8,8,0,0,1,0,17
and beyond,1816,9,14,2,0,0,1,26
wear a,1813,57,146,18,4,11,0,236
to start,1812,24,25,3,3,0,2,57
to win,1812,12,17,4,0,1,0,34
father son,1812,8,1,0,2,0,0,11
freelance writer,1811,74,104,8,6,8,0,200
end of,1811,26,39,9,1,6,0,81
on me,1811,21,41,3,1,6,5,77
be in,1811,29,36,3,3,4,0,75
mine alone,1810,114,93,5,3,3,1,219
research and,1810,18,17,0,0,0,0,35
track field,1809,1,5,0,0,0,0,6
and mom,1806,2,77,2,0,3,1,85
in america,1805,19,21,3,1,5,0,49
make your,1803,14,18,1,3,1,0,37
of humor,1801,20,41,2,0,4,1,68
the planet,1800,26,53,4,1,2,1,87
guy that,1800,38,1,0,4,0,1,44
editor for,1799,105,104,21,6,6,0,242
who enjoys,1798,51,28,5,6,3,0,93
a young,1798,23,18,2,0,1,0,44
don’t take,1796,14,29,6,0,3,0,52
take it,1794,19,32,4,2,7,0,64
all kinds,1792,45,32,8,3,4,2,94
just for,1792,22,24,1,2,7,1,57
business email,1788,103,69,19,11,15,2,219
the views,1787,78,51,4,3,1,0,137
and dad,1787,61,2,0,0,1,1,65
a way,1787,17,29,1,0,0,0,47
place for,1786,31,37,9,5,7,2,91
on it,1786,21,41,0,8,3,0,73
of experience,1786,8,2,4,0,1,0,15
is like,1783,11,23,5,4,2,0,45
join me,1782,20,27,6,2,2,0,57
a os,1780,1,4,0,1,0,0,6
check me,1779,25,16,4,2,2,2,51
the constitution,1778,3,7,0,0,0,0,10
opinions and,1777,79,67,8,3,4,0,161
im just,1776,15,38,6,7,8,0,74
to grow,1774,17,19,1,0,2,0,39
and so,1773,30,56,6,2,8,1,103
i've been,1773,31,39,3,6,4,0,83
out there,1772,32,22,7,2,5,0,68
girl dad,1772,32,0,0,0,0,0,32
pursuit of,1772,9,18,0,0,1,0,28
views mine,1771,146,245,14,8,16,1,430
a r,1771,13,23,0,1,1,1,39
professor at,1770,86,71,1,4,5,1,168
may not,1769,45,45,11,5,5,3,114
and support,1764,9,25,2,3,0,1,40
a lover,1763,26,50,4,2,1,0,83
guy with,1763,63,1,0,1,0,0,65
out our,1763,4,8,0,0,1,0,13
maga kag,1763,0,0,0,0,0,0,0
//www hudl,1763,0,0,0,0,0,0,0
r b,1762,13,12,6,2,0,0,33
south carolina,1762,19,8,1,2,0,1,31
followed by,1759,12,22,1,0,2,0,37
the road,1756,8,19,5,1,1,0,34
queen of,1755,7,155,7,3,25,2,199
see you,1754,15,33,5,2,1,0,56
29 11,1754,3,6,0,1,0,0,10
en el,1753,1,3,0,0,1,0,5
is one,1752,14,14,3,3,0,0,34
just some,1749,103,44,8,13,6,4,178
on tiktok,1749,40,91,16,3,12,1,163
free speech,1748,7,6,0,0,0,1,14
single mom,1746,2,91,2,0,2,0,97
fan for,1746,10,14,1,2,0,0,27
hi i’m,1744,65,115,27,17,24,5,253
is out,1743,38,51,7,5,1,2,104
everything else,1743,33,36,7,4,3,1,84
can find,1742,21,37,10,5,8,3,84
the moment,1740,25,29,4,4,5,1,68
life coach,1740,10,13,0,0,2,0,25
hope you,1738,32,36,13,7,5,0,93
university alum,1737,9,24,0,0,3,1,37
community of,1737,5,2,0,0,0,0,7
founder and,1736,26,14,1,2,1,0,44
my work,1735,34,63,24,6,17,2,146
full service,1734,0,1,0,0,0,0,1
to draw,1733,94,127,34,18,33,5,311
you for,1733,24,32,6,2,2,0,66
believes in,1732,19,34,0,2,1,1,57
take the,1730,13,22,6,3,1,2,47
a nice,1729,29,40,7,3,6,1,86
my first,1728,27,40,6,3,3,2,81
also love,1728,35,30,4,2,3,2,76
of truth,1726,9,19,2,1,0,1,32
vibes only,1725,16,27,2,0,4,1,50
more info,1724,13,25,4,8,2,1,53
lifelong learner,1723,17,77,0,2,1,2,99
always a,1723,15,46,7,2,8,0,78
editor at,1722,93,131,7,3,5,1,240
not here,1721,21,48,6,1,6,0,82
in peace,1721,13,24,2,1,3,0,43
your source,1721,0,1,0,0,0,0,1
a family,1720,5,19,2,1,0,0,27
hi i,1719,49,67,20,5,11,3,155
open minded,1719,10,15,0,1,2,0,28
not reflect,1718,87,102,15,7,9,3,223
your best,1718,10,15,2,5,2,0,34
wake up,1717,10,27,2,2,6,0,47
our community,1717,1,3,0,0,0,0,4
and making,1716,53,30,6,4,8,1,102
work and,1716,18,26,0,3,4,0,51
and fun,1716,21,10,6,3,4,1,45
but my,1713,33,55,5,4,7,2,106
feel like,1712,32,53,7,7,2,1,102
of what,1712,32,30,2,1,3,0,68
peace and,1711,9,33,0,2,3,1,48
i sell,1710,19,33,7,3,2,0,64
inspired by,1710,19,32,3,2,0,2,58
a wonderful,1710,19,19,0,1,0,0,39
of everything,1708,37,46,10,3,6,1,103
c/o 2023,1708,3,4,1,0,0,0,8
artist writer,1707,89,132,35,16,42,9,323
if your,1707,21,26,1,2,1,1,52
to buy,1707,18,17,3,4,4,0,46
of 2022,1705,19,16,2,2,0,0,39
maker of,1704,102,102,13,8,17,2,244
my page,1704,19,31,7,4,3,3,67
south florida,1702,6,9,0,0,2,1,18
tweets and,1701,51,87,5,3,3,0,149
for what,1701,17,26,0,0,2,0,45
love yourself,1700,12,52,2,3,5,1,75
founder ceo,1700,11,24,0,1,1,0,37
let's go,1700,15,14,2,2,2,1,36
don’t like,1699,25,32,7,1,4,0,69
live on,1699,22,32,6,1,0,2,63
girl with,1698,2,110,3,0,19,1,135
under the,1698,30,41,10,4,3,0,88
high quality,1698,5,9,1,1,2,0,18
stand with,1696,46,43,11,2,8,0,110
had a,1696,32,55,8,2,8,0,105
animals and,1693,24,56,5,3,6,1,95
for new,1692,25,25,4,5,2,0,61
truth and,1692,3,25,0,0,1,0,29
here http,1691,46,23,7,5,3,1,85
pronouns are,1689,103,113,64,17,30,15,342
// //,1688,65,141,25,11,30,2,274
my dreams,1688,20,20,2,0,3,0,45
specializes in,1688,6,6,0,1,2,0,15
do is,1687,20,44,10,7,12,3,96
you all,1686,34,30,4,7,2,0,77
writer editor,1685,81,205,15,4,10,1,316
be blocked,1685,109,71,22,13,13,7,235
rt endorsement,1683,59,60,4,3,1,1,128
live music,1683,23,46,2,0,2,0,73
justice and,1682,37,58,8,0,5,1,109
- a,1682,32,39,11,5,3,0,90
and it,1682,33,29,5,1,5,1,74
technology and,1681,40,8,0,3,2,0,53
blocked by,1680,38,35,5,1,1,1,81
artist /,1679,55,54,21,9,17,2,158
collector of,1676,56,71,10,1,8,2,148
head football,1676,0,0,0,0,0,0,0
give a,1675,13,26,5,1,1,0,46
and technology,1675,20,17,2,2,2,0,43
learning to,1673,60,67,11,4,6,3,151
my time,1673,27,43,9,0,3,1,83
only here,1671,12,39,7,2,3,0,63
join our,1671,3,4,2,0,1,1,11
made by,1670,110,77,21,17,21,2,248
be nice,1670,67,72,14,1,13,0,167
loves the,1670,18,23,2,3,2,0,48
one and,1668,24,32,0,2,2,0,60
experience in,1668,3,7,2,1,0,0,13
a christian,1668,4,5,0,0,0,0,9
to tell,1667,26,35,5,2,4,1,73
above all,1666,13,30,2,0,2,1,48
hard work,1665,3,7,0,0,0,0,10
life one,1664,13,26,3,4,3,1,50
leader of,1662,33,18,3,1,3,0,58
stand for,1661,8,18,4,2,0,0,32
here and,1660,46,42,3,5,6,3,105
than the,1660,29,35,5,4,3,0,76
your home,1658,1,4,1,0,1,0,7
by grace,1657,1,11,0,0,2,0,14
never be,1656,21,23,3,2,6,0,55
boys basketball,1656,1,0,0,0,0,0,1
and his,1655,31,7,0,6,1,1,46
you may,1653,33,26,7,6,9,1,82
new friends,1650,36,25,9,4,7,0,81
in their,1649,17,11,9,2,4,0,43
to show,1647,30,27,4,6,2,0,69
be yourself,1647,19,12,1,1,4,1,38
fun loving,1647,10,7,1,1,0,0,19
the blue,1646,16,15,1,0,0,1,33
solutions for,1646,1,1,0,0,0,0,2
my main,1645,51,48,10,8,12,3,132
people are,1645,31,33,4,0,3,0,71
the largest,1645,1,4,0,0,0,0,5
of being,1643,33,42,7,7,4,0,93
know you,1643,17,28,4,4,2,1,56
i speak,1642,35,58,6,1,2,2,104
office of,1641,7,15,0,2,0,0,24
owned by,1640,37,68,9,2,4,1,121
teacher of,1640,24,62,4,1,1,0,92
no lists,1640,3,51,0,0,1,0,55
local news,1639,7,21,0,0,0,0,28
to myself,1638,20,53,9,1,5,0,88
back in,1638,30,32,2,1,7,0,72
producer of,1637,51,33,3,2,5,0,94
use code,1637,26,30,0,0,2,0,58
not for,1636,29,23,1,2,8,4,67
make sure,1636,17,15,2,3,1,0,38
to promote,1636,8,14,0,2,1,0,25
american patriot,1635,2,1,0,0,0,0,3
it will,1634,19,22,4,2,4,0,51
header by,1633,230,279,120,60,53,16,758
love animals,1632,2,41,0,0,3,0,46
coach for,1631,8,9,0,1,0,1,19
of science,1630,52,64,6,3,1,0,126
the king,1630,10,6,2,2,1,0,21
i mostly,1629,133,107,15,13,10,2,280
and mother,1629,1,37,1,0,2,0,41
a la,1629,2,7,1,1,0,1,12
game designer,1628,353,115,25,30,18,4,545
be better,1628,48,37,1,7,2,0,95
not that,1627,64,70,3,6,6,0,149
mom grandma,1627,0,32,0,0,1,0,33
taken by,1625,116,72,32,24,24,7,275
to die,1625,34,46,12,1,5,2,100
is on,1625,27,37,5,5,3,0,77
proud democrat,1625,23,34,0,0,0,0,57
is too,1623,21,29,3,0,4,0,57
football fan,1623,11,13,1,0,0,0,25
editor of,1621,59,83,3,2,7,2,156
don’t have,1620,28,38,6,6,3,0,81
book lover,1618,26,163,5,2,9,1,206
youtube https,1618,31,10,1,2,1,0,45
live a,1618,15,21,1,2,0,0,39
jeremiah 29,1618,3,5,0,1,0,0,9
how i,1617,27,24,3,3,3,0,60
the whole,1616,16,31,5,2,2,1,57
star trek,1615,144,132,14,7,9,4,310
be my,1615,33,35,8,3,5,2,86
for an,1615,27,19,2,5,4,0,57
for bookings,1615,12,7,4,2,5,0,30
law enforcement,1614,3,4,0,0,0,0,7
my music,1613,37,21,6,2,4,1,71
texas tech,1613,12,14,0,0,0,0,26
group of,1613,11,7,1,1,1,1,22
author and,1612,42,49,4,1,12,3,111
the word,1612,23,28,3,4,1,0,59
seeker of,1611,28,46,1,3,2,1,81
blm acab,1610,289,275,148,99,116,20,947
of law,1610,23,27,1,0,0,1,52
3 5,1610,8,6,0,0,1,0,15
made me,1609,18,28,2,3,11,1,63
streamer and,1608,64,35,13,15,14,3,144
community college,1608,14,46,1,2,2,1,66
3 0,1608,6,6,1,1,1,0,15
for any,1606,24,28,2,3,5,0,62
you live,1606,12,22,0,2,3,0,39
nice to,1603,57,61,9,4,11,2,144
and food,1603,39,49,7,4,3,3,105
and no,1602,32,46,3,3,7,0,91
if we,1602,18,33,3,1,3,0,58
me is,1601,18,30,2,0,4,0,54
a variety,1600,29,29,7,2,2,0,69
4 life,1600,14,24,4,0,3,1,46
a husband,1600,19,5,0,0,0,1,25
sign up,1600,9,9,1,0,1,0,20
stuff i,1599,102,51,13,8,17,1,192
a twitter,1598,34,37,11,4,7,2,95
investment advice,1598,3,2,0,0,0,0,5
just wanna,1597,32,59,12,7,9,0,119
the earth,1597,29,56,3,4,4,0,96
and digital,1596,31,33,6,0,5,6,81
also i,1595,60,62,19,13,10,3,167
i'm also,1595,41,38,11,3,6,2,101
and living,1595,14,18,5,2,0,0,39
i run,1594,68,61,9,4,8,2,152
a dog,1594,60,70,12,3,4,1,150
a dad,1594,50,3,2,2,1,0,58
and new,1594,18,20,2,1,2,0,43
is dedicated,1594,1,1,0,0,0,0,2
find a,1593,23,25,0,3,0,0,51
build a,1592,15,23,4,2,0,0,44
to earth,1592,6,11,3,2,0,0,22
able to,1591,16,21,2,3,5,0,47
with our,1591,4,7,4,0,1,0,16
ncaa id,1591,0,0,0,0,0,0,0
vp of,1590,54,55,1,1,1,0,112
available now,1590,34,35,2,1,3,0,75
baseball and,1590,33,20,0,1,0,1,55
right to,1589,13,22,3,3,5,0,46
public policy,1588,43,54,3,4,0,0,104
let’s go,1588,10,14,1,1,3,0,29
i always,1587,15,38,3,1,6,0,63
play with,1585,26,26,3,1,5,1,62
old school,1585,20,8,2,1,2,0,33
by me,1583,114,99,53,26,26,10,328
that likes,1583,66,32,18,6,9,1,132
visit our,1583,0,0,0,0,0,0,0
a fun,1582,28,23,4,2,3,1,61
for good,1581,46,45,0,0,3,1,95
the music,1581,22,30,2,3,3,1,61
d c,1581,9,29,2,0,2,0,42
of four,1581,17,18,1,0,0,0,36
assistant coach,1581,9,4,1,0,0,0,14
the journey,1580,8,16,2,2,3,0,31
white sox,1579,21,9,1,1,0,0,32
player and,1578,82,38,12,4,5,0,141
and being,1578,39,55,7,4,7,1,113
we need,1578,23,23,1,0,1,0,48
a single,1578,13,19,0,4,3,1,40
man with,1578,33,3,1,1,1,0,39
project manager,1577,37,54,1,1,2,0,95
in need,1577,20,31,2,2,4,0,59
to inspire,1577,3,12,1,0,2,0,18
half of,1575,86,108,14,7,18,1,234
born to,1575,17,29,3,2,3,1,55
in florida,1574,20,23,2,1,1,0,47
public relations,1574,13,23,0,1,2,0,39
makes you,1573,15,26,7,1,2,1,52
as much,1571,23,27,1,4,3,0,58
estate broker,1571,1,2,0,0,0,0,3
stream on,1570,54,32,12,2,7,6,113
along the,1569,26,19,2,2,3,0,52
time is,1568,18,18,1,0,6,0,43
mama to,1567,1,109,2,0,6,1,119
i said,1567,22,61,1,0,4,3,91
//open spotify,1566,34,11,3,1,0,1,50
when it,1566,15,23,4,4,0,0,46
to life,1566,13,24,1,1,1,0,40
just ask,1565,18,10,3,2,0,2,35
or a,1563,36,35,7,1,9,2,90
is now,1563,22,22,4,0,6,2,56
and travel,1563,10,30,0,1,1,1,43
i wish,1562,34,52,5,2,8,3,104
huge fan,1562,27,31,2,3,2,0,65
ig -,1562,8,14,4,0,1,0,27
is me,1561,25,43,2,4,7,0,81
and is,1561,23,21,4,3,4,2,57
and let,1561,9,24,0,2,0,0,35
beer and,1560,32,25,2,2,2,0,63
way too,1559,92,117,16,8,15,0,248
team all,1559,1,1,0,0,0,0,2
notre dame,1556,10,11,0,0,0,0,21
tv shows,1555,23,81,4,0,5,0,113
she is,1555,7,37,1,2,6,0,53
up the,1555,16,25,2,1,3,0,47
or die,1553,27,30,6,4,4,2,73
searching for,1553,21,29,1,4,4,0,59
in every,1552,11,27,2,3,4,0,47
live laugh,1552,9,21,5,4,5,0,44
coach -,1551,4,2,0,0,0,0,6
striving to,1550,22,39,2,0,2,0,65
new people,1550,27,11,2,2,1,0,43
and learning,1549,22,32,7,2,5,1,69
take me,1547,20,41,3,2,9,0,75
support the,1546,14,23,3,2,3,0,45
makeup artist,1544,3,45,7,3,14,2,74
a whole,1543,38,65,6,5,5,2,121
i teach,1542,47,78,6,0,2,2,135
out and,1542,24,24,2,4,1,0,55
a true,1542,14,23,0,0,2,0,39
can help,1542,8,13,1,0,0,0,22
true crime,1541,16,141,4,2,8,1,172
like that,1540,31,38,5,3,4,0,81
the original,1540,20,18,3,1,1,1,44
horror movies,1539,61,73,10,4,5,1,154
what they,1538,14,14,2,2,3,0,35
no longer,1537,29,33,5,1,4,0,72
now in,1536,33,33,2,2,2,0,72
news junkie,1535,16,36,2,2,0,0,56
and wife,1535,2,43,1,0,2,0,48
services for,1535,2,12,0,0,0,0,14
nerd and,1533,119,101,13,9,15,3,260
those of,1532,70,69,6,5,4,2,156
//www amazon,1532,29,29,6,1,2,1,68
working for,1531,28,52,0,0,2,0,82
you i,1531,27,30,0,2,2,1,62
you were,1531,15,37,4,1,2,1,60
too short,1531,11,18,0,2,3,1,35
and surrounding,1531,0,1,0,0,0,0,1
he him,1531,0,0,0,0,0,0,0
see me,1530,28,26,4,4,7,2,71
before you,1530,18,25,4,1,4,0,52
each day,1530,14,15,1,3,1,0,34
tampa bay,1529,13,9,0,1,1,0,24
live my,1528,13,29,3,3,0,0,48
lost in,1525,33,47,3,5,8,0,96
helping others,1524,12,10,0,1,1,0,24
live your,1523,4,18,4,1,0,0,27
twitter to,1522,26,37,3,4,5,1,76
now a,1522,27,22,1,6,4,0,60
to join,1522,14,19,2,2,2,0,39
contact us,1522,0,0,0,0,1,0,1
of good,1519,22,58,4,3,0,0,87
work at,1518,48,36,5,0,6,0,95
the human,1518,32,34,6,5,7,0,84
making a,1518,32,29,3,4,1,1,70
girl in,1517,1,107,1,2,10,0,121
that makes,1517,21,34,5,7,3,0,70
my onlyfans,1516,11,22,0,2,4,0,39
retired from,1516,10,9,1,0,2,0,22
make my,1515,31,38,5,6,7,0,87
a mask,1514,52,130,12,3,9,0,206
a lil,1514,28,55,10,9,12,0,114
school teacher,1512,36,75,4,2,2,0,119
in south,1512,14,10,1,0,0,0,25
good food,1511,16,42,5,1,2,0,66
the national,1511,8,10,2,0,1,0,21
not monitored,1511,0,2,0,0,0,0,2
write about,1510,57,95,6,3,4,0,165
to chat,1510,48,14,9,4,1,0,76
you just,1510,18,29,6,2,5,0,60
my ig,1509,9,11,2,2,1,0,25
https //opensea,1509,2,5,0,0,1,0,8
york city,1508,20,14,1,1,1,0,37
the fuck,1507,26,37,11,6,14,1,95
you feel,1505,9,26,4,1,1,0,41
registered nurse,1503,10,45,2,2,2,0,61
people i,1502,31,28,3,3,3,0,68
a bot,1502,23,22,3,1,2,0,51
defender of,1501,19,29,1,0,1,0,50
that we,1501,17,12,1,1,0,0,31
i miss,1500,33,66,3,2,10,2,116
the dark,1500,29,48,14,5,7,1,104
criminal justice,1500,20,39,6,2,3,0,70
are in,1500,19,17,5,2,6,0,49
what i’m,1497,38,84,10,4,13,1,150
i made,1497,63,44,9,6,8,3,133
the 1,1497,3,6,1,1,1,0,12
and ceo,1496,13,13,1,0,0,0,27
home to,1495,8,8,1,0,0,0,17
family country,1495,1,0,0,0,0,0,1
art of,1494,31,27,10,4,4,0,76
creator and,1493,59,26,14,5,3,1,108
learning and,1491,26,36,6,2,1,1,72
along with,1490,14,14,3,2,1,0,34
of those,1488,43,36,13,3,9,1,105
a love,1488,31,39,9,5,5,1,90
away from,1488,24,29,4,1,6,0,64
ready for,1488,16,30,6,6,3,0,61
what makes,1488,16,22,1,1,5,1,46
like i,1487,35,41,7,2,5,0,90
at me,1487,36,25,6,1,6,0,74
on insta,1486,40,83,14,13,26,0,176
and professional,1486,41,46,6,8,6,0,107
visual artist,1485,24,35,14,5,8,0,86
fan page,1485,15,35,3,2,8,0,63
1/2 of,1484,64,74,6,9,14,3,170
and one,1484,19,37,0,2,3,1,62
by birth,1483,27,34,0,3,3,0,67
track and,1482,3,2,0,0,0,0,5
day i,1481,31,34,10,3,4,2,84
women and,1481,10,29,5,1,4,0,49
customer service,1481,12,7,2,0,2,1,24
time not,1480,16,32,3,3,6,2,62
figure out,1479,46,59,11,6,6,0,128
think i,1479,26,49,3,3,4,0,85
to one,1479,29,26,5,2,1,0,63
tech and,1478,44,28,6,4,5,0,87
a cool,1478,36,32,7,4,3,2,84
my other,1477,24,35,7,1,7,2,76
living and,1477,13,16,4,1,2,0,36
through life,1476,56,53,14,6,7,0,136
i own,1475,39,24,8,3,4,0,78
http //patreon,1474,127,103,47,14,19,5,315
and country,1473,3,6,0,0,1,0,10
to think,1472,22,36,7,2,7,0,74
visit my,1472,10,14,2,0,2,0,28
home for,1472,9,8,0,1,1,0,19
and if,1471,10,27,4,1,2,0,44
in one,1471,16,18,6,0,2,1,43
are always,1470,54,50,12,10,9,0,135
never give,1470,5,6,1,0,2,0,14
of business,1470,9,3,1,0,0,0,13
doing my,1469,40,97,16,7,12,1,173
friend of,1469,48,72,6,3,2,1,132
live the,1469,16,20,3,0,0,0,39
and football,1468,9,9,0,0,0,0,18
is here,1467,12,15,1,3,4,1,36
don't follow,1466,57,37,9,5,11,3,122
find my,1466,42,45,8,4,11,0,110
jesus follower,1465,10,26,0,0,0,0,36
here https,1464,37,23,7,2,7,0,76
your cash,1463,0,0,0,0,0,0,0
run by,1462,19,17,6,6,0,1,49
1 9,1462,6,12,0,1,0,0,19
breaking news,1460,7,20,0,1,1,0,29
keep your,1459,10,26,3,0,3,0,42
classic rock,1459,10,9,1,0,0,0,20
d a,1459,5,13,1,0,1,0,20
managing editor,1458,54,94,1,2,5,0,156
these are,1458,26,42,5,1,3,2,79
the middle,1458,14,35,6,1,3,0,59
me as,1457,35,25,6,2,1,0,69
views of,1456,65,50,2,2,0,0,119
get my,1456,23,27,7,2,5,1,65
nft artist,1456,7,12,0,0,2,0,21
http //ko-fi,1455,148,233,93,26,52,9,561
help me,1455,22,28,6,9,3,0,68
an old,1455,26,32,3,0,1,0,62
trump is,1454,6,7,1,0,0,0,14
trump won,1454,0,0,0,0,0,0,0
make money,1453,3,1,0,0,0,0,4
yrs old,1451,41,80,17,7,17,11,173
award winner,1451,33,49,2,1,7,0,92
many things,1450,72,101,12,4,9,3,201
public school,1449,27,71,2,0,3,0,103
the sky,1449,25,33,3,2,7,1,71
it's all,1449,23,23,4,2,1,2,55
special education,1449,12,39,1,0,0,1,53
a kid,1449,20,20,3,3,4,1,51
the mind,1449,15,12,3,1,1,3,35
community and,1448,14,21,4,0,1,1,41
give you,1448,10,20,5,1,2,0,38
truth seeker,1446,9,6,0,0,0,0,15
the highest,1446,3,8,0,1,2,0,14
be here,1445,31,49,6,10,5,2,103
you never,1445,19,13,2,1,2,0,37
only one,1441,13,24,0,0,1,0,38
create a,1441,9,9,3,0,2,0,23
kinds of,1440,31,18,8,1,4,2,64
out with,1440,20,39,2,1,2,0,64
creator for,1440,36,12,5,3,1,0,57
m sica,1440,2,6,0,0,1,0,9
civil rights,1439,41,57,4,1,2,1,106
and people,1439,20,30,1,3,1,0,55
everything in,1439,14,16,2,1,0,0,33
engineer at,1438,131,27,4,5,2,4,173
family first,1437,2,3,0,0,0,0,5
my dogs,1436,20,58,2,0,3,0,83
love being,1434,10,18,1,3,1,0,33
with over,1434,4,0,1,0,0,0,5
see what,1433,13,19,4,0,3,0,39
guy in,1431,60,3,0,5,0,0,68
the greater,1431,6,9,1,1,0,0,17
work on,1428,52,44,8,3,2,1,110
be good,1428,43,37,5,3,4,0,92
i create,1426,28,26,7,2,8,0,71
boys and,1426,13,15,2,3,2,0,35
memes and,1425,80,56,9,9,8,4,166
might be,1425,54,56,5,3,3,1,122
justice for,1425,28,45,3,1,2,0,79
day and,1425,30,29,2,3,6,0,70
sports music,1425,16,10,1,0,0,0,27
random thoughts,1424,31,46,2,3,4,0,86
hope to,1424,20,22,3,2,4,1,52
barstool athlete,1424,1,5,1,0,0,0,7
see my,1423,37,39,4,4,6,0,90
youtube http,1423,37,20,4,3,2,0,66
for now,1422,44,42,9,15,9,2,121
i might,1422,41,50,6,8,9,0,114
even if,1422,20,26,6,4,0,1,57
with love,1422,11,30,2,1,3,0,47
of mind,1421,12,19,3,1,1,0,36
romans 8,1421,1,13,1,0,0,0,15
live love,1421,2,8,0,0,0,0,10
and content,1420,35,28,3,1,5,0,72
bunch of,1419,55,57,8,3,6,1,130
on amazon,1419,29,21,0,0,2,1,53
tv and,1418,32,66,3,2,4,1,108
fuck you,1418,22,26,14,6,5,2,75
can get,1417,17,21,4,0,3,1,46
she /,1417,1,0,2,0,0,0,3
not represent,1416,88,65,4,9,3,0,169
in los,1415,20,16,0,0,2,0,38
https //m,1414,13,8,2,1,0,1,25
kind to,1412,42,47,9,4,8,0,110
culture and,1412,30,43,4,2,0,2,81
i’m doing,1411,33,81,14,6,15,1,150
i block,1411,43,50,15,3,2,2,115
best to,1411,41,48,7,2,10,3,111
by choice,1411,28,44,2,0,3,0,77
new single,1411,10,11,1,2,1,0,25
black and,1410,44,45,11,12,13,1,126
just to,1410,25,31,3,5,7,0,71
degree in,1410,29,23,3,3,3,0,61
coffee addict,1409,39,114,6,1,7,1,168
manager of,1409,37,34,5,6,2,2,86
the biggest,1409,20,15,2,1,1,0,39
nature and,1408,14,37,6,2,3,3,65
the news,1408,21,28,1,0,2,0,52
and former,1407,30,25,2,3,0,1,61
because of,1407,22,17,4,0,1,0,44
of their,1407,6,6,2,0,0,0,14
green bay,1406,10,13,0,0,0,0,23
english teacher,1405,45,95,0,1,2,0,143
my job,1405,17,30,2,1,1,0,51
of 2024,1405,6,3,0,1,0,0,10
to dm,1404,59,41,13,5,3,1,122
media and,1404,23,18,6,1,7,1,56
family is,1404,3,3,0,0,1,1,8
ice cream,1403,27,90,6,0,3,1,127
things are,1403,19,28,3,2,2,0,54
more about,1403,16,24,2,3,2,0,47
s a,1403,12,18,0,2,1,0,33
estate investor,1403,2,2,0,0,0,0,4
see it,1402,10,14,0,0,1,0,25
take care,1401,21,32,2,2,6,1,64
against the,1401,24,26,2,3,2,0,57
my old,1401,14,29,5,1,6,0,55
crypto nft,1401,1,1,1,0,0,0,3
version of,1400,21,33,5,6,2,0,67
fan love,1400,3,7,2,0,0,0,12
student in,1399,56,112,18,9,14,1,210
life you,1399,9,12,0,1,0,0,22
thanks for,1398,16,24,4,3,4,1,52
basketball and,1398,12,11,0,1,0,0,24
the worst,1397,38,42,6,3,4,1,94
me you,1397,20,12,6,3,2,1,44
of public,1396,25,41,4,1,2,0,73
a non-profit,1396,2,1,0,0,0,0,3
is more,1395,18,18,4,1,2,0,43
not just,1395,14,13,1,2,7,1,38
day to,1395,9,14,1,1,3,1,29
f tbol,1395,4,8,0,1,0,0,13
me your,1393,27,37,11,4,5,1,85
no more,1393,17,15,11,4,2,1,50
none of,1392,26,27,5,2,3,1,64
videos and,1392,35,11,2,3,3,1,55
share my,1392,25,22,2,2,4,0,55
games i,1391,86,35,9,6,9,1,146
president trump,1391,0,0,0,0,0,0,0
amante de,1389,2,4,0,0,0,0,6
rather be,1387,23,64,4,1,1,0,93
the beautiful,1387,14,20,1,1,2,0,38
a black,1386,20,21,7,5,3,1,57
long as,1386,20,20,2,2,5,2,51
and still,1385,23,28,3,1,3,1,59
married with,1385,11,10,1,3,0,0,25
be on,1384,22,21,3,0,3,0,49
a red,1383,19,60,1,0,2,0,82
but still,1383,20,41,10,5,4,0,80
expressed here,1382,59,49,4,1,5,5,123
in and,1380,18,13,1,1,1,0,34
a bitch,1379,17,58,9,1,4,0,89
a t,1379,12,17,2,0,0,0,31
that has,1379,11,13,2,3,2,0,31
school football,1379,1,0,0,0,0,0,1
don’t care,1378,13,23,1,0,1,2,40
anything else,1377,26,17,6,1,2,1,53
in general,1376,47,49,8,4,5,1,114
rts are,1376,37,27,5,5,1,1,76
a bio,1376,25,22,7,5,0,0,59
1st team,1376,1,0,0,0,0,0,1
who wants,1375,40,11,3,5,4,1,64
board of,1374,31,32,1,1,0,0,65
and share,1374,20,19,1,1,3,0,44
math teacher,1373,39,53,2,0,2,0,96
house of,1373,17,25,3,5,6,1,57
n de,1373,0,1,0,0,0,0,1
artist i,1372,56,76,17,7,23,5,184
mommy of,1372,0,22,3,0,2,1,28
i read,1370,53,128,6,4,7,1,199
a cat,1368,54,108,14,10,15,0,201
history of,1368,38,34,1,0,1,0,74
the soul,1367,8,22,1,0,3,0,34
god my,1367,2,2,0,0,1,0,5
the void,1365,92,164,19,11,30,2,318
at this,1365,28,57,11,6,7,0,109
just the,1364,31,35,8,1,4,3,82
and watch,1364,43,30,3,1,0,0,77
heart and,1364,13,22,2,1,1,0,39
mine and,1363,81,51,6,4,5,2,149
my instagram,1363,26,25,2,3,3,2,61
what i'm,1362,46,64,17,7,10,3,147
my journey,1361,10,17,2,0,5,0,34
data science,1360,73,39,3,3,3,1,122
back the,1360,5,6,1,0,0,0,12
afraid to,1359,18,36,4,2,2,1,63
for http,1358,38,26,2,4,0,1,71
music enthusiast,1357,43,40,5,6,1,0,95
related to,1356,14,26,1,2,0,1,44
data scientist,1354,99,42,3,6,7,0,157
i watch,1354,34,61,2,2,7,0,106
a friend,1354,19,39,8,4,7,2,79
nothing is,1354,17,13,3,0,10,0,43
in california,1353,19,25,3,1,1,0,49
and artist,1352,66,66,19,8,15,6,180
producer for,1352,53,50,8,2,1,0,114
that the,1352,14,18,1,1,2,0,36
use this,1351,41,36,10,1,10,1,99
myself and,1351,26,27,3,2,4,0,62
with friends,1351,20,20,4,4,4,0,52
life for,1350,5,8,2,1,3,0,19
new album,1349,17,11,0,0,2,0,30
501 c,1349,1,1,1,0,0,1,4
great kids,1348,8,12,0,0,1,1,22
making the,1347,25,24,5,2,2,1,59
people of,1347,15,14,2,0,0,0,31
n y,1347,2,4,1,0,0,0,7
with some,1346,22,28,3,1,3,1,58
you got,1346,18,14,1,2,2,0,37
i put,1345,41,46,8,5,13,1,114
me i'm,1345,18,29,10,4,1,2,64
views and,1343,53,58,5,3,1,1,121
to tweet,1343,34,48,4,0,4,1,91
and marketing,1343,13,15,3,1,0,0,32
free thinker,1343,4,8,1,0,0,1,14
go brandon,1343,1,0,0,0,0,0,1
development and,1342,10,22,1,2,2,0,37
you find,1341,13,12,1,1,6,0,33
the more,1339,12,31,2,0,0,0,45
to those,1339,11,11,0,0,1,0,23
of education,1338,14,35,2,1,0,0,52
association of,1338,2,4,0,0,0,0,6
to survive,1337,24,51,7,4,5,0,91
and public,1337,18,27,1,1,1,0,48
a kind,1337,10,8,0,0,6,1,25
pastor of,1337,9,2,0,0,0,0,11
day trader,1336,1,4,0,0,0,0,5
has to,1335,16,12,5,0,2,1,36
everything you,1335,6,9,1,0,2,0,18
use twitter,1334,25,36,9,6,9,0,85
ig http,1334,23,30,5,2,3,0,63
women in,1334,2,55,1,0,0,0,58
to eat,1334,16,33,4,2,2,0,57
and go,1334,18,21,3,0,2,2,46
can call,1333,57,77,30,16,20,3,203
digital media,1332,29,32,2,1,5,1,70
rest of,1332,28,34,4,0,0,0,66
fun with,1332,8,12,1,1,0,0,22
necessarily in,1331,44,48,1,1,1,3,98
is it,1331,19,42,8,0,6,0,75
only fans,1331,5,14,3,1,2,0,25
but it,1330,32,21,5,2,0,1,61
of medicine,1330,21,27,1,1,0,0,50
do all,1330,9,12,1,0,2,1,25
quality of,1330,7,5,0,0,0,1,13
the leading,1330,1,0,0,0,0,0,1
it’s all,1329,17,26,5,0,4,1,53
manchester united,1329,7,2,0,0,0,0,9
hi my,1326,35,39,13,5,11,2,105
care for,1326,12,20,3,0,1,1,37
god i,1326,5,3,1,2,2,0,13
in north,1325,7,7,1,1,0,0,16
r e,1323,9,19,4,1,0,1,34
a member,1323,15,4,4,2,1,0,26
puerto rican,1322,23,30,9,6,4,0,72
rock and,1322,27,22,4,1,1,1,56
and will,1322,26,18,4,1,3,0,52
as long,1322,19,20,2,2,5,2,50
m ed,1321,23,59,2,0,4,1,89
hall of,1321,12,6,0,0,2,0,20
created by,1320,19,10,0,1,1,0,31
the home,1320,3,2,1,0,0,0,6
bless america,1320,0,0,0,0,0,0,0
and that,1319,26,24,4,1,5,1,61
and what,1319,11,14,2,2,1,0,30
of south,1319,6,15,0,1,0,1,23
to achieve,1319,5,12,0,0,1,1,19
streamer on,1318,53,41,5,5,6,1,111
my beautiful,1318,12,14,2,0,1,0,29
us and,1318,7,7,1,0,0,1,16
we must,1316,11,15,7,0,4,0,37
and science,1315,40,58,5,1,2,2,108
of time,1315,40,29,9,2,8,0,88
and many,1315,26,28,4,2,2,0,62
40 years,1315,10,5,1,0,0,0,16
state champions,1315,0,0,0,0,0,0,0
no idea,1314,40,77,18,10,10,2,157
originally from,1314,36,18,0,1,2,3,60
to fight,1314,21,30,4,0,3,0,58
you gotta,1314,12,28,1,1,3,0,45
to 4,1314,9,27,2,1,2,0,41
to protect,1314,7,11,3,0,0,0,21
t f,1314,5,12,0,2,0,0,19
options trader,1314,2,0,0,0,0,0,2
old and,1313,23,25,5,1,5,1,60
keep up,1313,15,26,1,1,3,1,47
follow and,1313,10,6,2,0,3,0,21
student athlete,1312,4,4,1,0,0,0,9
what a,1311,23,40,4,3,6,0,76
email me,1311,25,38,6,2,1,2,74
and author,1311,25,27,3,1,5,1,62
photography and,1311,32,25,1,0,1,0,59
e a,1310,7,10,4,2,4,0,27
my account,1309,27,26,4,5,2,3,67
don't care,1309,24,22,4,1,2,5,58
could be,1308,33,42,3,0,4,1,83
i look,1306,33,27,5,5,5,0,75
for this,1304,25,34,7,4,4,1,75
founded by,1304,0,2,0,0,0,0,2
audio engineer,1303,57,25,14,6,7,0,109
out to,1303,20,27,3,3,3,0,56
and field,1303,3,2,0,0,0,0,5
roll tide,1301,4,13,0,1,0,0,18
thinking about,1299,54,100,12,6,12,1,185
friend to,1299,52,44,10,2,10,1,119
my profile,1299,36,23,9,3,3,1,75
off my,1299,26,38,3,2,3,1,73
tweets by,1299,35,15,11,1,5,3,70
the show,1299,14,19,0,4,1,0,38
sharing my,1299,15,20,1,0,1,0,37
producer and,1298,34,22,6,6,4,0,72
c 3,1298,1,1,1,0,0,1,4
and am,1296,30,28,6,8,4,0,76
and anything,1296,24,20,6,0,0,1,51
then i,1295,19,23,1,2,2,0,47
/ i,1294,46,55,8,13,11,4,137
music movies,1294,42,24,2,1,0,0,69
call of,1294,17,12,1,1,0,0,31
crypto trader,1294,1,3,0,0,0,0,4
red state,1293,13,55,0,0,0,0,68
enjoying the,1293,9,9,0,0,0,0,18
call us,1292,1,0,2,0,0,0,3
as it,1291,19,25,1,2,3,0,50
years young,1291,14,21,4,1,3,1,44
girl living,1290,0,53,1,0,3,0,57
conservative christian,1290,0,0,0,0,0,0,0
was the,1289,34,32,3,3,4,0,76
a bunch,1288,50,56,7,3,5,2,123
constitutional conservative,1288,0,0,0,0,0,0,0
way i,1287,10,20,3,1,1,1,36
i care,1286,25,41,7,4,4,1,82
else is,1286,19,24,4,0,1,1,49
engineer and,1285,71,26,6,3,4,0,110
living with,1285,27,61,3,0,6,3,100
man in,1285,39,7,1,3,0,1,51
fighting games,1284,152,22,20,19,7,5,225
am just,1284,17,23,5,0,4,0,49
of florida,1284,21,19,0,0,0,0,40
beautiful wife,1284,6,3,1,0,1,0,11
and nft,1284,3,3,0,1,0,0,7
a global,1284,0,4,1,0,1,0,6
be friends,1283,47,81,8,6,14,3,159
as they,1283,10,15,2,0,0,1,28
hoping to,1282,44,28,2,5,2,1,82
and education,1282,12,18,1,0,0,1,32
where we,1282,7,8,0,1,1,0,17
purveyor of,1281,72,43,8,8,7,0,138
stuck in,1281,42,47,7,5,10,0,111
a strong,1281,11,21,1,0,1,1,35
come true,1281,8,10,1,1,2,0,22
then you,1280,20,15,2,1,1,1,40
but also,1279,53,80,13,3,7,4,160
i mean,1279,16,31,8,0,6,1,62
nothing but,1279,13,23,7,2,7,0,52
10 years,1279,18,14,3,0,3,1,39
is short,1278,7,26,4,0,3,0,40
back up,1278,8,20,2,1,2,0,33
watch me,1277,28,20,7,4,5,0,64
https //twitch,1277,30,17,4,5,2,2,60
a part,1276,12,17,3,1,0,0,33
as we,1276,14,12,0,0,3,0,29
lived in,1275,9,19,0,0,3,0,31
provider of,1275,3,3,1,1,0,0,8
still a,1274,24,44,8,3,7,1,87
find your,1274,11,11,3,2,1,0,28
a positive,1274,10,11,0,2,1,0,24
e o,1274,2,10,0,1,0,0,13
are an,1272,8,7,3,0,3,0,21
connect with,1272,11,7,1,0,0,0,19
he /,1272,0,0,0,0,0,0,0
know that,1271,16,34,5,3,0,0,58
http //soundcloud,1270,31,14,6,5,5,1,62
of games,1269,115,48,7,5,5,4,184
this twitter,1269,25,33,9,1,2,1,71
are just,1269,22,30,4,2,6,1,65
the west,1269,17,26,4,1,0,0,48
of duty,1269,14,8,1,0,0,0,23
to it,1268,16,21,2,1,0,2,42
invest in,1268,9,6,2,0,0,0,17
solutions to,1268,3,0,0,0,0,0,3
me i’m,1267,21,29,2,0,5,1,58
behind the,1266,22,20,1,5,1,2,51
only the,1266,9,12,0,0,3,1,25
for every,1265,8,21,0,0,1,0,30
motivational speaker,1265,4,1,2,0,0,0,7
game dev,1264,191,87,42,20,23,4,367
bts twt,1264,3,120,4,0,7,0,134
musician and,1263,61,26,13,9,9,1,119
any of,1263,28,27,6,1,10,2,74
team of,1263,0,0,0,0,1,1,2
own not,1262,68,85,7,2,3,4,169
art by,1261,150,155,45,29,31,4,414
so many,1261,25,39,6,1,2,0,73
in 2022,1261,23,28,3,0,1,1,56
comes to,1261,12,14,2,2,2,0,32
do a,1260,43,36,12,7,5,2,105
to people,1260,39,30,3,2,3,0,77
follow you,1260,14,11,2,1,1,1,30
to connect,1260,10,14,2,0,0,1,27
my president,1260,0,7,1,1,1,0,10
an average,1259,23,12,2,0,0,1,38
who can,1259,13,15,1,2,3,0,34
and for,1258,21,18,2,1,2,0,44
sponsored by,1257,30,17,3,4,1,0,55
and on,1257,22,15,2,1,2,0,42
my cat,1255,68,137,18,10,20,0,253
text me,1255,5,7,1,0,0,0,13
the ocean,1253,17,51,8,2,5,0,83
tik tok,1253,16,24,6,1,5,2,54
only thing,1253,15,20,1,4,2,0,42
helping you,1253,0,2,2,0,1,0,5
and dog,1252,38,73,4,3,2,1,121
cubs fan,1252,26,21,0,2,2,0,51
back on,1252,21,22,1,1,3,1,49
or not,1251,22,18,6,2,1,0,49
learn to,1251,13,22,2,1,3,1,42
the public,1251,7,11,2,3,0,0,23
free spirit,1250,2,18,1,1,2,0,24
laugh love,1249,5,11,3,2,5,0,26
best in,1249,7,8,2,3,2,1,23
to look,1248,32,28,2,4,8,2,76
music art,1248,23,32,2,4,6,0,67
the bay,1248,30,14,0,4,4,0,52
for everything,1248,9,19,1,0,1,0,30
it or,1248,9,18,0,1,2,0,30
types of,1248,9,7,2,4,1,0,23
tech enthusiast,1247,44,20,1,5,1,1,72
love a,1246,22,35,2,4,5,0,68
breast cancer,1246,3,56,0,0,1,0,60
and follow,1246,10,10,0,1,0,0,21
season ticket,1246,3,5,0,0,1,0,9
a reason,1245,8,15,0,0,2,0,25
poker player,1245,7,4,0,1,0,0,12
a nerd,1244,84,59,11,8,5,4,171
you must,1244,7,14,4,2,2,1,30
for us,1244,9,16,1,0,3,1,30
living a,1244,11,15,0,1,1,0,28
bad at,1243,99,110,28,13,21,3,274
arts and,1243,19,35,5,2,7,1,69
writer artist,1242,56,140,37,13,19,2,267
men and,1242,13,9,2,0,3,0,27
website for,1242,6,13,3,0,3,1,26
my twitch,1240,33,15,9,7,2,1,67
now and,1240,25,23,4,4,4,1,61
a follow,1240,19,10,1,1,0,1,32
https //soundcloud,1240,17,7,3,2,1,0,30
a nonprofit,1240,4,4,0,0,0,0,8
owned and,1240,2,4,0,0,0,0,6
stay humble,1240,2,4,0,0,0,0,6
cowboys fan,1239,9,5,0,1,0,0,15
a child,1238,14,16,2,0,4,1,37
who love,1238,6,19,1,1,2,1,30
amateur photographer,1237,52,38,5,1,3,0,99
new things,1237,23,15,2,1,4,2,47
business development,1237,4,5,0,1,0,0,10
girls basketball,1237,0,0,0,0,0,0,0
sugar baby,1236,1,4,1,1,0,0,7
educator and,1235,21,48,7,3,1,0,80
coraz n,1235,1,3,0,1,0,0,5
someone who,1234,24,28,4,1,2,0,59
interest in,1234,27,19,2,0,2,1,51
is about,1234,14,24,2,0,0,0,40
the metaverse,1234,1,8,0,0,1,1,11
nsfw content,1233,98,59,23,16,20,7,223
that make,1233,27,27,3,2,3,1,63
in his,1233,25,6,2,2,0,2,37
law firm,1233,4,1,0,0,1,0,6
know i,1232,19,27,5,4,4,1,60
matter what,1232,14,12,1,0,2,0,29
and justice,1231,26,40,3,3,2,0,74
think about,1231,23,23,6,3,9,1,65
for sale,1231,10,11,3,2,2,0,28
for anything,1230,25,24,0,0,3,1,53
native american,1229,25,23,6,1,2,1,58
assistant principal,1229,3,16,0,0,0,0,19
artist -,1228,62,66,33,22,16,4,203
and others,1228,37,43,4,4,3,0,91
have my,1228,18,39,1,0,4,0,62
want a,1228,20,21,2,2,0,0,45
of 6,1228,6,14,1,0,1,1,23
washington dc,1227,11,12,1,0,0,0,24
type of,1227,6,10,3,0,2,1,22
and information,1227,4,5,1,0,0,0,10
chief of,1226,21,30,1,0,1,1,54
citizen of,1226,15,24,1,1,1,0,42
art is,1225,38,61,11,8,8,3,129
like and,1225,46,23,7,8,6,1,91
and political,1225,43,23,4,5,0,4,79
looking at,1225,37,30,2,4,2,0,75
about your,1225,18,23,7,2,1,0,51
financial services,1224,3,7,0,0,0,0,10
bestselling author,1223,17,93,3,1,2,0,116
https //open,1223,24,9,3,1,0,1,38
in public,1222,25,40,3,3,3,1,75
me but,1222,18,22,4,1,3,0,48
updates and,1222,1,6,3,0,0,0,10
a pretty,1221,19,27,6,5,5,0,62
my home,1221,12,30,2,0,2,0,46
stay at,1220,28,34,2,3,1,0,68
the little,1220,22,26,2,2,1,0,53
you go,1219,13,28,4,2,3,1,51
we live,1219,10,13,2,0,1,1,27
will follow,1219,14,5,3,0,1,1,24
2 boys,1219,4,11,0,0,3,0,18
and tech,1218,52,20,2,4,2,1,81
also like,1217,52,39,7,6,0,0,104
is home,1217,20,28,1,2,4,0,55
to cook,1217,18,14,2,3,2,1,40
it real,1217,3,10,2,1,2,0,18
this country,1217,3,8,1,1,1,0,14
game enthusiast,1216,133,65,19,10,8,6,241
just looking,1216,18,10,3,0,0,0,31
to offer,1216,9,14,1,1,1,0,26
i keep,1215,26,30,3,1,6,1,67
be great,1215,7,7,1,1,0,0,16
monitored 24/7,1215,0,0,0,0,0,0,0
2nd amendment,1214,1,0,0,0,0,0,1
family owned,1214,0,0,1,0,0,0,1
get vaccinated,1213,42,92,4,3,5,1,147
the change,1213,13,29,0,1,2,0,45
easy going,1213,6,1,0,1,0,0,8
is going,1212,20,24,4,6,9,0,63
all time,1211,17,17,3,0,0,0,37
y la,1211,1,3,0,0,0,0,4
ticket holder,1210,4,4,0,0,1,0,9
of any,1209,21,28,3,2,0,1,55
executive producer,1209,21,28,0,0,3,0,52
think of,1209,13,21,7,2,5,0,48
get out,1209,17,17,2,2,2,0,40
a journey,1209,16,11,2,1,2,1,33
to music,1208,28,28,1,2,2,2,63
cyber security,1208,23,9,2,0,1,0,35
this life,1208,8,17,1,0,1,0,27
truck driver,1208,4,6,2,1,0,0,13
the left,1207,31,24,5,3,1,1,65
first and,1207,9,27,5,1,3,0,45
forward to,1207,11,8,1,0,1,1,22
ole miss,1207,2,11,0,0,0,0,13
art music,1206,24,41,9,3,5,1,83
check my,1206,24,29,9,12,6,0,80
and human,1206,25,38,8,1,6,0,78
be with,1206,15,17,1,0,2,1,36
not always,1205,32,35,4,2,0,3,76
services and,1205,2,4,0,0,0,0,6
co-owner of,1204,29,29,4,2,6,1,71
com ig,1204,10,10,0,0,3,0,23
the key,1204,7,6,0,0,2,0,15
dms please,1203,3,39,0,0,1,0,43
live to,1203,8,12,2,1,0,0,23
spread love,1202,20,41,5,5,7,0,78
you might,1202,31,33,2,2,1,2,71
which is,1202,25,9,1,4,2,0,41
new page,1202,1,1,0,0,0,0,2
west coast,1201,19,22,3,1,2,0,47
on spotify,1201,21,15,3,3,5,0,47
blessed to,1201,0,6,0,0,0,0,6
1 fan,1200,30,53,6,3,7,0,99
east coast,1200,22,39,3,1,5,1,71
man and,1200,27,4,1,1,2,0,35
a leading,1200,2,0,0,0,0,0,2
or the,1199,27,19,3,1,2,0,52
problem solver,1199,25,26,0,0,0,1,52
over everything,1199,6,12,3,1,2,0,24
let us,1199,1,9,0,0,0,0,10
and operated,1199,0,2,0,0,0,0,2
of nature,1198,19,42,5,1,1,0,68
chicago sports,1198,22,10,0,0,0,0,32
more information,1198,1,6,1,0,0,0,8
since the,1197,23,22,1,2,2,0,50
content and,1196,24,24,9,3,4,2,66
please no,1196,20,35,3,5,1,1,65
main account,1195,40,40,8,2,8,1,99
life as,1195,17,27,1,0,2,0,47
trust the,1195,12,14,0,0,2,0,28
all sports,1195,3,1,0,0,0,0,4
intersection of,1194,30,44,4,1,1,1,81
and never,1194,16,19,1,1,0,0,37
relationship with,1193,24,21,3,6,1,0,55
author speaker,1193,12,15,0,0,1,0,28
graduate student,1192,40,69,8,7,4,0,128
this shit,1192,16,35,8,2,2,1,64
univ of,1190,13,27,1,0,0,0,41
of history,1189,32,33,0,2,0,0,67
and entertainment,1189,9,7,2,1,0,0,19
and twitch,1188,58,33,10,7,5,2,115
the side,1188,38,38,6,9,5,1,97
do with,1188,19,24,5,0,10,0,58
school and,1188,4,17,2,1,4,1,29
it takes,1188,6,14,2,0,2,0,24
and help,1188,5,4,2,1,0,0,12
music i,1187,35,18,6,5,7,0,71
m e,1187,5,7,3,0,1,1,17
but mostly,1186,54,93,17,9,16,1,190
one is,1186,17,27,4,2,0,0,50
page is,1185,12,13,3,2,2,3,35
of his,1184,24,3,0,0,0,1,28
success is,1184,0,4,0,0,0,0,4
hang out,1183,29,26,4,4,3,2,68
much as,1183,18,23,0,2,2,0,45
is only,1183,13,21,3,0,4,1,42
e r,1183,10,17,3,1,1,0,32
to explore,1183,17,5,3,0,2,0,27
please follow,1183,14,5,2,1,0,1,23
the midwest,1182,43,38,3,1,7,2,94
some people,1182,25,26,3,1,1,1,57
the twitter,1182,16,12,5,0,0,0,33
and founder,1182,15,8,0,3,3,0,29
they can,1182,8,12,2,0,3,0,25
you only,1182,5,17,0,0,1,0,23
doing it,1181,23,36,3,1,3,0,66
laugh and,1181,9,21,5,0,3,1,39
help others,1181,13,13,2,1,0,1,30
oxford comma,1179,73,173,5,1,7,1,260
and gamer,1179,53,50,9,1,7,3,123
my mom,1179,31,47,7,1,6,2,94
dm if,1179,33,13,8,1,10,2,67
18 content,1178,54,37,13,9,15,2,130
join my,1178,21,28,6,6,6,0,67
freedom and,1178,6,1,1,0,0,0,8
and gaming,1177,56,25,6,2,4,1,94
it be,1177,14,25,2,3,2,0,46
com https,1177,18,18,2,0,5,0,43
a happy,1177,8,23,4,1,3,0,39
friend and,1177,14,17,3,1,3,1,39
music sports,1177,14,9,0,1,1,0,25
a thing,1176,28,31,10,3,5,0,77
believe that,1176,13,15,2,3,0,0,33
baseball fan,1175,24,26,4,1,2,0,57
and friend,1175,12,17,0,1,2,0,32
am here,1175,15,10,2,0,3,0,30
person i,1174,24,38,3,3,5,1,74
are for,1174,18,26,4,3,3,1,55
coach of,1174,5,3,0,0,0,0,8
and avid,1173,19,31,4,1,4,1,60
me some,1173,21,18,3,3,0,1,46
comic books,1172,93,23,3,6,0,0,125
to understand,1172,17,22,3,0,1,0,43
and see,1172,10,14,3,0,1,0,28
bringing you,1172,2,3,0,0,0,0,5
the nft,1172,0,2,0,0,1,0,3
in order,1171,6,9,3,0,0,1,19
visit http,1170,1,5,0,3,1,0,10
/ her,1169,1,0,0,0,0,0,1
latest news,1169,0,0,0,0,0,0,0
and cats,1168,51,122,17,3,12,4,209
just my,1168,27,22,3,4,1,0,57
life love,1168,7,11,1,0,1,0,20
the business,1168,7,7,0,0,0,0,14
not investment,1168,2,0,0,0,0,0,2
and like,1167,31,20,10,1,11,0,73
i did,1167,23,23,2,1,7,1,57
good and,1167,23,15,2,0,4,0,44
investing in,1167,1,4,0,0,0,0,5
feed of,1167,0,1,0,0,0,0,1
dm or,1165,25,24,1,3,8,0,61
for women,1165,2,33,1,0,3,0,39
3 8,1165,2,0,0,0,0,0,2
and general,1164,74,41,9,5,3,3,135
my shit,1164,17,23,5,3,5,1,54
am who,1164,5,8,1,0,0,1,15
youtube and,1163,36,18,4,2,2,0,62
church of,1163,17,19,2,1,4,0,43
education teacher,1163,7,23,0,0,1,1,32
years and,1163,15,12,0,1,1,0,29
and real,1163,10,7,1,1,0,0,19
strive to,1163,5,7,0,2,1,0,15
and much,1162,9,13,1,0,2,0,25
chapter of,1162,2,2,0,0,0,0,4
im not,1161,15,23,1,4,8,1,52
s o,1161,6,10,3,1,0,0,20
houston tx,1161,4,5,1,0,2,0,12
heavy metal,1160,34,12,6,3,0,1,56
if the,1160,12,25,2,3,2,0,44
in business,1160,6,5,1,0,0,0,12
pic by,1159,212,115,52,22,23,8,432
good to,1159,25,16,2,2,3,0,48
enthusiast i,1158,60,48,16,5,8,1,138
game and,1158,61,29,8,6,5,2,111
girls and,1158,14,38,4,1,5,0,62
discord http,1158,23,11,1,4,3,0,42
for news,1158,6,12,0,0,0,0,18
just tryna,1157,19,18,3,3,9,0,52
nice guy,1157,30,1,0,0,0,1,32
southern california,1157,16,5,0,0,2,0,23
prof of,1156,65,105,1,4,4,3,182
science teacher,1156,26,45,6,1,1,0,79
usaf veteran,1156,23,12,0,0,1,1,37
the voice,1156,12,10,2,1,1,0,26
a a,1156,10,7,0,2,1,0,20
and movies,1155,55,35,3,1,4,0,98
hockey fan,1155,27,62,4,1,1,1,96
don’t follow,1155,21,30,4,2,5,0,62
mets fan,1155,24,28,1,0,2,0,55
my dream,1155,11,25,3,1,4,0,44
pro life,1155,1,1,0,0,0,0,2
wine and,1154,11,41,0,1,3,0,56
man i,1154,26,13,2,2,2,1,46
i n,1154,7,9,3,1,1,1,22
company that,1154,1,1,0,0,0,1,3
say hi,1153,51,43,7,3,5,5,114
to post,1153,40,42,12,5,11,3,113
i come,1153,20,33,3,0,3,1,60
are here,1153,6,11,1,0,0,0,18
exploring the,1152,25,17,3,0,0,2,47
that one,1151,48,24,12,5,6,1,96
the place,1151,13,28,2,5,4,0,52
on you,1151,15,14,1,1,0,1,32
and of,1151,10,14,0,1,0,0,25
fully vaccinated,1150,49,77,6,6,10,1,149
http //tinyurl,1150,46,29,3,1,5,0,84
get you,1150,11,25,2,0,0,0,38
and baseball,1150,17,13,1,0,1,0,32
amazing kids,1150,3,12,0,0,1,0,16
the streets,1149,41,37,6,1,6,0,91
long island,1149,17,10,2,0,0,0,29
2 beautiful,1149,2,4,0,0,0,0,6
film and,1148,60,29,5,4,3,1,102
blah blah,1148,9,24,3,1,0,0,37
updates on,1148,5,2,2,1,0,0,10
is so,1147,11,31,6,1,2,0,51
throughout the,1146,1,3,1,1,1,0,7
and work,1145,21,19,4,1,3,1,49
for updates,1145,9,7,3,0,0,0,19
i should,1144,39,32,4,7,3,1,86
a business,1144,11,4,1,1,1,1,19
nft crypto,1144,0,3,1,0,0,0,4
is great,1143,12,8,1,0,0,1,22
by way,1142,27,55,1,2,2,1,88
s t,1142,14,8,3,2,0,0,27
retired teacher,1142,0,8,0,0,0,0,8
am also,1141,27,14,2,4,2,1,50
woman of,1141,0,38,0,0,5,0,43
click link,1141,9,9,3,1,4,1,27
my daughter,1141,4,15,0,0,1,0,20
us out,1141,7,4,1,0,0,1,13
everyone else,1140,21,22,5,2,3,0,53
movies music,1140,32,12,0,1,6,1,52
sports teams,1140,15,11,0,0,1,0,27
straight male,1139,15,1,0,0,0,0,16
the fun,1138,13,16,3,3,0,1,36
let it,1138,9,18,2,3,1,0,33
of north,1138,10,10,0,0,0,0,20
http //opensea,1138,8,3,0,0,0,0,11
for myself,1137,25,34,4,3,3,2,71
live it,1136,11,8,0,0,1,0,20
car enthusiast,1135,43,7,2,3,0,4,59
all people,1135,15,19,1,1,0,0,36
veteran and,1135,11,8,1,0,1,1,22
lives of,1135,5,7,0,0,0,1,13
things to,1134,22,34,5,0,4,1,66
to reach,1134,9,8,2,0,1,0,20
here in,1134,6,11,0,1,0,0,18
currently working,1133,66,37,14,4,6,1,128
of social,1133,22,46,1,2,2,0,73
hit the,1133,14,7,2,4,0,0,27
say i,1132,9,21,3,1,1,1,36
most important,1132,6,7,0,1,1,0,15
make friends,1131,37,25,2,5,6,0,75
and http,1131,21,6,1,3,1,0,32
in dc,1130,34,42,3,2,6,1,88
a game,1130,52,19,6,3,5,0,85
and health,1130,10,31,3,0,2,0,46
fine art,1130,13,19,0,0,0,1,33
y el,1130,3,2,0,1,0,0,6
i eat,1129,32,21,4,1,6,0,64
a while,1129,23,26,3,3,8,0,63
into my,1129,11,35,5,3,7,0,61
for work,1127,81,73,30,11,16,4,215
be like,1127,12,30,4,2,2,1,51
not endorsement,1127,12,18,2,1,0,1,34
never know,1126,14,22,3,3,2,1,45
teacher coach,1126,4,12,0,0,0,0,16
dog and,1125,27,61,6,2,4,3,103
the north,1125,4,14,1,0,2,0,21
spending time,1125,5,4,0,0,0,0,9
would like,1124,15,18,3,2,5,1,44
never forget,1124,16,9,1,0,0,0,26
22 years,1122,48,31,9,3,3,8,102
it here,1122,19,35,4,1,3,0,62
a couple,1121,24,13,1,1,1,2,42
love people,1121,16,15,1,1,0,1,34
sports junkie,1121,5,1,0,0,2,0,8
for hire,1120,72,64,14,11,7,0,168
ways to,1120,18,27,0,2,0,0,47
instagram -,1120,11,8,3,2,0,0,24
all types,1120,11,7,3,2,0,0,23
the land,1119,22,13,3,0,3,0,41
news from,1119,0,0,0,0,0,0,0
and coffee,1118,43,66,7,10,8,0,134
covering the,1117,12,16,2,0,0,0,30
posts are,1116,29,22,3,1,2,0,57
coffee lover,1115,26,64,4,0,5,0,99
new and,1115,11,4,1,0,2,0,18
writing and,1113,48,58,7,8,10,1,132
due to,1113,26,23,2,1,4,3,59
they call,1113,22,18,6,4,3,0,53
business inquires,1113,25,19,2,4,2,0,52
a digital,1113,12,16,1,3,1,2,35
who believes,1113,10,16,2,1,0,0,29
crypto nfts,1113,5,5,0,0,1,0,11
fan -,1112,49,30,4,4,4,0,91
i’m in,1112,22,40,3,3,6,0,74
always in,1112,24,32,5,1,1,0,63
guy from,1112,31,0,2,1,0,0,34
the black,1112,9,17,2,0,2,2,32
get in,1111,16,28,5,3,3,1,56
a story,1111,9,18,4,3,2,0,36
my channel,1111,15,17,0,2,0,1,35
digital marketer,1110,14,38,3,0,0,0,55
a normal,1110,20,20,5,2,2,0,49
stock market,1110,1,3,1,0,0,0,5
product manager,1109,53,37,3,0,2,1,96
for inquiries,1109,21,25,8,6,11,0,71
and 2,1109,11,27,1,1,2,0,42
the perfect,1109,6,20,3,0,1,0,30
platform for,1109,5,1,1,0,0,0,7
higher ed,1108,46,80,10,2,6,1,145
without a,1108,25,27,3,1,0,0,56
deal with,1108,17,20,7,2,3,0,49
their own,1107,10,13,10,0,1,0,34
my goal,1107,8,8,2,1,1,0,20
about a,1106,32,36,4,4,6,0,82
i’ve been,1106,19,27,3,3,4,1,57
parody account,1106,25,9,3,4,1,0,42
and coach,1106,8,8,0,0,0,0,16
our clients,1105,0,0,0,0,0,0,0
game developer,1104,142,30,16,14,3,1,206
protonmail com,1104,18,31,4,2,7,1,63
girl mom,1104,0,45,0,0,0,0,45
in science,1103,20,51,0,1,2,0,74
under 18,1101,94,57,33,8,18,6,216
piece of,1101,26,32,3,3,13,0,77
doing what,1101,16,14,1,2,0,0,33
big dick,1101,13,6,1,1,1,0,22
christian wife,1101,0,9,0,0,0,0,9
surrounding areas,1101,0,0,0,0,0,0,0
i'm in,1100,26,23,5,2,3,1,60
rest easy,1099,5,9,1,0,3,0,18
the money,1099,4,7,0,1,0,0,12
c/o 2024,1099,2,3,0,0,1,0,6
of food,1098,28,52,4,0,2,1,87
the intersection,1098,28,38,5,1,2,0,74
do good,1097,35,57,5,1,3,0,101
follower husband,1097,7,0,0,0,0,0,7
my pronouns,1096,52,55,45,11,21,9,193
look like,1096,33,40,3,3,5,0,84
seen on,1096,36,10,2,0,4,0,52
to try,1095,17,14,1,2,3,3,40
keep the,1095,13,19,2,0,4,1,39
money and,1095,10,4,1,0,0,0,15
always learning,1094,42,50,3,0,5,1,101
rights and,1094,35,41,1,3,1,1,82
don't take,1094,23,17,2,1,6,0,49
had to,1094,9,16,2,0,1,0,28
asst prof,1093,85,159,5,2,8,2,261
21 years,1093,47,21,8,2,7,4,89
to hear,1093,16,15,1,1,2,0,35
one piece,1092,80,39,15,9,11,2,156
media manager,1092,41,81,7,4,5,0,138
of that,1092,33,27,4,1,3,2,70
good life,1092,7,8,0,0,0,0,15
and trying,1091,34,37,3,4,3,2,83
sports betting,1091,4,0,0,0,0,0,4
a different,1090,7,17,1,3,0,0,28
the environment,1089,13,34,3,1,4,0,55
much to,1089,14,21,3,0,2,0,40
will make,1089,11,16,2,2,1,0,32
mind and,1089,11,11,2,2,0,2,28
wish i,1087,27,38,4,2,9,3,83
you could,1087,21,27,3,3,4,0,58
guitar player,1087,21,9,2,0,0,0,32
most high,1087,4,2,0,0,0,0,6
down the,1086,14,27,2,0,1,1,45
and learn,1086,12,13,1,1,0,0,27
that can,1086,9,7,1,0,1,0,18
for sports,1086,6,4,1,0,0,0,11
proverbs 3,1086,2,4,0,0,0,0,6
use my,1085,36,46,13,4,7,1,107
a week,1085,19,16,3,2,0,0,40
a smile,1085,10,9,0,2,2,0,23
discord https,1084,23,9,3,4,4,1,44
it a,1084,17,17,2,1,3,1,41
like what,1084,24,10,2,0,1,1,38
moved to,1084,14,11,0,2,0,1,28
actor writer,1083,65,58,8,6,12,2,151
when i'm,1083,40,25,5,1,2,1,74
twitch and,1083,31,18,7,3,5,1,65
love dogs,1083,12,31,0,2,3,0,48
cars and,1083,23,9,4,3,1,1,41
i'm doing,1082,39,72,9,6,9,3,138
of coffee,1082,23,85,7,1,3,0,119
who knows,1082,23,20,9,5,5,3,65
to date,1082,2,8,0,2,3,0,15
the premier,1082,2,0,0,0,0,0,2
social studies,1081,29,35,2,1,3,0,70
doing the,1081,23,34,4,1,3,1,66
wrestling and,1081,41,16,2,3,1,0,63
it professional,1081,40,14,0,1,1,0,56
management and,1081,5,6,0,1,1,0,13
to end,1080,15,24,1,1,1,0,42
it with,1080,8,5,4,2,0,0,19
atlanta braves,1080,7,1,0,0,0,0,8
journey to,1079,10,15,2,1,3,0,31
at it,1078,30,21,5,2,4,0,62
as possible,1078,15,25,1,1,3,1,46
of chicago,1078,17,15,2,0,0,0,34
through my,1077,14,17,2,0,2,1,36
think you,1077,10,14,2,3,4,1,34
world i,1077,6,18,2,1,1,1,29
back and,1077,8,12,4,1,1,0,26
de mi,1077,1,3,0,0,0,0,4
c e,1076,5,27,1,1,2,1,37
15 years,1076,14,10,2,3,0,0,29
// i,1075,65,81,24,16,17,3,206
content for,1075,12,17,3,3,1,0,36
hate me,1075,5,11,7,2,0,1,26
truth is,1075,5,10,2,0,1,0,18
university alumni,1075,7,8,0,0,1,0,16
living on,1074,26,57,9,2,8,1,103
by trade,1073,45,23,3,3,4,1,79
a k,1073,34,16,1,3,2,1,57
sister friend,1073,0,29,1,0,1,0,31
the office,1073,7,14,1,1,1,0,24
now living,1073,11,9,1,0,0,1,22
all american,1073,0,0,0,1,0,0,1
reading and,1072,15,47,2,1,3,2,70
more of,1072,25,22,5,5,1,1,59
dallas tx,1072,5,5,1,0,0,1,12
make art,1071,60,106,32,22,33,7,260
i'll be,1071,26,36,4,1,3,0,70
music video,1071,35,16,4,6,2,0,63
to spread,1070,18,28,6,1,3,0,56
most importantly,1070,17,16,1,1,0,0,35
and working,1070,13,14,0,2,0,0,29
a n,1070,6,16,2,1,1,1,27
good times,1070,13,11,0,1,0,0,25
and culture,1069,14,27,1,0,1,0,43
editor and,1068,75,56,7,2,3,0,143
player of,1068,80,37,8,4,4,2,135
link for,1068,17,25,9,1,5,1,58
life the,1068,8,15,3,0,0,0,26
woman who,1067,0,35,2,0,2,0,39
good music,1067,9,18,0,0,1,0,28
and tv,1066,36,42,7,1,2,0,88
it on,1066,12,13,2,0,1,1,29
hater of,1065,36,39,4,2,3,2,86
don't want,1065,16,20,1,1,7,2,47
leave me,1065,8,22,6,0,5,0,41
them to,1065,8,16,0,3,0,0,27
here is,1064,18,20,6,2,3,0,49
a s,1064,13,17,0,2,2,0,34
proud mother,1064,1,21,0,0,0,0,22
family my,1064,3,6,0,0,1,0,10
not so,1063,12,33,4,3,0,0,52
a voice,1063,23,15,5,2,1,1,47
and take,1063,11,24,2,2,2,0,41
currently in,1062,24,45,10,5,6,3,93
now http,1062,17,22,0,1,0,0,40
in houston,1062,5,8,0,4,0,0,17
christ husband,1062,0,0,0,0,0,0,0
/ him,1062,0,0,0,0,0,0,0
have you,1061,14,28,6,2,6,1,57
you follow,1061,17,19,3,1,1,3,44
the lives,1061,5,5,1,0,0,1,12
art director,1060,48,75,4,4,5,0,136
who have,1060,4,10,1,0,1,1,17
entrepreneur and,1060,4,0,0,0,0,0,4
gonna be,1059,29,38,12,5,4,2,90
out for,1059,12,18,1,1,2,0,34
check us,1059,4,3,1,0,0,1,9
range of,1059,3,3,1,0,0,0,7
to each,1058,78,44,8,6,3,2,141
or email,1058,19,19,1,4,6,1,50
published author,1058,16,23,1,0,3,1,44
in atlanta,1058,13,11,2,1,1,0,28
it comes,1058,7,14,1,1,0,1,24
sure to,1058,8,8,1,2,1,0,20
and big,1057,24,22,4,5,2,0,57
sox fan,1057,10,24,0,1,2,0,37
we believe,1057,0,0,0,0,0,0,0
and news,1056,10,7,1,1,1,0,20
old man,1055,40,3,6,3,1,0,53
turn on,1055,9,10,2,0,2,1,24
a safe,1054,19,46,10,2,4,1,82
is this,1054,22,39,4,3,6,1,75
best i,1054,32,26,6,3,2,1,70
cleveland sports,1054,15,7,0,0,0,0,22
husband son,1054,16,1,1,1,0,0,19
miami dolphins,1054,3,1,1,0,0,0,5
and nature,1053,19,31,5,2,3,2,62
student and,1052,45,56,9,5,5,1,121
do better,1052,31,40,2,1,3,1,78
and talk,1052,26,24,12,4,12,0,78
any other,1052,12,14,3,2,1,0,32
so that,1052,8,13,1,0,2,1,25
music artist,1052,8,2,3,2,0,1,16
hello i,1051,36,30,6,4,10,1,87
i share,1051,19,26,1,3,2,1,52
products and,1051,1,0,0,0,0,0,1
the ohio,1050,11,14,0,1,0,0,26
the ultimate,1050,8,5,1,1,0,0,15
with god,1050,0,2,0,0,1,0,3
machine learning,1049,50,19,1,1,1,0,72
ever meet,1049,23,34,2,5,3,0,67
about you,1049,16,16,4,7,2,0,45
life on,1048,7,20,0,0,1,0,28
i ain’t,1048,9,13,2,0,2,0,26
brand ambassador,1048,9,14,1,0,0,0,24
unless you,1047,27,22,8,2,1,0,60
current events,1047,15,22,3,0,1,1,42
and youtube,1047,19,12,0,2,2,2,37
being me,1047,7,12,1,0,0,0,20
can you,1046,14,26,3,1,3,0,47
advocating for,1046,14,21,1,1,2,0,39
the beauty,1046,2,16,0,1,1,0,20
com -,1045,28,19,2,4,3,0,56
1 2,1045,10,18,3,4,1,0,36
beautiful girls,1045,2,7,0,0,0,0,9
music fan,1043,38,19,2,2,1,0,62
of other,1042,47,45,8,1,6,1,108
and dogs,1042,19,80,1,1,4,0,105
the world’s,1042,6,10,2,0,1,0,19
lord and,1042,4,5,0,0,3,0,12
blm lgbtq,1041,60,85,8,2,6,2,163
resist blm,1041,14,48,0,0,3,0,65
washed up,1041,25,16,1,1,2,2,47
doctor of,1041,11,25,2,2,1,1,42
before i,1041,13,25,0,1,1,0,40
john 3,1041,3,5,0,0,0,1,9
com or,1040,21,8,5,6,2,0,42
god love,1040,3,10,1,0,0,0,14
to listen,1039,25,26,4,2,0,0,57
to pay,1039,14,11,4,2,2,0,33
from all,1039,4,5,1,2,2,0,14
mama of,1038,0,58,1,1,1,0,61
fashion designer,1038,5,21,2,1,7,1,37
new music,1038,17,6,1,1,1,0,26
care and,1038,9,9,1,2,0,0,21
grandmother of,1038,0,6,0,0,0,0,6
fuck the,1037,36,43,11,4,4,0,98
one another,1037,20,23,3,1,0,0,47
comics and,1036,82,47,20,6,15,0,170
and games,1036,71,45,15,11,3,4,149
until i,1036,16,31,1,2,4,0,54
you look,1036,15,25,2,0,5,0,47
devoted to,1036,13,20,0,0,3,0,36
creating a,1036,7,6,1,2,2,0,18
of happiness,1036,3,14,0,0,1,0,18
principal of,1036,4,11,0,0,0,0,15
fuck off,1035,64,45,30,15,14,4,172
y o,1034,42,40,11,6,8,1,108
watch the,1034,10,13,4,1,1,0,29
single dad,1034,22,1,0,0,0,0,23
all animals,1034,12,11,0,0,0,0,23
song writer,1034,2,2,0,0,0,1,5
freedom of,1034,4,0,1,0,0,0,5
when we,1033,18,29,0,1,2,0,50
me my,1033,10,19,4,1,3,0,37
how much,1033,16,17,1,1,2,0,37
is still,1033,14,16,2,2,2,0,36
but we,1033,15,14,1,1,0,1,32
service and,1033,1,4,0,0,0,0,5
twitch https,1032,27,16,4,4,3,2,56
i'm on,1032,19,19,4,5,2,2,51
combat veteran,1032,5,4,2,0,0,0,11
history buff,1031,29,29,1,0,1,0,60
the free,1031,8,5,1,0,0,1,15
the night,1030,16,39,3,0,8,0,66
forget to,1030,26,23,4,3,7,0,63
we're a,1030,3,1,1,1,0,1,7
reader writer,1029,20,147,5,0,5,0,177
bts army,1029,3,128,3,1,6,1,142
make some,1029,18,23,4,3,5,0,53
connoisseur of,1028,50,36,5,2,8,0,101
playing video,1028,35,22,5,1,7,1,71
anything i,1028,22,22,5,1,0,0,50
i promise,1027,37,30,3,0,5,2,77
this thing,1027,14,23,3,0,7,0,47
till i,1027,19,9,1,2,2,1,34
sports lover,1027,6,21,0,1,1,0,29
school class,1027,3,3,0,0,0,0,6
public speaker,1026,14,16,1,0,1,0,32
who will,1025,13,17,3,1,2,2,38
your next,1025,10,4,0,0,1,0,15
3 16,1025,7,6,0,0,0,1,14
in christ,1025,0,2,0,0,0,0,2
alum of,1024,33,52,2,1,1,0,89
rts endorsements,1024,33,44,3,1,3,0,84
my free,1024,21,25,7,0,5,0,58
black man,1024,11,0,0,0,0,0,11
made a,1023,31,28,6,3,0,2,70
for that,1023,24,23,3,2,0,1,53
2 0,1023,14,20,0,0,2,0,36
game of,1023,17,14,1,1,2,0,35
c/o 2022,1023,0,3,0,0,0,0,3
out in,1022,29,26,8,4,5,2,74
com and,1022,25,8,2,0,2,0,37
to stop,1022,16,14,1,0,2,1,34
more to,1022,12,12,2,1,1,0,28
two beautiful,1022,6,9,0,1,1,0,17
and things,1021,39,43,9,8,4,1,104
account to,1021,35,30,5,1,5,2,78
in any,1021,16,22,1,0,1,1,41
and basketball,1021,12,2,0,0,0,0,14
bay packers,1020,9,7,0,0,0,0,16
commercial real,1020,1,1,0,0,0,0,2
digital art,1019,30,39,8,2,12,4,95
a home,1019,7,11,3,2,0,0,23
to others,1018,13,18,3,1,3,2,40
dude who,1017,67,0,2,5,0,1,75
show me,1017,19,23,1,2,2,0,47
one who,1017,11,18,1,1,3,1,35
in central,1017,10,7,0,0,0,0,17
animal crossing,1016,56,183,23,8,30,4,304
higher education,1016,10,22,1,0,1,0,34
the party,1016,11,14,2,1,1,0,29
as if,1016,4,11,1,1,1,0,18
easy to,1016,10,2,2,0,0,0,14
trans rights,1015,293,187,58,38,26,13,615
and cat,1015,43,81,8,6,8,1,147
is king,1015,8,1,0,0,0,0,9
in tech,1014,27,64,3,1,1,2,98
own risk,1014,19,18,3,4,3,1,48
e s,1014,6,14,2,1,1,0,24
next generation,1014,7,9,0,0,1,0,17
managed by,1014,2,9,0,0,2,0,13
son and,1014,5,5,0,1,1,0,12
a more,1013,15,26,2,3,3,0,49
guy trying,1013,18,0,0,1,0,0,19
trying my,1012,73,103,25,9,27,2,239
please don't,1012,37,36,12,5,14,4,108
tattoo artist,1012,11,33,14,4,19,0,81
and don't,1012,28,18,3,2,1,0,52
got the,1012,11,19,5,1,5,0,41
we specialize,1012,0,2,0,0,0,0,2
financial freedom,1012,0,1,0,0,0,0,1
follow if,1011,46,36,19,4,14,6,125
and loves,1011,20,20,3,2,1,1,47
but if,1011,11,19,2,0,1,1,34
true to,1011,11,10,2,0,1,1,25
follow our,1011,0,1,0,0,0,0,1
it's the,1010,23,16,2,2,3,2,48
law and,1010,24,20,1,0,1,0,46
long term,1010,1,9,0,1,0,1,12
take my,1009,16,22,0,2,3,0,43
in washington,1009,10,8,0,0,0,0,18
at times,1008,56,29,7,7,3,2,104
of 2025,1008,7,2,0,0,0,1,10
que me,1008,4,2,1,0,0,1,8
of none,1007,33,22,6,1,2,0,64
day is,1007,20,19,0,0,2,0,41
and having,1007,16,14,1,0,3,2,36
in usa,1007,9,10,1,0,0,0,20
talking to,1006,23,32,5,5,4,0,69
the devil,1006,16,21,3,1,4,1,46
make sense,1006,18,24,2,0,0,0,44
in search,1005,21,29,3,1,1,0,55
the law,1005,16,19,0,1,3,0,39
the old,1005,19,5,2,1,0,0,27
of human,1004,22,24,4,0,3,1,54
you're not,1003,28,25,3,1,2,1,60
but never,1003,20,20,3,4,1,0,48
golf and,1003,6,0,0,0,0,0,6
a joke,1002,15,36,7,1,7,0,66
of animals,1002,8,45,2,2,4,0,61
good day,1002,28,18,6,0,5,1,58
director and,1002,18,18,3,0,3,0,42
can see,1002,16,19,2,0,1,0,38
know who,1002,7,20,1,0,2,0,30
don't let,1002,10,11,5,1,2,0,29
say what,1002,9,10,0,0,1,0,20
of cats,1001,33,143,8,2,7,1,194
self proclaimed,1001,33,27,4,4,6,1,75
to leave,1001,13,16,0,0,3,0,32
and updates,1001,1,1,3,0,1,0,6
about politics,1000,72,67,4,3,5,1,152
search of,1000,21,28,2,1,1,0,53
single and,1000,31,13,3,2,0,1,50
got to,1000,18,12,3,0,1,0,34
want it,1000,5,15,2,1,3,1,27
the better,1000,10,14,0,0,1,0,25
nsfw account,999,104,57,28,17,18,13,237
usaf vet,999,19,22,1,0,0,0,42
an avid,999,14,17,0,1,0,0,32
is worth,998,9,12,1,1,2,0,25
the red,998,10,10,1,2,1,1,25
buffalo bills,998,13,8,0,0,0,0,21
soccer coach,998,9,3,1,0,0,0,13
government politics,998,1,0,0,0,0,0,1
i’m on,997,9,20,9,1,4,2,45
such as,997,18,14,2,2,0,0,36
with people,997,17,10,0,0,1,0,28
expert in,997,11,9,1,1,1,0,23
to not,996,28,22,4,3,4,2,63
enjoy my,996,21,20,4,3,4,0,52
know about,996,11,18,3,1,2,0,35
account manager,996,3,8,1,1,0,0,13
not looking,995,16,16,3,5,2,0,42
now available,995,18,15,1,2,3,1,40
investor and,995,0,1,0,0,0,0,1
advocate and,994,21,36,1,1,5,1,65
and free,994,11,9,1,0,2,1,24
marine corps,994,11,4,0,0,0,0,15
the pursuit,994,4,5,0,0,0,0,9
belongs to,993,18,30,6,2,4,1,61
martial arts,993,24,4,0,0,2,3,33
in me,993,6,13,1,0,1,1,22
others to,993,7,13,0,0,0,0,20
of fame,993,10,5,0,0,1,0,16
a group,993,7,3,1,0,1,1,13
18 years,992,39,16,3,4,2,0,64
whatever you,992,18,14,2,0,4,2,40
world series,992,9,5,0,1,0,0,15
to providing,992,1,1,0,0,1,0,3
same time,991,27,45,0,2,5,2,81
yourself and,990,12,20,1,0,1,0,34
wife daughter,990,1,29,0,0,0,0,30
faith in,990,7,20,1,1,1,0,30
harry potter,989,15,58,5,2,6,2,88
i drink,987,19,32,2,3,4,0,60
i won't,987,16,13,1,0,7,0,37
card collector,987,12,3,0,0,0,0,15
other people,986,28,35,2,1,2,1,69
proud liberal,986,16,30,0,0,1,0,47
learn and,986,16,20,1,1,1,0,39
road to,986,5,6,2,2,0,0,15
and services,985,1,3,0,1,0,0,5
of dogs,984,25,67,2,0,1,0,95
from me,984,18,22,5,1,5,0,51
will get,984,12,10,3,3,1,0,29
established in,984,0,2,0,0,0,0,2
what else,983,40,28,7,4,9,1,89
rights activist,983,17,36,9,5,4,0,71
the girl,983,1,47,4,0,2,1,55
needs to,983,15,12,6,2,3,0,38
about what,983,13,13,3,1,0,1,31
for real,983,8,7,0,0,1,1,17
3 boys,983,5,9,0,0,0,0,14
changing the,983,6,7,1,0,0,0,14
free time,982,36,42,7,2,7,0,94
league of,982,40,24,2,5,2,0,73
good people,982,14,19,1,2,2,0,38
never stop,982,12,14,2,2,4,0,34
you believe,982,11,15,0,0,1,1,28
the center,982,7,14,4,0,0,0,25
to speak,981,10,27,0,0,2,0,39
show you,981,9,9,3,0,0,0,21
the gospel,981,5,7,1,1,0,0,14
be afraid,980,16,13,2,5,3,1,40
in education,980,12,22,1,0,2,0,37
designed to,980,8,2,1,0,1,0,12
glory to,980,8,0,2,0,0,0,10
an online,980,5,5,0,0,0,0,10
a retired,979,1,1,0,0,1,0,3
reflect my,978,42,72,5,2,6,2,129
don’t get,978,11,25,3,1,4,0,44
sf giants,978,14,24,1,1,0,0,40
our democracy,978,8,9,0,0,0,0,17
account got,978,4,9,0,0,2,0,15
follow on,978,4,9,0,0,2,0,15
over 30,977,9,16,3,0,0,0,28
state and,977,9,5,0,0,0,0,14
students and,977,2,8,0,0,0,0,10
no me,977,0,6,2,0,1,0,9
buy sell,977,1,2,0,0,0,0,3
world to,976,10,18,2,2,1,0,33
working hard,976,7,12,1,0,1,0,21
art account,975,104,130,51,23,43,10,361
and looking,975,27,18,0,5,0,1,51
you would,975,9,12,1,0,1,1,24
nft creator,975,3,6,2,0,0,0,11
the occasional,974,34,39,3,6,6,5,93
dm open,974,21,6,2,5,0,0,34
as hell,973,59,55,19,9,16,5,163
science fiction,973,68,52,7,5,4,2,138
pictures of,973,48,58,9,2,4,3,124
with big,973,10,24,5,1,1,1,42
hard and,972,13,9,1,1,2,0,26
i swear,971,39,44,11,6,6,2,108
o o,971,9,15,4,2,1,0,31
i t,971,13,7,2,1,2,0,25
artist who,970,45,44,16,13,19,5,142
world one,970,11,15,2,0,0,1,29
the family,970,6,11,2,1,1,0,21
puerto rico,970,10,5,1,0,1,0,17
needs of,970,2,2,0,1,0,0,5
and host,969,34,14,0,0,0,0,48
a social,969,17,17,3,4,5,1,47
fan in,969,12,14,2,1,1,0,30
of myself,968,28,24,6,1,2,0,61
respond to,968,11,20,2,1,4,0,38
way through,967,26,30,5,2,4,2,69
in sports,967,8,15,0,0,0,0,23
is coming,967,6,12,1,1,0,0,20
and freedom,967,7,3,1,0,1,0,12
and i'll,966,15,22,6,0,3,0,46
your soul,966,7,21,1,0,1,0,30
let your,966,6,12,0,3,2,0,23
idk what,965,37,47,9,4,22,1,120
only for,965,15,25,2,3,2,0,47
instagram http,965,21,20,1,0,1,1,44
the ride,965,11,16,4,0,3,0,34
and stay,965,9,15,0,0,2,0,26
been in,965,12,9,3,1,0,0,25
or get,965,8,10,1,2,2,0,23
learn from,965,6,11,0,3,0,0,20
black woman,964,1,56,1,1,8,1,68
land of,964,14,16,2,2,1,0,35
because you,964,8,11,1,1,2,0,23
retired and,964,1,2,0,0,0,0,3
chair of,963,38,36,3,3,2,1,83
for something,963,12,22,3,1,1,1,40
a gay,962,91,24,9,12,7,3,146
self taught,962,20,35,12,7,11,0,85
men’s basketball,962,1,1,0,0,0,0,2
stories and,961,30,25,9,4,5,3,76
pics and,961,23,16,3,2,4,1,49
you say,961,14,23,3,3,2,0,45
on onlyfans,961,8,21,6,1,3,0,39
god country,961,0,0,0,0,0,0,0
to time,960,33,21,5,4,0,2,65
in no,960,23,24,3,0,2,2,54
stay tuned,960,8,6,1,0,2,0,17
and god,960,2,7,0,0,1,0,10
massage therapist,959,9,21,5,1,2,0,38
loving husband,959,13,2,0,2,0,0,17
worry about,958,10,15,0,1,0,0,26
now https,958,11,8,5,0,1,0,25
not really,957,29,29,8,2,8,0,76
once a,957,21,17,2,1,2,0,43
on and,957,11,16,1,3,2,0,33
and great,957,7,8,2,0,0,0,17
and wellness,957,2,6,0,0,0,0,8
3 7,957,1,4,0,0,0,0,5
and aspiring,956,58,49,11,7,7,1,133
full stack,956,54,22,5,5,2,0,88
and advocate,956,20,36,1,2,2,0,61
apex legends,956,30,14,4,5,6,1,60
and how,956,18,24,3,0,2,0,47
a creative,956,11,16,3,2,1,1,34
life my,956,7,10,5,0,1,0,23
us today,956,1,0,0,0,0,0,1
an endorsement,955,19,10,1,0,2,0,32
o e,955,0,7,1,0,2,0,10
men's basketball,955,1,0,0,0,0,0,1
read my,954,43,54,10,5,12,3,127
and history,954,27,42,3,2,1,1,76
not me,954,26,23,2,0,3,0,54
good for,954,19,21,3,1,1,0,45
and small,954,11,22,4,1,5,0,43
and keep,954,8,7,0,0,0,1,16
order to,954,4,6,1,0,0,0,11
que no,954,2,2,0,1,0,0,5
the person,953,16,30,2,1,0,2,51
reader and,952,20,84,5,3,4,2,118
anime lover,952,42,41,5,2,11,0,101
black women,952,11,60,2,0,7,1,81
liberty and,952,5,9,0,1,0,0,15
services in,952,0,0,0,0,0,0,0
harry styles,951,6,141,8,1,18,0,174
check it,951,26,10,1,3,3,0,43
gpa 4,951,1,0,0,0,0,0,1
as my,950,25,29,2,1,3,1,61
of marketing,950,16,33,0,3,2,0,54
board certified,950,6,23,0,0,0,1,30
5 gpa,950,0,0,0,0,0,0,0
this app,949,15,25,6,3,6,0,55
never been,949,16,19,3,3,2,1,44
the church,949,14,23,3,1,1,0,42
meet new,949,17,5,1,2,1,0,26
look for,949,8,12,0,1,2,0,23
a team,949,3,4,0,0,2,1,10
play a,948,61,25,8,3,5,0,102
and very,948,30,40,5,8,5,1,89
for 10,948,12,25,1,1,2,0,41
down for,948,13,12,2,2,0,0,29
you on,948,10,12,2,2,0,0,26
giants fan,948,11,11,0,0,0,0,22
until you,948,6,13,1,0,2,0,22
- all,947,23,28,5,1,4,0,61
policy and,947,21,30,1,2,1,1,56
martial artist,947,30,16,4,1,2,1,54
for his,947,23,3,0,4,1,1,32
here we,947,9,17,2,0,1,0,29
so far,946,16,20,0,0,4,0,40
come join,946,9,7,5,2,1,1,25
a gift,946,6,6,1,0,1,0,14
and fitness,946,2,6,0,1,0,0,9
something new,945,21,11,1,3,1,0,37
make things,944,47,61,15,6,11,3,143
writing about,944,32,86,7,3,5,0,133
my god,944,7,18,3,2,2,0,32
not what,944,7,14,2,0,0,1,24
the sports,944,3,2,0,0,1,1,7
you ever,943,18,25,7,2,3,0,55
k a,943,26,9,1,1,2,1,40
simple man,943,16,0,0,2,0,1,19
they say,942,16,19,1,0,1,1,38
product of,942,20,13,2,0,1,0,36
in miami,942,4,9,0,0,0,0,13
public affairs,941,18,24,2,0,1,0,45
with his,941,22,1,1,0,0,0,24
cross country,941,0,4,0,0,0,0,4
reading this,940,34,36,6,3,2,0,81
the hell,940,24,33,6,3,7,0,73
not sure,939,32,15,4,4,5,1,61
and fan,939,22,26,5,0,4,1,58
why i,939,12,14,0,3,5,1,35
and owner,939,11,9,2,2,2,0,26
my money,939,8,5,0,0,0,1,14
23 years,938,27,31,3,5,6,3,75
e n,938,7,5,1,1,2,0,16
with their,938,4,10,1,0,0,0,15
grace of,938,7,3,0,0,2,0,12
supply chain,938,4,6,0,0,0,0,10
and writing,937,40,54,5,5,7,1,112
in her,937,2,59,4,1,3,1,70
see here,937,10,17,3,2,2,1,35
has no,936,17,22,5,2,4,0,50
what do,936,16,16,6,1,3,0,42
servant of,936,4,7,0,0,0,0,11
a unique,936,4,2,1,0,0,0,7
my last,935,14,32,7,0,1,0,54
of https,935,26,15,2,2,1,0,46
artist from,935,16,18,2,3,4,0,43
an open,935,27,10,2,2,0,1,42
when they,935,19,15,2,3,2,0,41
first time,935,16,19,2,0,1,0,38
and personal,935,8,16,4,2,3,1,34
a collection,935,8,14,3,1,0,0,26
the ones,935,12,6,3,1,2,0,24
collector and,935,10,9,2,2,0,0,23
principal at,935,9,6,0,0,0,0,15
we trust,935,7,6,0,0,0,0,13
board games,934,157,61,7,2,7,0,234
the shit,934,13,18,1,1,5,0,38
and its,934,9,9,3,0,1,1,23
3 beautiful,934,1,5,0,0,0,0,6
with ukraine,933,37,27,7,1,7,0,79
the bad,933,23,17,4,1,4,1,50
of others,933,13,15,1,1,0,0,30
improve the,933,7,2,0,0,0,0,9
made of,932,38,62,10,1,8,1,120
and enjoying,932,2,4,0,0,1,0,7
blessed with,932,2,3,0,0,0,0,5
i give,931,16,13,5,3,2,0,39
is free,931,13,23,0,1,1,0,38
mother daughter,931,0,22,0,0,1,0,23
the grace,931,7,5,0,0,2,0,14
athletic director,931,2,1,0,0,0,0,3
shut up,930,31,54,5,8,12,1,111
get better,930,25,12,3,4,3,0,47
don’t want,930,15,21,3,1,4,0,44
state champion,930,0,0,0,0,0,0,0
staff writer,929,54,59,9,1,3,0,126
fluent in,929,12,45,1,0,6,0,64
for children,929,6,14,1,1,3,0,25
of faith,929,3,11,1,0,0,0,15
history teacher,928,27,34,5,0,2,1,69
many more,928,14,21,2,1,2,0,40
meant to,928,8,15,3,1,0,0,27
radio host,928,11,7,0,1,1,0,20
support and,928,6,6,2,0,0,0,14
that provides,928,1,1,0,0,0,0,2
of video,927,82,47,9,6,5,1,150
as fuck,927,33,50,24,13,14,1,135
sh t,927,4,24,2,2,0,0,32
the morning,927,11,12,0,1,0,0,24
pray for,927,6,8,0,2,1,1,18
and helping,927,7,4,0,2,0,0,13
not all,926,21,27,2,1,1,1,53
it like,926,4,10,0,0,0,0,14
years experience,926,1,3,1,1,0,0,6
hockey and,925,27,36,2,0,6,1,72
of technology,925,20,9,4,1,0,0,34
real madrid,925,2,3,0,0,0,0,5
fighting game,924,113,18,12,9,2,3,157
s in,924,21,30,2,3,6,0,62
of black,924,13,33,4,1,2,0,53
chelsea fc,924,12,2,0,0,0,0,14
our own,924,8,4,2,0,0,0,14
me happy,923,9,34,1,4,3,1,52
mechanical engineer,923,28,15,0,2,1,0,46
realtor with,923,1,1,0,0,0,0,2
fan club,922,24,33,6,3,11,0,77
place in,922,28,25,1,4,3,0,61
front of,922,23,25,5,1,2,0,56
is never,922,15,24,1,1,5,1,47
way you,922,4,11,2,0,1,0,18
twitter and,921,25,24,7,2,2,0,60
no i,920,24,35,7,0,6,2,74
the wrong,920,20,19,8,1,3,2,53
my ass,920,13,24,9,2,2,0,50
the house,920,11,15,6,3,5,0,40
or you,920,18,5,2,2,2,1,30
in paradise,920,6,12,0,1,0,0,19
network of,920,4,3,0,0,0,0,7
dungeon master,919,216,56,28,23,10,1,334
mostly just,919,69,63,20,14,9,0,175
mod for,919,40,62,13,6,13,1,135
data analyst,919,43,23,6,2,1,0,75
but now,919,17,26,3,2,2,0,50
to run,919,18,14,1,1,2,0,36
' ',919,11,19,2,0,2,0,34
through a,919,13,15,1,0,2,0,31
retired army,919,1,2,0,0,0,0,3
be more,918,24,36,3,2,1,1,67
and design,918,21,31,5,5,3,2,67
a d,918,17,8,2,3,1,0,31
yankees fan,918,13,13,0,0,0,0,26
serial entrepreneur,918,5,1,0,0,0,0,6
w/ a,917,23,36,3,2,1,0,65
and future,917,27,28,2,1,3,2,63
for friends,917,28,18,6,8,2,0,62
my thing,917,13,28,1,0,5,0,47
engaged to,916,43,43,19,7,13,3,128
learn how,916,9,4,1,2,0,0,16
belong to,915,21,31,7,2,1,0,62
a heart,915,24,26,5,2,4,0,61
about life,915,12,17,5,0,0,1,35
than your,915,16,13,2,1,2,0,34
the gop,915,10,9,0,0,0,0,19
46 5,915,0,11,0,0,1,0,12
web 3,915,2,2,0,0,0,0,4
and occasional,914,60,47,8,4,2,1,122
my content,914,21,25,7,10,5,2,70
outlook com,914,27,24,4,3,3,0,61
play the,914,32,21,3,1,2,0,59
and photographer,914,18,18,6,7,3,1,53
did i,914,14,26,2,2,3,0,47
and videos,914,15,6,2,2,0,0,25
in crypto,914,0,0,0,0,1,0,1
free palestine,913,102,96,32,19,30,3,282
law student,913,39,78,3,4,5,1,130
and animal,913,15,44,5,4,2,1,71
me here,913,21,26,4,1,3,1,56
live with,913,7,18,2,1,1,0,29
of women,913,0,23,0,0,3,0,26
guide to,912,11,24,3,1,2,0,41
heart is,912,9,26,0,0,6,0,41
2 amazing,912,4,13,1,0,1,0,19
in las,912,7,5,1,0,0,0,13
community manager,911,53,47,9,3,10,2,124
america and,911,3,6,1,0,0,0,10
rights are,910,167,141,24,7,15,5,359
running for,910,36,25,1,1,4,0,67
time on,910,23,29,1,2,4,0,59
for yourself,910,5,8,2,1,1,0,17
power to,909,16,25,0,1,5,1,48
and creative,909,8,24,2,1,2,0,37
minding my,909,0,11,1,2,4,0,18
from time,908,31,19,5,4,0,2,61
hello my,908,19,18,9,1,3,2,52
my children,908,6,12,1,0,1,0,20
and events,908,4,4,0,0,0,0,8
person of,907,29,16,10,0,6,0,61
to yourself,907,15,30,3,2,6,1,57
a god,907,12,15,10,2,6,0,45
fuck it,907,13,18,3,1,2,0,37
work to,907,7,14,0,1,1,0,23
key to,907,7,2,0,0,2,0,11
training and,907,3,4,0,0,1,0,8
reflect the,906,45,34,4,1,0,0,84
make people,906,25,10,4,2,4,1,46
always on,906,17,20,2,0,1,1,41
next door,906,9,21,5,0,6,0,41
the east,906,10,12,3,1,3,1,30
goes on,906,10,15,4,0,0,0,29
lets go,906,9,5,0,0,2,0,16
3 4,906,2,5,1,0,0,0,8
s c,906,4,3,0,0,1,0,8
basketball team,906,1,0,0,0,0,0,1
but in,905,21,30,9,1,6,1,68
youtube videos,905,41,12,2,3,4,2,64
http //youtu,905,16,8,0,1,3,0,28
like sports,905,6,6,1,1,2,0,16
in seattle,904,46,36,4,6,1,1,94
laugh at,904,29,20,2,0,2,0,53
my lord,904,1,3,0,0,0,0,4
bad bitch,903,10,38,7,0,5,0,60
music for,903,31,8,2,2,1,1,45
i came,903,13,20,5,0,4,1,43
channel https,903,14,9,1,0,1,0,25
nascar fan,903,10,7,1,1,0,1,20
3 3,903,5,3,0,0,0,0,8
at university,902,32,29,2,0,1,1,65
ability to,902,8,11,2,1,2,0,24
jersey girl,901,0,73,0,0,1,0,74
civil engineer,901,13,13,0,3,0,0,29
future is,901,8,12,0,1,3,0,24
to lose,901,6,12,4,0,2,0,24
to book,901,3,9,2,2,8,0,24
small businesses,901,4,15,1,0,2,0,22
based out,901,10,3,1,1,0,0,15
book nerd,900,35,110,6,1,8,0,160
is mine,900,29,26,7,2,3,1,68
being the,900,10,11,3,2,0,0,26
to us,900,6,6,1,1,3,0,17
// ig,899,8,26,2,1,2,0,39
and families,899,0,7,0,0,0,0,7
a conservative,899,1,1,0,0,0,0,2
and memes,898,39,29,6,8,11,1,94
with that,898,18,23,3,2,11,0,57
the answer,898,8,23,2,0,1,0,34
iowa state,898,15,13,1,0,3,0,32
and women,898,8,11,1,0,3,2,25
people that,898,7,8,0,0,0,0,15
a sports,898,2,5,0,0,0,0,7
and retweets,897,34,28,3,3,6,1,75
i tell,897,26,24,3,2,3,0,58
my little,897,17,28,3,3,3,0,54
known for,897,18,16,4,1,2,0,41
is right,897,7,10,0,2,0,1,20
ultra maga,897,0,0,0,0,0,0,0
cause i,896,13,16,3,2,6,1,41
my eyes,896,8,23,2,0,4,0,37
about our,896,8,8,1,0,2,0,19
horse racing,896,3,3,2,0,0,0,8
dad jokes,895,69,24,2,2,4,1,102
streamer http,895,34,24,11,1,4,1,75
just love,895,14,30,2,1,3,0,50
with her,895,4,32,1,0,3,0,40
i’ll be,894,20,30,6,1,4,0,61
afraid of,894,12,21,3,4,5,0,45
do this,894,17,16,2,0,0,0,35
be me,894,10,18,1,0,2,0,31
non-profit organization,894,0,0,0,0,0,0,0
pc gamer,893,55,27,3,0,5,0,90
do things,893,39,23,3,2,4,0,71
time in,893,17,13,4,0,0,0,34
know more,893,7,11,1,0,1,1,21
and occasionally,892,42,44,4,4,4,0,98
about everything,892,24,26,2,2,2,0,56
and beer,892,27,20,0,2,0,0,49
love your,892,8,22,0,2,1,2,35
world champion,892,22,9,0,2,0,0,33
married and,892,9,12,2,2,2,1,28
would love,892,13,9,2,2,2,0,28
most beautiful,892,4,13,2,0,2,0,21
according to,891,39,29,6,4,4,0,82
and producer,891,28,17,7,1,2,1,56
and sell,891,4,6,2,0,4,0,16
love family,891,2,8,0,0,0,0,10
if not,890,20,22,6,2,1,1,52
short to,890,4,12,0,1,2,0,19
for their,890,6,7,3,0,1,0,17
a mi,890,0,1,0,0,0,0,1
commissions closed,889,81,132,56,29,53,0,351
coordinator at,889,17,25,4,1,4,0,51
that's all,889,11,13,2,2,1,0,29
me just,889,3,12,3,2,4,0,24
honest and,889,1,3,0,0,0,0,4
the mission,889,2,1,1,0,0,0,4
find us,889,1,1,1,0,0,0,3
for justice,888,20,43,4,1,2,0,70
in front,888,21,24,6,1,2,0,54
don’t let,888,11,16,4,0,0,0,31
a hard,888,9,5,3,1,0,0,18
help with,888,6,4,0,0,0,0,10
- my,887,39,35,7,4,6,0,91
usmc vet,887,20,8,0,1,2,0,31
source of,887,8,10,0,1,0,0,19
learn about,887,6,5,1,0,0,0,12
reader of,886,20,84,4,2,3,1,114
show host,886,9,6,1,2,2,1,21
jesus and,886,8,9,0,0,0,0,17
nft collection,886,1,3,0,0,0,0,4
and playing,885,33,30,2,2,5,0,72
d m,885,10,12,2,0,3,0,27
nfts and,885,9,6,0,0,2,0,17
in heaven,885,3,6,1,1,1,0,12
to helping,885,1,7,1,0,0,0,9
division of,885,0,3,0,0,0,0,3
better world,884,25,23,4,4,1,1,58
l e,884,5,8,3,1,2,0,19
mission of,884,0,0,0,0,0,0,0
http //paypal,883,26,31,10,4,2,0,73
a work,883,13,32,3,1,2,0,51
better to,883,11,12,0,1,3,0,27
l i,883,5,13,4,0,0,0,22
de las,883,3,2,0,0,0,0,5
supposed to,882,27,22,8,2,2,0,61
wanting to,882,23,14,6,1,5,1,50
now i'm,882,17,26,0,0,2,2,47
also have,882,21,10,2,0,4,3,40
an awesome,882,16,19,2,1,0,0,38
love love,882,3,23,2,1,0,0,29
happiness is,882,5,7,0,1,2,0,15
3 6,882,1,2,0,0,0,0,3
be found,881,27,26,9,3,7,0,72
i build,881,21,14,2,4,3,0,44
hanging out,881,13,26,3,2,0,0,44
let’s get,881,4,17,1,1,2,0,25
no time,881,12,11,1,1,0,0,25
the health,881,0,4,0,0,0,0,4
really like,880,44,54,10,9,14,3,134
of these,880,18,17,3,0,1,0,39
during the,880,15,13,0,0,0,2,30
a former,880,9,13,1,0,1,0,24
go dawgs,880,5,12,0,0,0,0,17
a king,880,7,6,0,1,0,0,14
information and,880,2,3,1,0,1,0,7
and data,879,37,14,3,0,1,2,57
a student,879,13,17,1,2,2,0,35
wish to,879,9,19,4,2,0,0,34
to many,879,12,15,2,0,3,0,32
opportunity for,879,5,1,0,0,0,0,6
state champs,879,2,1,0,0,0,0,3
get me,878,14,16,1,1,2,0,34
by nature,878,8,20,0,0,1,0,29
a fuck,878,9,10,6,2,1,1,29
trump and,878,3,3,0,0,0,0,6
games on,877,55,30,3,5,4,1,98
movies tv,877,32,27,1,0,1,1,62
and media,877,23,19,5,3,7,1,58
adjunct professor,877,11,18,3,1,1,0,34
what happens,877,13,11,0,0,0,0,24
visit us,877,2,0,0,0,0,0,2
a full-service,877,0,0,0,0,0,0,0
writer reader,876,32,154,9,2,12,0,209
own opinions,876,42,42,5,1,1,0,91
not much,876,32,22,3,0,5,0,62
and this,876,17,27,3,2,2,1,52
wanted to,876,11,18,0,1,2,0,32
just being,876,12,8,2,0,2,0,24
sports nut,876,12,8,0,0,0,0,20
christ is,876,2,1,1,0,0,0,4
outdoor enthusiast,875,20,35,1,1,1,0,58
university alumna,875,0,30,0,0,3,0,33
the global,875,4,5,2,1,2,0,14
utm medium,875,2,9,0,1,0,0,12
ny giants,875,4,1,0,0,1,0,6
punk rock,874,50,34,3,5,2,1,95
make videos,874,53,18,2,1,7,0,81
champion of,874,20,27,4,0,2,0,53
just have,874,14,21,1,2,1,0,39
call it,874,17,15,0,1,6,0,39
me so,874,9,22,1,1,6,0,39
is beautiful,874,8,8,2,1,3,0,22
feed for,874,3,1,2,0,0,0,6
artist gamer,873,47,88,16,6,13,5,175
alt account,873,73,27,13,8,4,1,126
enthusiast -,873,38,30,6,7,6,2,89
and find,873,13,19,2,1,2,0,37
from new,873,16,11,0,4,2,0,33
and are,872,29,14,2,1,2,0,48
why not,872,15,12,3,1,1,0,32
happy and,872,10,10,2,1,0,0,23
world with,872,4,11,0,1,3,0,19
never let,872,4,6,1,0,0,0,11
my brain,871,35,55,14,7,5,2,118
get paid,871,12,16,1,1,2,0,32
by providing,871,0,0,0,0,0,0,0
destiny 2,870,60,42,11,4,10,2,129
in person,870,17,34,4,1,4,1,61
grow up,870,20,30,2,0,6,0,58
for social,870,14,31,5,1,2,0,53
fur babies,870,7,25,1,1,1,0,35
looking forward,870,8,11,1,0,0,1,21
carrd co,869,61,104,36,16,28,3,248
go by,869,45,46,20,16,16,6,149
joe biden,869,8,3,3,0,0,0,14
shit and,868,38,23,14,2,4,1,82
the guy,868,43,0,2,5,0,1,51
instead of,868,14,23,11,0,2,1,51
the crypto,868,0,2,0,0,0,0,2
candidate in,867,47,91,6,4,6,1,155
playing games,867,45,23,1,7,3,1,80
and say,867,12,14,2,1,2,2,33
to three,867,5,17,0,1,3,0,26
of health,867,6,19,0,0,1,0,26
your real,867,2,0,0,0,0,0,2
liberal democrat,866,10,22,0,0,0,0,32
it’s the,866,11,14,0,2,2,0,29
together we,866,4,12,0,0,1,2,19
fun to,866,5,5,1,0,1,0,12
and fantasy,865,40,53,8,1,3,1,106
geek and,865,46,37,0,2,3,0,88
rights advocate,865,13,52,3,5,5,0,78
blue in,865,8,27,0,0,0,0,35
only way,865,7,11,6,0,2,0,26
/ ig,865,8,8,4,1,2,0,23
we don't,865,10,8,1,1,0,0,20
open source,864,68,23,2,4,3,1,101
winner of,864,28,21,4,1,3,0,57
when i’m,864,21,17,3,0,2,0,43
in ny,864,11,18,1,0,0,0,30
my real,863,13,31,2,6,3,0,55
shit i,863,20,15,3,2,4,0,44
p s,863,12,13,2,0,1,0,28
independent thinker,863,1,5,1,0,0,0,7
program director,862,17,30,0,1,3,0,51
so if,861,16,16,3,3,3,0,41
special needs,861,13,16,1,0,1,0,31
something to,861,7,13,4,0,1,1,26
i'm from,861,9,9,3,0,3,1,25
50 years,861,2,3,0,1,0,0,6
aspiring writer,860,72,56,12,6,6,1,153
up my,860,15,19,2,2,5,4,47
/ http,860,19,15,5,3,3,0,45
of stuff,859,43,53,6,1,4,2,109
meet you,859,33,27,2,5,5,2,74
spare time,859,25,19,6,1,2,1,54
has the,859,12,8,2,2,2,0,26
a local,859,9,10,3,2,1,0,25
west virginia,859,9,11,1,0,0,0,21
steelers fan,859,8,5,0,0,0,1,14
and commercial,859,2,3,0,0,0,0,5
big time,858,16,25,3,1,1,0,46
lover i,858,11,27,1,0,2,0,41
go blue,858,11,20,0,1,1,0,33
gym rat,858,14,12,1,0,1,0,28
in yourself,858,7,5,0,0,2,0,14
of freedom,858,4,5,0,0,0,0,9
and maybe,857,27,20,6,4,6,3,66
to 1,857,3,19,1,0,0,0,23
thanks to,857,6,15,0,0,1,0,22
usmc veteran,857,6,6,1,0,0,0,13
represent my,856,57,55,6,5,5,1,129
in english,856,29,40,4,1,6,0,80
everyone is,856,16,28,2,1,4,0,51
sub to,856,5,12,0,0,5,0,22
home and,856,10,10,0,1,0,0,21
35 years,856,3,4,1,0,0,0,8
students in,856,0,8,0,0,0,0,8
baseball player,856,4,0,0,0,0,0,4
and there,855,24,23,0,2,5,2,56
dream of,855,10,14,2,2,1,1,30
nft and,855,4,2,0,0,0,0,6
insurance agent,855,0,3,0,0,0,1,4
o que,855,0,2,0,0,0,0,2
please don’t,854,21,40,10,6,10,4,91
artist photographer,854,12,35,6,7,5,0,65
a healthy,854,14,10,0,0,2,0,26
with family,854,2,4,0,0,0,0,6
the rich,853,55,72,21,11,14,2,175
reporter at,853,16,34,4,2,1,0,57
do my,853,21,16,5,4,2,0,48
years ago,853,8,16,1,0,1,1,27
my body,852,16,46,4,2,4,1,73
- not,852,21,19,3,3,2,0,48
love what,852,5,8,1,0,0,0,14
the hottest,852,4,4,0,0,2,0,10
business owners,852,0,0,0,0,0,1,1
my face,851,19,28,5,1,4,1,58
a teacher,851,10,27,0,0,0,1,38
that was,851,12,15,0,2,2,0,31
one thing,851,11,17,1,0,2,0,31
and sharing,851,5,7,1,1,1,0,15
all ages,851,3,3,0,0,1,0,7
8 gpa,851,0,0,0,0,0,0,0
tweets mine,850,63,107,1,1,7,1,180
i sometimes,850,68,39,11,5,9,3,135
game player,850,82,23,13,4,3,0,125
the memes,850,19,22,2,3,3,1,50
know it,850,14,13,3,1,1,2,34
resource for,850,1,1,0,0,0,1,3
and creator,849,18,21,2,2,5,1,49
a boy,849,22,8,6,4,0,0,40
a chance,849,8,9,2,0,3,1,23
come and,849,4,12,1,0,0,1,18
and grow,849,5,9,1,0,1,1,17
a y,849,2,5,1,0,0,0,8
to succeed,849,1,2,0,1,0,0,4
producer at,848,43,37,5,1,3,0,89
developer and,848,47,20,4,4,0,0,75
graphic artist,848,20,20,1,1,2,1,45
states of,848,5,2,1,0,0,0,8
and retweet,847,40,18,4,9,6,3,80
my friend,847,22,22,5,3,7,2,61
i won’t,847,11,23,3,0,5,2,44
it’s just,847,12,14,5,3,2,0,36
fantasy sports,847,8,1,0,1,0,0,10
of fun,846,19,20,1,2,0,1,43
arts culture,846,5,10,0,0,0,1,16
you’re not,845,12,32,4,0,10,2,60
come from,845,13,14,0,0,2,1,30
and 1,845,8,13,5,1,1,0,28
the goat,845,4,3,4,2,0,0,13
within the,845,2,4,2,0,1,0,9
anime fan,844,50,34,4,3,4,1,96
in dallas,844,10,3,0,0,1,0,14
estate professional,844,0,1,0,0,0,0,1
hot takes,843,30,37,10,4,4,0,85
if they,843,11,11,0,2,0,1,25
the field,843,2,10,1,0,0,0,13
radio show,843,6,3,0,1,1,0,11
shop for,843,2,7,1,0,0,0,10
sports cards,843,1,0,1,0,0,0,2
hello i'm,842,31,30,10,4,8,6,89
young men,842,2,6,0,0,0,0,8
over 20,842,3,2,0,0,1,0,6
avid gamer,841,55,14,5,2,3,1,80
a c,841,15,33,7,2,5,0,62
i’m also,841,17,21,3,3,4,3,51
around me,841,8,21,3,0,1,0,33
not interested,840,13,14,1,0,4,1,33
support for,840,12,12,0,1,0,0,25
to ensure,840,3,1,0,0,0,0,4
- no,839,41,25,6,5,6,3,86
movie lover,839,33,28,1,1,2,0,65
take your,839,10,12,2,0,0,0,24
emmy award,839,13,6,0,0,2,0,21
news alerts,839,0,0,0,0,0,0,0
http //amzn,838,28,25,2,2,1,0,58
nfl nba,838,0,0,0,0,0,0,0
it has,837,9,15,1,0,1,0,26
love laugh,837,1,2,0,2,0,0,5
love america,837,0,4,0,1,0,0,5
keep going,836,9,26,0,2,2,0,39
new mexico,836,12,9,2,3,0,0,26
come on,836,9,10,2,1,4,0,26
judge me,836,6,9,0,0,1,0,16
basketball program,836,0,0,0,0,0,0,0
please do,835,28,54,16,6,14,2,120
not follow,835,29,29,17,2,7,2,86
way in,835,22,15,3,3,5,0,48
believer of,835,6,24,2,0,2,1,35
your eyes,835,12,12,2,1,2,0,29
to new,835,13,10,1,1,1,0,26
grateful for,835,4,13,0,1,1,0,19
live by,835,4,5,3,1,0,0,13
24 years,834,24,30,3,4,3,2,66
the sea,834,19,30,7,3,5,1,65
went to,834,14,19,2,2,2,0,39
//m youtube,834,7,3,0,2,0,0,12
artist for,833,41,38,11,8,8,0,106
don't get,833,13,14,2,1,1,1,32
your time,833,10,13,0,0,0,0,23
guy i,832,39,2,1,1,0,0,43
for info,832,18,15,4,0,5,0,42
and happy,832,13,15,3,2,6,0,39
publisher of,832,15,5,0,0,0,0,20
follow your,832,8,8,1,0,0,0,17
writer /,831,46,37,9,2,8,0,102
video gamer,831,49,18,5,2,1,2,77
streaming on,831,30,12,3,2,4,0,51
for kids,831,6,37,5,2,0,0,50
super fan,831,19,18,2,0,2,0,41
old i,831,12,16,6,0,5,1,40
producer /,831,12,4,2,1,0,0,19
our goal,831,0,0,0,0,0,0,0
co-creator of,830,72,45,6,5,4,0,132
fueled by,830,24,73,3,5,4,0,109
super bowl,830,5,1,0,0,0,0,6
to ask,829,17,21,6,4,2,0,50
there's a,829,21,18,8,1,0,1,49
of color,829,8,34,4,1,2,0,49
all we,829,17,17,0,0,2,2,38
to their,829,14,6,3,3,5,0,31
the san,829,8,3,0,1,0,0,12
4 5,829,0,6,0,0,1,0,7
football team,829,3,0,0,1,0,0,4
support our,829,2,1,0,0,0,0,3
come here,828,9,18,2,2,0,0,31
website http,828,8,9,2,1,2,0,22
football basketball,828,9,3,0,0,0,0,12
organization that,828,0,0,0,0,0,0,0
me what,827,14,18,2,3,1,1,39
the golden,827,8,20,1,0,1,0,30
ideas and,827,6,11,3,1,2,0,23
sister aunt,827,0,19,0,0,0,0,19
fitness and,827,10,4,1,0,1,0,16
big brother,826,26,8,1,0,1,0,36
are personal,826,16,6,0,0,0,1,23
day by,826,7,10,3,1,2,0,23
beauty and,826,3,13,2,0,1,0,19
and financial,826,1,2,0,0,0,0,3
only nsfw,825,57,22,13,3,8,1,104
artist in,825,26,44,11,2,9,1,93
biggest fan,825,26,41,4,2,2,0,75
mom i,825,0,63,1,0,4,0,68
or just,825,24,14,2,1,2,0,43
and yes,825,12,18,2,5,1,0,38
native texan,825,5,18,0,0,1,0,24
love our,825,3,7,0,0,0,0,10
s navy,825,6,1,0,0,0,1,8
god has,825,3,1,1,0,0,0,5
marketing manager,824,15,55,0,1,1,1,73
love video,824,35,10,4,6,5,1,61
t o,824,24,5,3,0,2,0,34
us all,824,8,17,3,0,2,0,30
below to,824,6,8,0,2,3,0,19
single father,824,8,0,0,0,0,0,8
and write,823,38,43,16,4,6,0,107
virginia tech,823,20,32,1,0,1,0,54
in brooklyn,823,16,21,1,3,2,0,43
and photography,823,19,10,2,1,1,0,33
working out,823,7,7,1,1,0,0,16
speaker author,823,3,11,0,0,1,0,15
pinned tweet,822,29,41,10,12,15,1,108
most likely,822,23,45,7,1,3,0,79
not like,822,20,25,5,2,4,2,58
say it,822,10,7,2,0,1,0,20
voice for,822,10,7,1,0,2,0,20
building the,822,10,7,0,1,0,0,18
we work,822,0,2,0,0,0,0,2
trump 2024,822,0,0,0,0,0,0,0
gen x,821,28,76,4,0,4,1,113
animal rights,821,5,16,0,1,0,0,22
draw and,820,41,59,16,19,20,1,156
equality for,820,19,32,1,1,0,0,53
how we,820,13,17,1,0,1,0,32
get back,820,5,19,2,1,1,0,28
the story,820,11,8,2,0,1,2,24
lost my,820,10,9,2,1,0,0,22
am me,820,9,7,2,0,1,0,19
a leader,820,2,3,0,0,0,0,5
writer photographer,819,28,49,3,3,5,1,89
r d,819,28,15,5,0,3,0,51
law school,819,15,24,2,0,3,0,44
i’m back,819,4,9,1,1,0,0,15
north america,819,4,4,0,0,0,0,8
college grad,818,22,29,3,0,1,1,56
the podcast,818,21,14,1,1,1,1,39
hockey player,818,23,11,0,0,0,0,34
stop the,818,6,8,1,0,0,0,15
us a,818,1,5,0,0,1,0,7
y de,818,1,5,0,0,0,0,6
like video,817,95,42,12,6,9,0,164
a relationship,817,16,20,4,2,2,1,45
form of,817,14,16,3,3,1,0,37
in everything,817,11,9,4,0,1,0,25
sometimes you,817,11,10,0,1,0,0,22
stay in,817,1,11,1,0,1,0,14
told me,816,19,26,2,1,6,0,54
nc state,816,15,22,0,1,0,0,38
streamer for,816,22,10,4,0,0,0,36
partner at,816,11,12,0,0,1,0,24
s i,816,5,9,2,0,1,0,17
a los,816,2,4,0,0,0,0,6
thank god,816,2,2,1,0,0,0,5
and im,815,15,14,7,2,5,3,46
such a,815,7,29,0,1,2,1,40
http //amazon,815,21,12,4,0,1,0,38
me how,815,14,20,2,0,2,0,38
of houston,815,13,11,1,0,0,0,25
for 20,815,11,9,1,0,1,1,23
add my,815,1,3,1,1,1,0,7
stock trader,815,3,0,0,0,0,0,3
baptist church,815,1,1,0,0,0,0,2
the path,814,12,10,1,2,1,0,26
a democrat,814,4,9,0,1,1,0,15
members of,814,3,2,1,0,0,0,6
profile picture,812,95,32,13,6,9,4,159
and film,812,41,27,5,5,2,0,80
love playing,812,16,10,3,2,1,0,32
a dm,812,14,10,2,1,2,0,29
the work,812,10,13,0,1,1,0,25
change your,812,5,10,1,0,0,0,16
trust in,812,2,5,0,0,2,0,9
repped by,811,51,171,14,2,12,1,251
twitter i,811,21,24,4,1,3,0,53
happens to,811,12,23,4,1,1,0,41
in you,811,17,14,2,3,0,0,36
with others,811,12,11,1,1,1,0,26
of michigan,811,13,10,0,0,0,0,23
com/watch v,811,8,4,1,1,0,0,14
and nfts,811,4,4,0,0,0,0,8
marketing agency,811,2,1,0,0,0,0,3
of fine,810,25,19,3,1,3,0,51
of arizona,810,10,17,1,0,1,0,29
media marketing,810,3,14,1,0,0,0,18
years i,810,7,5,1,2,0,0,15
school sports,810,2,0,0,0,0,0,2
my dad,809,13,17,4,0,1,0,35
you wish,809,7,18,0,0,0,1,26
texas state,809,5,10,1,0,1,0,17
3 kids,809,4,13,0,0,0,0,17
h s,809,2,7,2,1,0,0,12
2 2,809,2,4,2,0,2,0,10
fan go,809,5,3,0,0,0,0,8
dm us,809,0,1,0,0,0,0,1
web designer,808,15,21,6,1,1,0,44
here so,808,17,15,4,1,2,0,39
athletic trainer,808,5,16,0,0,0,0,21
l o,808,4,9,3,0,2,0,18
donald trump,808,4,2,1,0,0,0,7
are human,807,167,136,22,7,15,6,353
good in,807,13,20,1,3,1,0,38
the government,807,9,10,3,2,2,0,26
your head,807,5,14,2,0,0,0,21
el mundo,807,0,4,0,0,0,0,4
and bad,806,45,41,4,6,4,3,103
love anime,806,19,29,7,4,5,2,66
me no,806,13,16,6,0,4,1,40
rocket league,806,25,9,1,4,1,0,40
and wine,806,12,26,0,1,0,0,39
my blog,806,13,19,0,2,2,1,37
in boston,806,12,19,2,0,1,1,35
10 off,806,9,20,0,1,2,0,32
of knowledge,806,12,15,0,0,2,0,29
football player,806,2,2,0,1,0,0,5
for god,806,0,3,0,0,1,0,4
advocate of,805,25,19,2,2,1,0,49
a liberal,805,13,17,0,1,0,1,32
for them,805,15,5,2,5,3,0,30
ceo at,805,10,6,1,0,0,0,17
opportunity to,805,5,3,0,0,0,0,8
o de,805,0,0,0,0,0,0,0
teacher in,804,18,32,1,0,2,0,53
electrical engineer,804,34,6,0,2,5,0,47
not afraid,804,6,25,2,2,0,0,35
of california,804,22,5,0,1,1,0,29
knowledge is,804,4,7,0,0,0,0,11
3d artist,803,60,44,12,12,4,1,133
games anime,803,67,38,4,5,5,0,119
brother son,803,17,0,0,1,0,0,18
women's basketball,803,0,7,0,0,0,0,7
to success,803,0,1,0,1,0,0,2
food lover,802,22,32,1,0,2,0,57
backup account,802,9,16,2,0,1,2,30
the fight,802,4,16,1,1,0,0,22
raised me,802,9,8,0,0,1,0,18
knowledge and,802,6,6,2,1,2,0,17
i bleed,802,1,5,0,1,0,0,7
about to,801,16,22,2,1,2,1,44
who cares,801,7,18,3,1,3,1,33
loves his,801,19,0,0,0,0,0,19
born again,801,6,7,0,0,0,0,13
lot about,800,44,62,11,2,9,0,128
put here,800,30,25,3,8,8,1,75
own a,800,19,12,4,4,2,1,42
physical therapist,800,10,16,0,0,2,0,28
a lifetime,800,10,8,1,1,1,0,21
regular guy,800,11,0,0,0,0,0,11
in jesus,800,1,4,0,0,0,0,5
i study,799,49,91,4,4,3,0,151
the book,799,14,24,3,1,2,0,44
will do,799,18,16,6,1,1,0,42
a focus,799,17,21,3,0,1,0,42
is possible,799,16,17,2,2,1,1,39
austin tx,799,16,11,2,0,0,1,30
to 5,799,3,11,2,0,0,0,16
record label,799,3,0,1,2,0,0,6
alerts events,799,0,0,0,0,0,0,0
crazy cat,798,6,109,3,2,6,2,128
are welcome,798,17,19,2,6,1,1,46
in politics,798,16,11,0,0,2,0,29
it the,798,9,10,0,1,0,0,20
president and,798,7,9,1,0,1,0,18
web design,798,7,7,0,0,0,2,16
the beginning,798,3,11,0,1,0,0,15
fitness enthusiast,798,8,7,0,0,0,0,15
your future,798,6,6,1,1,0,0,14
the market,798,2,0,0,0,0,0,2
tar heel,797,17,44,0,0,1,0,62
always horny,797,28,7,3,5,3,1,47
things you,797,10,19,1,0,1,1,32
meeting new,797,13,6,3,0,1,0,23
daughter and,797,1,14,0,0,0,0,15
service to,797,0,4,1,0,1,0,6
phil 4,797,0,3,0,0,0,0,3
of every,796,14,19,2,1,3,0,39
will find,796,10,11,0,1,0,1,23
and research,796,9,4,1,1,0,0,15
nail tech,796,0,12,1,0,0,0,13
chiefs fan,796,8,2,1,0,0,0,11
opportunities for,796,4,2,0,0,0,0,6
the globe,796,4,1,0,0,0,0,5
safe space,795,33,85,14,9,12,2,155
a blue,795,25,23,1,2,3,0,54
now i’m,795,15,23,2,3,4,1,48
from your,795,7,9,1,0,3,0,20
our lives,795,7,11,2,0,0,0,20
keller williams,795,0,1,0,0,0,0,1
and books,794,19,62,4,4,5,1,95
in history,794,28,25,2,1,1,0,57
see in,794,12,20,3,2,4,0,41
to everyone,794,15,17,2,1,0,0,35
you happy,794,8,18,1,1,1,2,31
up a,794,11,12,0,1,0,0,24
kid from,794,15,4,0,3,2,0,24
most people,794,13,9,0,0,0,0,22
space for,793,19,34,15,2,2,2,74
of politics,793,31,24,1,3,0,2,61
age of,793,19,23,2,2,2,1,49
would you,793,15,21,4,0,7,0,47
with any,793,12,17,1,1,3,1,35
god for,793,1,6,2,0,2,0,11
a private,793,1,4,0,1,0,0,6
sports news,793,1,3,1,0,0,0,5
forex trader,793,0,0,0,0,0,0,0
read and,792,11,37,1,0,2,0,51
that matters,792,8,14,4,2,2,0,30
of content,791,18,17,4,1,1,1,42
force veteran,791,12,9,1,0,1,0,23
miss you,791,7,13,1,1,1,0,23
my cats,790,27,92,7,3,16,0,145
a b,790,9,10,9,1,2,0,31
tweets from,790,12,8,0,0,1,1,22
a l,790,7,4,3,1,2,0,17
the present,790,5,5,2,0,2,0,14
through christ,790,0,2,0,0,0,0,2
product designer,789,44,44,4,5,4,1,102
shows and,789,12,31,2,3,4,0,52
as seen,789,22,18,1,1,3,0,45
every time,789,10,14,3,1,1,0,29
o n,789,3,11,1,1,2,0,18
hey i'm,788,44,32,15,7,12,8,118
woman in,788,1,47,0,0,4,1,53
good person,788,22,18,1,1,4,0,46
can change,788,8,14,2,0,1,0,25
loving and,788,1,10,0,0,0,0,11
come check,788,5,3,1,0,0,0,9
need of,787,20,31,3,0,5,0,59
mayor of,787,27,22,2,2,2,0,55
and every,787,11,16,0,1,3,0,31
1 1,787,8,9,0,0,0,0,17
do art,786,61,74,43,21,23,7,229
i sing,786,24,38,5,3,4,0,74
be able,786,7,10,1,0,3,0,21
state alumni,786,4,11,1,1,0,0,17
generation of,786,3,6,0,0,0,0,9
next level,786,0,3,1,0,1,0,5
and animals,785,16,31,5,0,4,0,56
me http,785,15,19,7,4,3,1,49
not on,785,20,16,0,2,2,0,40
on fb,785,4,13,0,1,0,0,18
the difference,785,6,2,5,0,0,0,13
basketball player,785,7,1,0,0,0,0,8
are your,784,2,6,1,1,1,0,11
community for,784,2,7,1,0,0,0,10
is nothing,784,4,5,0,0,1,0,10
national champion,784,5,2,0,0,1,0,8
idea what,783,32,56,9,10,7,2,116
coffee drinker,783,21,63,0,2,3,0,89
chicago bears,783,7,4,0,0,0,0,11
braves fan,783,7,3,0,0,0,0,10
us in,783,1,4,2,0,0,0,7
candidate at,782,60,100,5,4,7,1,177
treat people,782,4,73,2,0,13,0,92
and editor,782,36,43,4,2,1,2,88
gamer i,782,35,15,2,1,5,2,60
don't need,782,9,19,1,3,0,1,33
between the,782,11,10,0,0,0,0,21
words in,781,46,140,5,4,11,0,206
me know,781,20,11,4,4,1,0,40
the ground,781,15,18,2,3,1,0,39
kind and,781,15,20,1,1,0,0,37
know where,781,6,15,0,1,1,1,24
and grandmother,781,0,3,0,0,0,0,3
social work,780,18,45,5,7,6,0,81
sick of,780,13,25,1,1,3,1,44
sports politics,780,25,16,0,0,2,0,43
without the,780,14,21,2,0,2,0,39
guy and,780,27,1,0,2,0,0,30
watching the,780,8,14,1,0,1,0,24
average guy,780,12,0,0,0,0,0,12
businesses and,780,2,2,0,0,0,0,4
gay and,779,88,27,11,22,9,2,159
writer director,779,37,34,5,3,7,0,86
team member,779,27,27,3,2,2,0,61
the web,779,16,10,1,6,0,0,33
one can,779,11,14,4,0,0,0,29
mind is,779,7,7,3,1,0,0,18
faith and,779,4,9,0,0,0,0,13
tips and,779,5,4,3,0,0,0,12
families and,779,1,3,1,0,0,0,5
will come,778,4,16,0,1,1,0,22
your feelings,778,3,7,3,0,0,0,13
strength and,778,2,1,2,0,0,0,5
company in,778,3,1,0,0,0,0,4
only please,777,73,38,21,13,10,5,160
some guy,777,67,2,2,5,1,1,78
loving it,777,11,7,3,1,1,1,24
we know,777,5,12,1,1,0,0,19
know your,777,1,8,2,0,0,0,11
mi vida,777,1,3,1,0,0,1,6
inc is,777,0,0,0,0,0,0,0
filled with,776,12,26,6,2,6,1,53
did you,776,14,27,3,2,3,1,50
made it,776,9,17,0,2,1,0,29
making it,776,10,14,0,1,3,0,28
and bred,776,7,16,0,0,3,0,26
in austin,776,9,11,2,0,1,0,23
avid sports,776,3,3,0,0,0,0,6
we create,776,2,0,1,0,0,0,3
senior editor,775,41,66,3,0,3,1,114
whatever i,775,21,18,7,5,4,0,55
a year,775,13,15,1,0,2,0,31
self love,775,2,19,2,0,2,0,25
write and,774,37,46,10,6,9,3,111
usa today,774,6,51,0,0,1,0,58
girl from,774,2,25,1,0,1,0,29
outdoors and,774,10,13,0,0,1,0,24
become the,774,4,7,1,3,0,0,15
yeah i,773,17,24,4,3,2,1,51
a youtube,773,26,4,2,3,4,0,39
less than,773,10,13,1,1,2,0,27
in southern,773,9,5,0,0,2,0,16
fellow at,772,33,41,1,0,1,0,76
while i,772,22,19,2,2,2,0,47
me -,772,12,21,8,1,2,1,45
free agent,772,23,8,2,4,0,0,37
oh yeah,772,17,11,4,1,0,0,33
momma to,772,0,25,0,0,2,0,27
is available,772,10,12,1,0,0,0,23
life like,772,9,11,0,0,1,0,21
golf course,772,1,1,0,0,0,0,2
post my,771,34,37,16,4,11,1,103
and likes,771,54,18,2,4,2,0,80
my dms,771,24,30,4,4,5,0,67
a personal,771,20,29,4,0,8,0,61
me from,771,23,22,9,2,3,2,61
contributor to,771,31,24,1,2,2,0,60
working at,771,25,24,1,0,0,0,50
thing i,771,19,19,2,1,2,0,43
and counting,771,21,17,3,1,1,0,43
those that,771,7,7,3,2,0,0,19
final fantasy,770,74,56,13,7,17,4,171
my book,770,23,32,4,3,1,1,64
college graduate,770,14,15,1,0,1,1,32
for collabs,770,12,4,4,5,4,1,30
for content,770,12,12,2,0,1,1,28
and development,770,14,7,0,2,0,1,24
me now,770,9,12,1,0,2,0,24
is key,770,4,9,0,0,0,0,13
to http,770,5,2,2,0,0,0,9
students to,770,1,3,0,0,0,0,4
with kindness,769,2,82,3,0,11,0,98
writer producer,769,23,30,2,1,2,1,59
tweet at,769,17,17,2,2,1,1,40
love making,769,16,13,1,2,1,0,33
and two,769,11,16,1,0,1,0,29
college and,769,8,5,0,0,0,0,13
freedom is,769,1,2,1,0,0,0,4
do that,768,16,15,1,2,3,0,37
decided to,768,13,16,1,2,2,1,35
we the,768,8,3,0,0,1,0,12
go on,767,24,23,0,1,1,2,51
becoming a,767,19,13,7,2,2,0,43
meet ups,767,1,18,1,1,3,0,24
stay positive,767,5,14,1,0,0,0,20
and beautiful,767,5,10,0,3,0,1,19
health wellness,767,0,8,1,0,0,0,9
art i,766,36,42,15,4,11,2,110
once in,766,17,28,1,2,6,0,54
f ck,766,19,15,2,1,1,0,38
the daily,766,12,18,1,0,0,0,31
hmu for,766,5,6,1,2,0,1,15
hopeless romantic,765,20,31,4,2,8,1,66
coordinator for,765,20,28,7,1,2,0,58
keep my,765,11,25,3,0,1,0,40
a future,765,9,14,0,0,2,0,25
licensed in,765,2,3,0,1,0,0,6
world news,765,1,2,0,1,0,0,4
please visit,765,1,2,0,0,0,0,3
conservative patriot,765,0,0,0,0,0,0,0
a hot,764,20,41,7,3,2,0,73
change is,764,19,28,2,0,2,0,51
27 years,764,15,22,3,5,1,4,50
made this,764,19,18,6,3,3,0,49
a random,764,24,16,4,2,1,0,47
keep moving,764,11,11,2,0,0,0,24
white house,764,4,11,0,0,0,0,15
college basketball,764,5,2,1,0,0,0,8
a national,764,0,3,0,0,0,0,3
18 and,763,27,13,4,2,4,1,51
fall in,763,6,22,4,2,3,1,38
i found,763,7,20,0,0,3,0,30
jokes and,762,47,25,7,2,3,1,85
program manager,762,30,33,3,0,2,0,68
of twitter,762,22,10,0,1,1,1,35
black belt,762,20,10,1,0,1,0,32
you enjoy,762,16,8,3,3,2,0,32
junkie and,762,18,10,0,1,0,0,29
moving forward,762,13,11,2,0,0,0,26
go follow,762,12,5,3,2,2,0,24
good guy,762,11,1,0,2,0,0,14
pol tica,762,0,1,0,0,0,0,1
artist musician,761,40,33,10,6,14,2,105
just keep,761,11,19,2,1,0,0,33
and teacher,761,11,13,0,0,1,0,25
loving my,761,5,8,3,1,1,0,18
the team,761,6,6,1,0,1,0,14
to empower,761,2,5,0,0,1,0,8
very much,760,31,37,9,1,8,1,87
my whole,760,13,28,3,3,8,0,55
dir of,760,26,26,1,1,1,0,55
on https,760,21,6,3,3,2,1,36
man that,760,5,4,0,0,0,0,9
highly favored,760,3,3,0,0,1,0,7
from around,760,2,2,0,0,0,0,4
18 i,759,45,33,16,10,15,1,120
a damn,759,20,26,1,1,2,0,50
anime manga,758,29,33,3,0,8,2,75
own retweets,758,19,24,1,1,1,1,47
to call,758,25,11,2,1,1,1,41
chat with,758,10,5,2,0,0,0,17
we also,758,1,3,0,0,1,0,5
let's talk,757,21,31,0,3,1,1,57
only a,757,11,13,2,1,4,1,32
to let,757,7,13,2,2,0,0,24
it ain’t,757,7,12,1,0,0,0,20
the goal,757,7,10,2,0,0,0,19
chicago cubs,757,6,6,0,0,0,0,12
20 yrs,756,12,24,6,1,3,2,48
great again,756,2,1,0,0,0,0,3
i probably,755,27,23,4,6,7,0,67
to turn,755,6,17,3,1,0,1,28
podcast on,755,13,12,2,0,0,0,27
it -,755,12,10,1,0,2,1,26
rock music,755,7,11,1,1,1,0,21
everything that,755,4,11,0,0,0,0,15
orange county,755,5,3,0,1,1,0,10
maga trump,755,0,1,0,0,0,0,1
and game,754,72,26,13,6,6,0,123
me alone,754,9,16,4,0,5,0,34
you be,754,11,11,1,1,1,1,26
called life,754,7,7,3,0,1,0,18
3 2,754,2,2,0,0,0,0,4
to earn,754,2,2,0,0,0,0,4
of her,753,3,36,1,0,3,0,43
about how,753,15,19,0,1,1,0,36
got me,753,8,14,2,0,4,1,29
got my,753,12,12,1,1,2,0,28
husband proud,753,9,0,0,0,0,0,9
medium copy,753,1,7,0,1,0,0,9
2 kids,752,5,17,1,1,0,0,24
arizona state,752,9,8,0,0,0,0,17
family of,752,2,7,0,0,0,0,9
conservative and,752,1,0,0,0,0,0,1
this point,751,19,41,10,6,7,0,83
2 and,751,16,19,1,2,6,1,45
gamer streamer,750,24,20,6,8,5,0,63
and they,750,14,15,3,1,6,0,39
critical care,750,13,22,2,0,1,0,38
there's no,750,6,15,0,2,2,1,26
and coming,750,15,3,2,0,5,0,25
man is,750,4,5,0,1,2,0,12
fishing and,750,4,0,0,0,0,0,4
and pop,749,34,31,4,3,3,0,75
d student,749,21,40,6,2,3,0,72
on an,749,22,17,4,1,0,0,44
make up,749,12,16,1,0,6,1,36
sharing the,749,4,2,0,0,0,1,7
health policy,748,34,71,1,0,3,1,110
d candidate,748,31,66,4,0,5,1,107
please be,748,39,43,8,4,10,0,104
you're a,748,26,15,4,3,6,4,58
them all,748,8,21,1,3,2,0,35
a loving,748,10,4,2,0,0,0,16
managing partner,748,2,3,0,0,1,0,6
all mine,747,31,80,1,0,4,0,116
long walks,747,15,19,2,2,3,0,41
somewhere in,747,8,13,0,2,2,1,26
the resistance,747,6,16,0,0,1,0,23
m o,747,1,9,1,1,2,0,14
ba in,746,33,43,4,5,7,0,92
substack com,746,24,28,5,0,0,0,57
it's just,746,18,18,1,2,1,0,40
pay me,746,10,19,3,3,2,0,37
masters in,746,14,17,4,1,1,0,37
and director,746,16,11,2,1,2,0,32
i'm me,746,6,7,0,0,1,2,16
one time,745,26,22,2,2,2,0,54
is hard,745,9,19,2,3,2,1,36
get off,745,12,14,1,0,3,1,31
casual gamer,744,40,35,5,4,4,1,89
on discord,744,41,24,7,5,7,3,87
doctoral student,744,24,43,4,1,2,0,74
an aspiring,744,36,21,4,5,3,2,71
the white,744,15,15,1,3,1,1,36
com /,744,14,13,0,2,3,0,32
not have,744,13,11,2,2,2,0,30
for others,744,12,14,0,0,0,1,27
long beach,744,6,9,0,1,0,0,16
beauty of,744,2,7,0,1,1,0,11
the entire,744,3,4,0,0,0,0,7
dot com,743,61,49,9,6,4,3,132
the opinions,743,29,15,3,1,1,1,50
bio to,743,17,7,3,1,3,0,31
be free,743,8,13,2,1,2,1,27
real and,743,7,13,1,1,2,0,24
protect the,743,7,13,1,0,0,0,21
3 amazing,743,2,8,0,0,0,0,10
some other,742,39,30,4,4,1,3,81
medical advice,742,27,40,0,0,1,0,68
trades master,742,25,15,4,1,2,0,47
responsible for,742,13,16,3,0,0,0,32
a crazy,742,7,19,1,0,0,1,28
below for,742,3,10,1,0,4,1,19
get along,742,11,5,2,0,0,0,18
thankful for,742,2,8,1,0,0,0,11
estate and,742,2,3,0,0,0,0,5
personal injury,742,0,1,0,0,0,0,1
horror movie,741,27,48,2,1,9,2,89
voting rights,741,18,41,1,0,1,0,61
and full,741,16,20,6,5,6,1,54
the wind,741,7,14,6,1,0,0,28
of washington,741,14,13,0,1,0,0,28
to check,741,6,14,4,2,0,0,26
all for,741,7,14,1,0,1,0,23
will block,740,32,29,9,6,4,0,80
also known,740,19,27,3,0,9,0,58
support my,740,17,22,2,2,2,0,45
girl and,740,1,34,0,0,5,1,41
dreams and,740,5,15,5,0,1,1,27
to raise,740,6,14,0,0,1,0,21
best way,740,6,10,1,1,2,0,20
daddy to,740,14,0,1,1,1,0,17
american dream,740,6,6,0,0,0,0,12
beautiful children,740,4,1,0,0,0,0,5
louis cardinals,740,3,1,0,0,1,0,5
bandcamp com,739,39,14,12,6,7,1,79
just having,739,17,5,1,2,1,1,27
r a,739,9,6,1,0,2,0,18
to sell,739,8,3,1,1,0,0,13
we’re your,739,0,0,0,0,0,0,0
horror and,738,53,52,13,4,11,1,134
about anything,738,22,11,0,2,1,0,36
sister daughter,738,0,26,0,0,0,0,26
contributor for,738,14,9,0,0,1,0,24
want the,738,4,11,0,2,1,1,19
disciple of,738,8,3,1,0,0,0,12
line coach,738,1,0,0,0,0,0,1
these days,737,31,33,9,1,4,0,78
cook and,737,17,22,3,2,1,0,45
a million,737,6,22,3,1,0,0,32
school counselor,737,7,23,1,0,1,0,32
a high,737,8,7,2,0,1,0,18
love in,736,8,23,4,1,5,0,41
and has,736,9,15,3,3,1,1,32
country boy,736,2,0,0,1,0,0,3
tarot reader,735,12,62,12,4,21,2,113
podcast and,735,28,14,1,1,0,0,44
a movie,735,19,11,3,1,1,0,35
coming to,735,13,17,2,0,0,1,33
and watching,735,9,12,2,3,0,1,27
fashion and,735,7,14,1,0,1,2,25
in st,735,6,9,0,0,0,1,16
passion is,735,6,3,0,0,0,0,9
dream big,735,2,6,0,0,0,0,8
just doing,734,15,30,4,6,2,0,57
wanna know,734,7,9,1,0,0,0,17
you back,734,6,4,1,0,0,0,11
love this,734,0,4,2,1,1,0,8
only no,733,39,30,9,10,3,5,96
for love,733,9,21,3,2,3,0,38
to teach,732,18,19,0,1,0,0,38
all love,732,7,14,4,1,4,2,32
from chicago,732,14,3,6,2,0,0,25
depends on,732,5,10,1,1,1,1,19
and college,732,8,7,0,0,0,0,15
of 7,732,5,4,0,1,0,0,10
a public,731,12,22,3,1,2,0,40
we don’t,731,8,21,2,0,0,0,31
institute of,731,12,7,0,2,0,0,21
can only,731,5,8,4,0,2,1,20
bring you,731,2,4,0,0,0,2,8
his own,730,27,3,0,2,0,0,32
and i’ll,730,18,12,0,0,1,1,32
fanatic and,730,15,9,3,1,0,1,29
michigan state,730,10,9,1,0,0,0,20
fly high,730,4,8,3,0,0,0,15
or whatever,729,44,35,11,6,4,1,101
think i’m,729,16,47,3,1,7,0,74
and that's,729,21,14,4,4,3,2,48
got it,729,13,8,3,0,0,0,24
on their,729,6,13,2,0,1,1,23
and home,729,6,12,0,0,0,0,18
excellence in,729,4,2,0,0,0,0,6
is committed,729,0,0,0,0,0,0,0
at work,728,20,21,0,3,1,1,46
let’s talk,728,16,19,0,4,3,0,42
i'm going,728,16,15,4,1,1,2,39
living for,728,7,22,0,0,1,0,30
keeping it,728,9,5,2,1,2,0,19
from our,728,2,5,2,0,0,0,9
only i,727,23,15,8,4,8,1,59
of real,727,6,7,2,1,1,0,17
and build,727,9,5,0,1,0,0,15
n a,727,6,6,0,0,0,0,12
es mi,727,2,5,4,0,0,0,11
talk show,727,4,2,0,1,0,0,7
1/3 of,726,34,28,4,3,6,2,77
until the,726,10,20,2,1,1,0,34
under construction,726,9,13,3,0,2,1,28
and roll,726,11,11,0,1,0,0,23
the digital,726,6,4,1,0,0,1,12
the police,725,91,88,27,9,21,1,237
things for,725,35,39,5,0,3,1,83
mind me,725,11,22,10,4,4,0,51
videos on,725,16,10,1,3,2,0,32
it do,725,4,9,0,1,3,0,17
the industry,725,4,5,1,0,3,0,13
blessed and,725,4,4,0,0,1,0,9
family love,725,1,1,0,0,0,1,3
pics of,724,23,29,6,0,3,0,61
to like,724,28,14,3,5,0,0,50
end the,724,13,12,1,1,2,1,30
up i,724,9,10,2,0,1,0,22
before the,724,11,6,1,2,1,1,22
school baseball,724,0,0,0,0,0,0,0
i didn't,723,22,20,1,2,1,0,46
public education,723,7,29,0,0,3,0,39
bass player,722,36,7,4,0,0,0,47
i'm always,721,16,15,4,1,0,0,36
and he,721,7,9,1,0,1,1,19
atlanta ga,721,7,5,0,0,0,0,12
awesome kids,721,7,4,0,0,0,0,11
advisor at,721,2,4,0,0,0,0,6
the culture,721,1,2,0,0,0,0,3
for being,720,8,17,5,1,3,2,36
for truth,720,4,6,0,0,0,0,10
writing a,719,26,47,6,6,7,1,93
data and,719,19,15,1,0,4,0,39
in music,719,16,18,1,0,0,1,36
to sing,719,14,6,4,1,2,0,27
difference in,719,1,8,1,0,0,0,10
cooking and,718,23,24,0,0,1,1,49
we're all,718,18,15,5,0,1,0,39
t a,718,8,17,1,2,2,1,31
want you,718,8,21,0,0,0,0,29
have 2,718,6,14,0,0,0,0,20
all good,718,4,7,0,0,0,2,13
and online,718,3,4,0,0,0,0,7
enjoyer of,717,69,33,8,7,3,0,120
person and,717,20,17,9,2,3,0,51
tv show,717,10,19,1,1,2,0,33
are on,717,10,9,2,4,0,1,26
with two,717,9,11,1,2,0,0,23
with other,717,11,8,1,0,0,0,20
the true,717,8,9,1,0,0,0,18
share the,717,9,6,2,0,0,0,17
of st,717,7,3,0,0,0,0,10
to fuck,716,9,9,1,1,2,1,23
with 2,716,2,9,0,1,0,1,13
wealth management,716,1,2,0,0,0,0,3
mix of,715,33,27,9,4,6,1,80
who lives,715,14,18,7,1,0,0,40
in college,715,21,9,2,2,1,1,36
identify as,715,15,8,5,1,2,2,33
top of,715,11,8,1,1,0,0,21
the wall,715,8,6,1,0,4,0,19
fitness wellness,715,0,1,0,0,2,0,3
designer for,714,52,26,4,3,3,1,89
but they,714,17,14,2,2,6,0,41
to feel,714,10,18,3,2,7,1,41
always have,714,9,15,2,0,2,0,28
of san,714,7,4,0,1,0,0,12
softball coach,714,2,5,0,0,0,0,7
no se,714,3,2,0,0,0,0,5
por la,714,2,0,0,0,1,0,3
school athletics,714,0,0,0,0,0,0,0
22 //,713,35,57,12,7,22,1,134
parent of,713,18,26,9,6,9,2,70
more i,713,14,19,6,0,1,0,40
have any,713,14,9,4,1,3,1,32
see a,713,5,17,2,3,1,1,29
licensed esthetician,713,0,25,2,1,0,0,28
of great,713,9,14,1,1,1,0,26
in northern,713,3,6,1,0,0,0,10
it happen,713,1,5,1,2,0,0,9
school c/o,713,0,0,0,0,0,0,0
dm’s open,712,48,9,7,7,6,0,77
can never,712,14,14,1,2,2,0,33
of twins,712,13,19,0,0,0,0,32
hate the,712,10,10,1,3,0,0,24
the green,712,12,5,1,1,2,0,21
consultant and,712,7,7,0,1,0,0,15
on snapchat,712,4,2,0,0,0,0,6
online classes,712,0,2,0,0,0,0,2
and educator,711,20,16,3,3,0,0,42
tech geek,711,27,7,1,2,0,0,37
a job,711,12,21,0,3,0,0,36
pro wrestler,711,15,7,1,3,2,3,31
over here,711,11,11,1,2,2,1,28
the mountains,711,11,14,0,1,0,0,26
a i,711,9,7,1,1,1,0,19
physical therapy,711,6,6,0,0,1,0,13
copy link,711,1,7,0,1,0,0,9
partner of,710,21,11,8,1,0,1,42
with this,710,17,16,1,1,2,0,37
i trust,710,3,7,0,0,0,0,10
go away,709,15,38,6,4,5,1,69
i've got,709,19,23,9,1,3,0,55
am in,709,14,15,2,3,3,0,37
and her,709,5,25,0,0,0,0,30
and over,709,20,3,0,0,1,0,24
all state,709,1,0,0,0,0,0,1
that i'm,708,15,16,1,2,4,0,38
ass and,708,15,10,5,1,2,0,33
hi im,707,25,41,18,11,12,5,112
know a,707,19,17,4,0,3,0,43
you but,707,13,20,3,0,0,0,36
what are,707,8,15,5,1,1,0,30
of iowa,707,5,14,0,1,1,0,21
guy living,707,12,0,0,1,0,0,13
artist producer,707,8,2,2,0,0,0,12
father friend,707,9,0,0,0,0,0,9
the glory,707,1,5,1,0,1,0,8
family i,707,3,4,0,0,0,0,7
affiliate of,707,2,3,0,0,0,0,5
i’m funny,706,25,42,6,3,8,0,84
just out,706,15,31,2,0,3,2,53
married mom,706,0,33,1,0,0,0,34
rock n,706,7,13,1,0,1,1,23
watch my,706,12,7,1,1,1,0,22
so we,706,4,11,0,1,0,2,18
the bible,706,7,3,2,0,0,1,13
are cool,705,58,33,4,10,4,1,110
about music,705,38,29,4,1,4,0,76
person in,705,14,24,5,1,3,1,48
resident of,705,15,22,3,0,3,0,43
choose to,705,5,16,3,1,2,0,27
safe and,705,7,11,1,2,1,0,22
managing director,705,5,14,0,1,0,0,20
humor and,704,11,29,1,1,2,0,44
the water,704,10,11,0,1,1,0,23
fear of,704,5,9,0,0,2,0,16
a country,704,5,7,0,1,0,0,13
i once,703,21,18,2,2,0,1,44
a college,703,16,17,1,2,1,0,37
i i,703,10,15,3,5,4,0,37
old soul,703,7,22,0,0,3,0,32
friends i,703,7,13,4,3,2,0,29
the reason,703,4,12,1,1,4,0,22
keynote speaker,703,9,11,0,0,1,0,21
while you,703,6,11,1,0,0,0,18
you ain’t,703,4,4,0,0,0,0,8
it's good,703,3,3,0,0,1,0,7
state football,703,2,1,0,0,0,0,3
a furry,702,81,29,12,9,6,4,141
story of,702,14,6,1,0,1,1,23
bills fan,702,9,8,0,0,0,0,17
economic development,702,2,6,0,0,1,0,9
10 000,702,2,2,0,3,0,0,7
and service,702,2,2,0,0,0,1,5
cup of,701,8,33,4,1,5,0,51
anyone who,701,14,13,1,2,4,0,34
pay for,701,15,11,1,1,2,0,30
resist fbr,701,8,16,1,0,0,0,25
anything that,701,8,10,1,4,1,0,24
alum and,701,13,10,0,0,0,0,23
the gym,701,8,5,1,1,0,0,15
of legends,700,38,19,2,5,1,0,65
and ready,700,12,15,10,2,2,0,41
d i,700,14,15,6,1,2,2,40
american and,700,6,5,0,0,0,0,11
save our,700,1,6,0,0,1,0,8
entrepreneur investor,700,3,0,0,0,0,0,3
c/o 2025,700,0,0,0,0,0,0,0
who plays,699,46,22,4,4,2,2,80
and black,699,15,30,2,6,1,1,55
my baby,699,8,17,1,1,2,0,29
not advice,699,5,8,0,0,0,0,13
live free,699,2,3,0,0,0,0,5
of words,698,22,74,0,0,3,0,99
likes are,698,44,11,4,11,2,1,73
a in,698,16,29,6,1,6,0,58
little things,698,10,22,1,0,2,0,35
christian and,698,6,1,1,0,0,1,9
get money,698,2,2,1,0,0,0,5
love cats,697,10,37,9,2,4,0,62
but always,697,16,20,2,3,7,0,48
and don’t,697,14,20,1,0,4,1,40
manager and,697,15,13,3,3,2,0,36
keep me,697,6,18,2,0,1,0,27
place where,697,10,7,2,2,1,0,22
and respect,697,6,10,1,0,1,0,18
it right,697,7,11,0,0,0,0,18
it's time,697,7,9,0,0,0,0,16
deleted at,697,3,5,3,0,1,0,12
a twitch,696,15,17,12,3,7,1,55
if it's,696,16,17,0,1,2,0,36
the darkness,696,11,14,1,0,0,0,26
rhode island,696,13,9,0,0,2,1,25
elon musk,696,9,5,3,0,1,0,18
a blessing,696,0,6,0,0,1,0,7
providing the,696,0,0,0,0,0,0,0
genshin impact,695,37,96,12,7,26,4,182
a side,695,18,30,5,3,4,1,61
i’m still,695,15,31,1,1,6,0,54
to hell,695,9,21,3,2,3,1,39
i thought,695,9,21,4,0,0,1,35
a photographer,695,8,13,1,0,3,0,25
on social,695,7,8,2,2,1,0,20
definitely not,694,36,36,3,2,7,0,84
own rts,694,23,29,2,1,1,0,56
cool and,694,15,16,2,3,7,0,43
and funny,694,15,15,6,2,2,1,41
can take,694,6,9,1,1,0,2,19
el paso,694,6,8,1,2,1,0,18
content creators,694,7,5,2,0,3,0,17
focuses on,694,3,7,1,0,0,0,11
basketball fan,694,7,3,0,0,1,0,11
hard worker,694,2,1,0,0,0,0,3
r b/soul,694,0,0,0,0,0,0,0
a music,693,15,8,2,0,0,0,25
organization dedicated,693,0,0,0,0,0,0,0
retweets endorsements,692,18,25,1,1,0,0,45
striving for,692,8,15,1,0,0,0,24
my link,692,6,6,1,1,1,0,15
carpe diem,692,5,7,0,0,0,0,12
you not,692,2,5,2,0,0,0,9
for commissions,691,45,62,20,5,18,1,151
artist of,691,29,30,4,1,4,5,73
content is,691,29,15,3,4,1,0,52
funny and,691,18,24,4,1,0,0,47
n e,691,3,21,2,0,2,0,28
even when,691,5,14,2,1,1,0,23
radio station,691,1,2,2,0,0,0,5
stocks and,691,1,0,0,0,0,0,1
amount of,690,32,30,1,3,3,2,71
and shit,690,18,16,6,2,3,1,46
i call,690,4,19,2,1,2,0,28
the air,690,14,10,1,0,1,0,26
to move,690,10,11,0,1,1,0,23
life has,690,5,9,0,0,0,0,14
of crypto,690,0,1,0,0,0,0,1
cohost of,689,57,55,8,3,5,1,129
be 18,689,33,19,13,5,5,0,75
of some,689,24,24,6,2,3,3,62
and reading,689,10,36,1,1,0,0,48
blue dot,689,2,36,0,0,0,0,38
someone else,689,10,13,1,1,1,0,26
for entertainment,689,6,4,0,0,0,0,10
site for,689,2,2,1,2,0,0,7
your mom,688,14,34,3,1,7,1,60
too seriously,688,15,15,5,0,3,0,38
dog owner,687,24,25,0,0,1,0,50
ref wl,687,9,15,4,1,0,0,29
life but,687,9,11,0,0,1,0,21
leave a,687,8,7,2,0,1,1,19
first team,687,0,0,0,0,0,0,0
a fucking,686,16,32,11,3,7,0,69
can have,686,7,17,2,0,0,0,26
and laugh,686,14,10,0,0,0,1,25
you really,686,7,8,3,1,4,0,23
o a,686,5,5,0,0,0,0,10
g o,686,4,4,1,0,0,0,9
gamer girl,685,1,95,1,1,7,0,105
on to,685,10,10,3,1,1,0,25
on xbox,685,17,7,0,1,0,0,25
- ig,685,9,10,1,2,1,0,23
the chicago,685,7,8,0,2,0,0,17
be true,685,2,12,1,0,1,1,17
you you,685,3,7,0,2,3,1,16
eagles fan,685,4,3,0,0,0,0,7
que se,685,1,1,0,0,1,0,3
updates from,685,1,1,0,0,0,0,2
bitcoin ethereum,685,1,0,0,0,0,0,1
old enough,684,23,32,4,2,1,0,62
somewhere between,684,16,22,3,2,2,0,45
out loud,684,12,21,1,0,1,0,35
washington state,684,12,13,1,1,1,0,28
have one,684,9,10,1,2,1,0,23
of learning,684,5,13,1,2,0,0,21
sports writer,684,12,3,0,0,1,0,16
that helps,684,3,4,1,0,1,0,9
formerly known,683,21,17,7,6,4,1,56
with good,683,6,13,1,0,1,0,21
loves her,683,0,19,0,0,0,0,19
and post,682,29,16,5,9,7,1,67
represent the,682,24,13,2,1,1,1,42
it’s me,682,15,20,1,0,2,0,38
only on,682,7,13,3,1,2,1,27
c a,682,1,10,6,1,1,0,19
the quality,682,5,1,1,0,0,1,8
todo lo,682,1,0,0,0,0,0,1
pretty good,681,26,21,5,1,2,0,55
want me,681,20,20,4,1,4,1,50
am very,681,15,27,4,1,3,0,50
to dance,681,3,27,2,2,3,0,37
the face,681,13,12,2,0,2,0,29
center of,681,7,8,0,0,0,0,15
of alabama,681,6,5,0,0,0,0,11
led by,681,1,1,0,0,0,0,2
art lover,680,22,31,3,2,3,0,61
i didn’t,680,9,27,0,3,4,1,44
an angel,680,4,17,3,1,2,0,27
san jose,680,7,8,0,2,0,0,17
la vie,680,5,9,1,0,0,0,15
to better,680,7,4,0,0,1,0,12
baseball team,680,2,1,0,0,0,0,3
jesus husband,680,0,0,0,0,0,0,0
for no,679,21,10,1,1,4,1,38
28 years,679,15,12,2,2,2,1,34
they will,679,4,11,1,0,1,0,17
utah jazz,679,10,5,0,0,0,0,15
self employed,679,0,0,0,0,0,0,0
photos and,678,22,14,0,1,2,0,39
travel enthusiast,678,3,24,1,0,1,0,29
making my,678,12,13,2,0,0,0,27
me be,678,9,10,2,1,3,0,25
are no,678,11,9,2,0,3,0,25
of political,678,12,11,1,0,0,0,24
sports editor,678,10,6,1,0,0,0,17
tennis player,678,5,7,0,1,1,0,14
nursing student,677,16,38,0,0,1,0,55
research fellow,677,22,31,0,1,1,0,55
great day,677,6,10,2,2,0,2,22
brand new,677,9,8,1,0,0,0,18
get spoiled,677,0,0,0,0,0,0,0
hate it,676,18,31,2,2,2,1,56
player in,676,31,9,2,2,0,0,44
you deserve,676,6,14,1,2,0,0,23
just do,676,7,13,0,1,2,0,23
go pack,676,7,8,0,0,0,0,15
defensive coordinator,676,1,0,0,0,0,0,1
buy my,675,25,27,6,8,3,0,69
video producer,675,28,24,2,4,2,1,61
a youtuber,675,16,7,1,1,1,1,27
book me,675,4,8,1,0,2,0,15
god in,675,4,7,1,0,1,0,13
amazing wife,675,8,2,0,0,0,0,10
like this,674,12,25,3,1,7,1,49
personal views,674,23,21,2,1,1,0,48
my of,674,13,15,2,0,6,0,36
not equal,674,10,18,1,0,0,0,29
5 years,674,7,7,4,0,0,0,18
share your,674,3,2,0,0,0,0,5
all district,674,0,0,0,0,0,0,0
random stuff,673,29,15,9,3,7,0,63
but it’s,673,15,20,7,1,3,0,46
mom dog,673,0,40,0,0,3,0,43
me back,673,9,24,1,0,2,0,36
can't be,673,11,11,1,2,1,0,26
path to,673,7,5,0,1,1,0,14
i’m going,672,11,25,1,0,3,0,40
you guys,672,8,13,4,1,0,0,26
fun i,672,12,7,3,0,2,0,24
by and,672,6,9,0,1,0,1,17
who want,672,6,5,0,0,0,0,11
got hacked,672,2,4,0,0,0,0,6
college baseball,672,1,1,0,0,0,0,2
dms always,671,80,14,10,9,5,1,119
things with,671,23,25,4,2,0,0,54
on of,671,11,27,5,1,6,0,50
space and,671,22,21,2,0,3,0,48
author the,671,16,28,0,1,2,0,47
don’t ask,671,10,16,3,3,2,0,34
for one,671,13,13,1,0,2,0,29
world where,671,8,16,2,0,1,0,27
school for,671,7,7,2,2,0,0,18
fun in,671,6,8,2,1,1,0,18
medical center,671,5,4,1,0,0,0,10
beautiful daughters,671,3,1,0,0,0,0,4
news in,671,1,1,0,0,0,0,2
done by,670,61,33,16,7,7,1,125
like anime,670,28,33,4,5,6,2,78
let's be,670,19,29,2,1,5,1,57
film tv,670,21,29,1,0,2,0,53
yet to,670,5,10,2,0,2,0,19
go bills,670,10,8,1,0,0,0,19
don't give,670,4,10,1,0,0,0,15
more at,670,9,4,0,0,1,0,14
proudly serving,670,3,2,0,0,0,0,5
sports talk,670,1,1,0,0,0,0,2
on gettr,670,0,0,0,0,0,0,0
23 //,669,25,62,18,8,9,1,123
writer poet,669,20,38,5,2,4,2,71
lord of,669,40,13,3,2,2,0,60
pictures and,669,15,16,5,3,2,0,41
we were,669,8,20,1,0,1,0,30
proud wife,669,0,20,0,0,1,0,21
central florida,669,4,7,1,0,0,0,12
retired rn,669,0,11,0,0,0,0,11
every moment,669,1,6,0,2,2,0,11
beautiful and,668,8,10,3,0,1,1,23
21st century,668,11,7,3,0,1,1,23
you dont,668,7,8,3,1,3,0,22
liverpool fc,668,12,8,1,0,0,0,21
instagram and,668,4,13,1,2,0,1,21
man trying,668,16,0,0,2,0,0,18
investor in,668,2,0,0,0,0,0,2
all thoughts,667,23,66,6,1,4,1,101
history nerd,667,37,45,6,4,1,1,94
like an,667,15,23,0,1,2,1,42
your fav,667,9,12,1,1,2,0,25
in us,667,6,10,1,0,0,0,17
2 great,667,1,7,0,0,0,1,9
miami heat,667,4,4,0,0,0,0,8
come for,666,35,39,3,2,3,1,83
book reader,666,19,45,2,1,2,0,69
the amazing,666,22,21,3,3,3,1,53
don't forget,666,12,7,2,1,5,0,27
how can,666,10,13,1,1,1,0,26
mine not,665,53,35,2,2,0,0,92
my jam,665,28,43,4,2,4,0,81
journalist and,665,16,21,2,2,0,0,41
teaching and,665,10,11,1,0,0,0,22
till the,665,9,7,0,0,1,0,17
a top,665,11,2,1,1,0,0,15
he has,665,5,1,0,0,0,0,6
22 /,664,19,33,5,9,10,0,76
think i'm,664,26,38,7,2,3,0,76
and random,664,26,25,5,3,4,1,64
a problem,664,9,17,2,2,2,1,33
detroit sports,664,14,1,0,1,0,0,16
pastor at,664,5,4,0,0,0,0,9
a 501,664,1,0,0,0,0,0,1
not as,663,23,15,2,3,1,0,44
my spirit,663,17,22,1,0,2,0,42
fan /,663,16,20,1,0,0,0,37
since 2017,663,15,17,0,0,0,0,32
you how,663,5,4,2,0,1,0,12
he who,663,7,2,0,0,0,0,9
sports reporter,663,2,5,0,0,0,0,7
roman catholic,663,3,2,0,0,0,0,5
curator of,662,27,20,3,1,3,0,54
and open,662,12,14,2,3,1,1,33
the line,662,13,14,0,2,1,0,30
leave the,662,7,16,2,0,2,0,27
i s,662,8,10,2,0,0,0,20
packers fan,662,10,7,1,0,0,0,18
fan proud,662,6,9,1,0,1,0,17
entertainment and,662,9,6,0,0,2,0,17
journey of,662,8,3,2,2,1,0,16
let live,662,2,11,0,1,1,0,15
husband -,662,14,0,0,0,0,0,14
a son,662,6,2,0,0,1,0,9
information technology,662,5,1,0,1,0,0,7
to stand,662,4,1,0,1,0,0,6
thousands of,662,2,2,0,0,0,0,4
sort of,661,32,27,5,2,3,1,70
for money,661,16,14,4,2,2,0,38
now link,661,10,3,3,0,3,0,19
for freedom,661,1,5,2,0,0,0,8
studies teacher,660,17,21,1,1,0,0,40
my spare,660,16,17,5,0,1,1,40
father teacher,660,15,0,0,0,0,0,15
life liberty,660,3,2,0,0,0,0,5
i ain't,659,5,10,1,1,0,0,17
let go,659,2,14,0,0,0,0,16
youtube com/watch,659,3,4,0,1,0,0,8
more we’re,659,0,0,0,0,0,0,0
i rt,658,43,36,9,11,20,0,119
the pnw,658,29,34,10,4,5,1,83
5th grade,658,7,21,0,0,0,0,28
i’m from,658,8,11,0,0,3,0,22
here on,658,10,5,1,1,4,0,21
speaker and,658,6,7,0,0,0,0,13
for daily,658,3,3,0,0,1,0,7
avatar by,657,144,77,23,18,10,10,282
opinions of,657,25,18,3,1,1,0,48
of both,657,14,23,3,0,2,0,42
rts not,657,14,23,0,0,0,1,38
his way,657,29,0,2,2,0,1,34
also the,657,19,5,1,0,2,1,28
my story,657,3,9,0,0,3,0,15
a nigga,657,2,1,0,1,0,0,4
commissions are,656,50,65,29,14,30,3,191
the woods,656,17,43,6,3,4,0,73
because it,656,13,8,2,0,2,0,25
is open,656,9,7,1,2,2,0,21
south dakota,656,4,7,0,0,0,0,11
biden is,656,3,4,1,0,0,0,8
us marine,656,4,2,0,0,0,0,6
3 9,656,1,1,0,0,0,0,2
for greatness,656,1,1,0,0,0,0,2
like music,655,29,30,11,1,10,0,81
artist designer,655,21,25,7,3,8,0,64
fan who,655,17,8,1,1,1,0,28
- love,655,13,6,4,2,1,1,27
be one,655,8,10,3,0,1,0,22
3 1,655,5,8,0,3,1,0,17
trans woman,654,1,266,4,0,28,7,306
worth it,654,8,16,4,2,1,1,32
no 1,654,8,9,0,0,3,0,20
new here,654,5,8,1,1,0,0,15
psalm 46,654,0,7,0,0,1,0,8
angel investor,654,5,3,0,0,0,0,8
county high,654,0,1,0,0,0,0,1
software dev,653,87,25,6,2,1,3,124
the coolest,653,11,19,0,3,1,0,34
name of,653,15,9,1,1,4,0,30
social and,653,15,8,1,0,1,2,27
state grad,653,15,7,0,0,1,0,23
people laugh,653,12,6,3,0,0,1,22
know my,653,9,8,1,1,1,0,20
and peace,653,4,1,1,0,0,0,6
designer at,652,86,36,9,5,2,0,138
is best,652,34,21,1,3,5,0,64
use the,652,15,16,3,1,0,1,36
purposes only,652,3,5,1,0,0,1,10
and high,652,4,3,1,0,0,0,8
still trying,651,16,31,1,1,2,0,51
i'm into,651,20,13,1,2,2,0,38
are only,651,15,15,1,0,2,0,33
keep on,651,8,17,3,0,0,1,29
it gets,651,14,7,0,0,7,0,28
hotmail com,651,13,9,2,1,1,0,26
just because,651,6,12,3,0,1,0,22
came to,651,10,7,2,0,0,1,20
see how,651,8,8,3,0,0,0,19
- we,651,6,6,2,0,1,1,16
general news,651,0,0,0,0,0,0,0
nerd who,650,64,33,17,8,8,6,136
very good,650,17,27,4,1,3,0,52
all this,650,18,16,2,2,1,1,40
water and,650,10,13,1,4,2,0,30
for someone,650,14,12,0,2,1,1,30
in ohio,650,7,11,2,2,0,1,23
photographer videographer,650,9,5,1,0,0,0,15
therefore i,649,15,16,1,0,1,0,33
n roll,649,6,12,1,0,1,1,21
8 18,649,1,5,1,0,3,0,10
my snap,649,4,1,1,1,1,0,8
equity and,648,18,37,3,4,2,1,65
york times,648,24,25,1,1,1,0,52
early childhood,648,5,34,2,0,2,0,43
want my,648,9,15,2,2,3,1,32
to any,648,9,10,2,2,3,0,26
it you,648,7,12,1,0,3,0,23
denver broncos,648,2,2,0,0,0,0,4
business man,648,3,0,0,0,0,0,3
fiction writer,647,53,84,6,2,4,0,149
and hockey,647,14,28,3,0,5,1,51
my podcast,647,19,9,3,1,3,1,36
college alum,647,10,22,0,0,1,0,33
director -,647,13,9,0,1,0,0,23
you so,647,3,14,2,0,0,0,19
love art,646,15,23,5,1,3,1,48
after a,646,13,19,2,2,2,1,39
wait for,646,4,6,1,1,0,0,12
also on,645,11,17,4,0,3,0,35
thing that,645,10,11,2,2,3,0,28
blogger and,645,4,17,3,0,0,0,24
point of,645,6,12,0,0,2,0,20
a queen,645,3,9,1,0,3,0,16
married for,645,0,3,0,0,0,0,3
enthusiast /,644,29,20,3,3,6,0,61
it's me,644,15,19,8,5,3,2,52
a special,644,10,7,0,1,2,1,21
silicon valley,644,11,8,0,0,0,0,19
and blue,644,12,3,0,0,1,0,16
graduated from,644,7,4,0,0,1,0,12
keep you,644,2,2,0,0,1,0,5
selection of,644,1,2,0,0,0,0,3
loves all,643,15,26,3,1,1,1,47
news reporter,643,6,20,1,0,1,0,28
sales manager,643,8,2,0,0,0,0,10
we serve,643,0,1,1,0,0,0,2
comments are,642,12,13,1,1,1,1,29
be who,642,6,12,0,1,2,0,21
a certified,642,7,7,3,1,1,0,19
country girl,642,1,8,0,0,0,0,9
to develop,642,3,1,0,0,0,0,4
life insurance,642,0,0,0,0,0,0,0
420 friendly,641,15,33,6,4,6,0,64
but don't,641,19,13,2,1,1,3,39
how do,641,11,16,3,2,5,0,37
said i,641,12,12,4,1,1,0,30
music in,641,14,12,3,0,1,0,30
come back,641,10,13,2,1,1,0,27
the core,641,9,13,0,1,0,0,23
mind your,641,2,10,0,0,3,0,15
com instagram,641,2,2,0,1,1,0,6
pretty cool,640,32,24,5,3,1,1,66
out what,640,15,24,3,2,3,0,47
i'd rather,640,12,19,1,1,0,0,33
and local,640,7,10,4,0,3,1,25
up your,640,9,14,0,1,0,0,24
all who,640,9,12,2,0,0,0,23
one step,640,8,13,0,0,1,0,22
they have,640,7,6,2,0,2,0,17
on in,640,5,10,1,0,0,0,16
fort worth,640,4,2,0,1,2,0,9
words and,639,26,35,5,0,4,0,70
other than,639,17,15,1,2,4,1,40
is being,639,13,18,3,1,2,1,38
and forever,639,11,18,3,2,1,1,36
and it's,639,15,13,2,2,2,1,35
account was,639,12,7,2,0,0,1,22
top 1,639,6,11,0,1,4,0,22
don’t give,639,2,12,2,0,2,0,18
for success,639,0,2,0,0,0,0,2
call 911,639,0,0,0,0,0,0,0
are solely,638,24,24,4,1,2,0,55
// http,638,14,19,8,5,4,0,50
loves music,638,15,12,1,0,1,0,29
get on,638,10,10,2,1,2,1,26
info on,638,6,7,0,1,1,0,15
news anchor,638,3,5,0,0,0,0,8
my savior,638,2,1,1,0,0,0,4
tend to,637,24,24,3,1,5,2,59
the second,637,10,13,1,1,0,0,25
enjoy it,637,6,7,0,0,0,0,13
likes and,636,35,15,5,6,6,1,68
an idiot,636,29,21,5,2,1,0,58
love them,636,9,23,2,1,1,0,36
specialist at,636,11,17,1,2,1,0,32
this one,636,11,14,1,0,1,0,27
people on,636,10,13,0,2,0,0,25
18 /,635,42,20,16,4,4,0,86
really just,635,16,27,8,3,6,0,60
bs in,635,25,24,3,1,2,0,55
need is,635,8,10,1,1,3,1,24
you take,635,8,11,1,0,2,0,22
of georgia,635,9,10,0,1,0,0,20
it can,635,6,7,4,1,1,1,20
always been,635,6,12,1,0,0,0,19
fan from,635,7,3,0,3,0,0,13
bears fan,635,8,4,0,0,0,0,12
believer husband,635,1,0,0,0,0,0,1
head baseball,635,0,0,0,0,0,0,0
supporting the,634,7,4,0,0,0,0,11
word of,634,1,5,2,1,0,0,9
sport athlete,634,2,0,0,0,0,0,2
sometimes nsfw,633,103,74,33,21,25,10,266
freelance artist,633,37,78,22,16,20,1,174
singer and,633,13,23,1,2,2,0,41
before it,633,15,21,1,2,0,0,39
no kids,633,7,10,2,1,1,0,21
hope for,633,7,10,1,1,0,0,19
travel the,633,7,7,0,0,0,1,15
n d,633,1,9,1,1,2,0,14
with new,633,8,4,0,1,0,0,13
brought to,633,4,3,3,0,2,0,12
keeper of,632,19,44,8,4,1,3,79
uc berkeley,632,23,40,1,1,2,0,67
m v,632,5,8,2,1,2,0,18
the florida,632,3,7,1,0,0,0,11
the box,632,3,6,0,0,1,1,11
cat and,631,27,62,7,5,6,1,108
don’t mind,631,9,16,6,0,2,0,33
learning about,631,12,15,3,0,0,0,30
education for,631,2,9,0,0,0,0,11
and savior,631,2,5,0,0,3,0,10
a follower,631,5,3,0,0,0,0,8
your last,631,4,2,0,0,0,0,6
is very,630,13,15,2,2,2,1,35
and pro,630,25,5,1,0,3,0,34
engineering and,630,14,6,1,1,2,0,24
for better,630,8,13,2,0,0,0,23
today is,630,3,9,0,1,0,0,13
link https,630,4,6,0,1,0,0,11
level of,630,4,3,2,0,0,0,9
by god,630,3,2,1,0,1,0,7
to educate,630,0,4,0,1,0,0,5
our team,630,1,1,0,0,0,0,2
located at,630,0,0,0,0,0,0,0
wife dog,629,1,70,0,0,0,0,71
forever a,629,15,34,2,1,2,1,55
and policy,629,14,30,0,0,0,0,44
provide a,629,1,1,1,0,0,0,3
information on,629,1,2,0,0,0,0,3
police department,629,0,0,0,0,0,0,0
day job,628,32,39,6,4,5,0,86
and hope,628,8,5,1,1,1,0,16
starting over,628,3,7,0,0,2,0,12
experience and,628,4,5,1,0,2,0,12
not perfect,628,3,5,0,2,1,0,11
by faith,628,3,2,1,0,1,0,7
vida es,628,2,1,1,0,1,0,5
on main,627,77,51,25,12,24,2,191
plant based,627,14,27,2,1,7,0,51
the rain,627,7,32,3,0,1,0,43
dabble in,627,20,16,3,0,3,0,42
metal head,627,20,14,3,2,0,1,40
that it,627,11,12,1,2,0,0,26
red wings,627,5,8,0,1,2,1,17
secret account,627,5,10,0,0,1,0,16
bringing the,627,1,5,0,1,0,0,7
work is,626,13,9,7,2,2,0,33
mom who,626,1,29,1,0,1,0,32
unless i,626,8,11,4,2,0,3,28
it just,626,9,12,2,0,3,0,26
every week,626,7,12,1,1,0,0,21
i started,626,5,9,0,1,3,0,18
guy looking,626,8,0,0,1,0,0,9
a veteran,626,2,5,0,0,1,0,8
en mi,626,0,3,0,0,0,0,3
make new,625,16,11,4,0,3,0,34
may the,625,12,13,1,0,2,1,29
nothing else,625,9,8,2,3,2,1,25
and 3,625,7,7,0,0,1,1,16
all students,625,1,13,0,0,0,0,14
help the,625,8,5,0,0,0,0,13
body and,625,6,5,1,0,0,0,12
and golf,625,7,2,0,0,0,0,9
of gold,624,13,23,3,3,2,1,45
can’t be,624,9,17,4,1,3,0,34
best and,624,12,5,0,0,2,0,19
of liberty,624,5,6,0,0,0,0,11
of family,624,5,5,0,0,0,0,10
23 /,623,32,32,17,9,5,5,100
general manager,623,9,8,1,0,0,0,18
single mother,623,2,15,0,0,0,0,17
dm on,623,1,3,1,1,0,0,6
your family,623,1,2,2,0,0,0,5
nft project,623,0,3,0,0,0,0,3
mostly about,622,26,44,2,0,4,1,77
/ artist,622,23,27,7,4,8,2,71
works in,622,28,24,3,3,2,2,62
a hobby,622,20,19,2,1,4,1,47
or be,622,8,12,1,3,2,1,27
- and,622,7,11,5,0,0,0,23
you from,622,4,8,1,0,1,1,15
what u,622,2,7,2,0,2,0,13
works to,622,1,2,0,0,0,0,3
and die,621,5,11,3,1,2,1,23
data analytics,621,8,14,0,0,0,0,22
s m,621,10,10,0,0,0,0,20
an ordinary,621,9,6,1,1,1,0,18
v e,621,2,10,1,1,1,0,15
a daily,620,5,10,1,0,0,0,16
traveler and,620,7,6,0,0,1,0,14
a lifestyle,620,2,1,1,1,0,0,5
coach /,620,1,2,0,0,0,0,3
//music apple,620,2,0,0,0,0,0,2
iced coffee,619,28,82,8,0,3,0,121
doctor who,619,54,45,3,4,5,0,111
currently a,619,24,20,4,3,2,0,53
soccer fan,619,21,12,0,2,0,1,36
sea of,619,13,17,0,0,1,1,32
story ideas,619,8,13,1,0,1,0,23
is you,619,3,18,1,1,0,0,23
be done,619,2,6,1,2,0,0,11
facebook http,619,0,3,0,0,0,0,3
crypto currency,619,1,0,0,0,0,0,1
gay man,618,43,0,2,2,0,2,49
i cannot,618,13,18,3,0,1,0,35
your typical,618,12,16,0,3,2,0,33
how the,618,6,14,1,0,3,0,24
we got,618,6,9,3,0,1,0,19
n g,618,2,5,3,0,2,0,12
the media,618,3,4,1,1,0,0,9
on itunes,618,3,4,0,0,0,0,7
tweet a,617,23,35,4,0,7,0,69
all out,617,14,17,2,0,2,0,35
start a,617,9,15,2,1,0,0,27
know why,617,4,15,3,2,0,0,24
happy wife,617,0,21,0,0,0,0,21
buyers and,617,2,1,1,0,1,0,5
for promo,617,3,1,0,0,0,0,4
lash tech,617,0,3,0,0,0,0,3
actor singer,616,43,45,6,7,4,0,105
person with,616,12,19,9,4,4,0,48
following me,616,14,9,1,2,0,0,26
follow to,616,7,4,1,0,2,0,14
explore the,616,5,1,2,0,0,0,8
business consultant,616,1,4,1,0,0,0,6
christ and,616,0,4,0,0,0,0,4
individuals and,616,1,2,0,0,0,0,3
and environmental,615,14,25,3,2,0,0,44
the desert,615,12,15,1,3,4,0,35
don't ask,615,14,10,3,3,0,1,31
no to,615,10,17,0,0,2,0,29
dream is,615,8,15,1,0,2,0,26
model and,615,7,11,3,1,1,1,24
thing to,615,14,6,0,1,0,1,22
trust me,615,8,10,1,1,1,0,21
soccer player,615,4,12,0,0,1,0,17
be treated,615,5,8,0,1,1,0,15
representing the,615,7,4,1,1,0,0,13
society of,615,2,6,0,0,1,0,9
tune in,615,4,2,0,0,0,0,6
state champ,615,2,0,0,0,0,0,2
since 2015,614,8,32,3,1,6,0,50
the main,614,17,6,5,4,3,0,35
storm chaser,614,16,8,0,2,2,1,29
was in,614,9,17,2,0,1,0,29
got suspended,614,5,7,2,1,0,0,15
of arkansas,614,6,5,1,0,0,0,12
a vision,614,3,2,1,1,0,1,8
a republican,614,4,2,1,0,0,0,7
research scientist,613,38,24,1,1,1,0,65
i collect,613,17,27,5,1,1,0,51
of work,613,9,16,2,0,1,0,28
ambassador for,613,12,8,1,0,1,0,22
government and,613,8,5,0,1,0,0,14
speak my,613,6,7,1,0,0,0,14
of southern,613,8,3,0,0,2,0,13
the college,613,6,6,0,0,0,0,12
combat vet,613,9,2,1,0,0,0,12
be sure,613,4,3,0,0,0,0,7
and retired,613,3,3,0,0,0,0,6
and getting,612,9,16,0,2,3,0,30
this for,612,5,14,2,1,3,0,25
from texas,612,11,4,2,1,3,0,21
of high,612,11,6,0,0,3,0,20
an adult,611,22,38,16,2,3,1,82
person that,611,21,8,4,3,1,3,40
earth and,611,8,15,1,0,1,0,25
the pain,611,9,11,1,1,2,0,24
he was,611,16,7,0,0,1,0,24
m d,611,13,9,0,0,0,0,22
voted for,611,4,12,1,0,0,0,17
loves you,611,7,6,1,2,0,0,16
young and,611,4,8,0,0,2,0,14
mom teacher,610,0,48,1,0,0,0,49
yes i’m,610,12,18,7,0,7,0,44
soccer and,610,25,14,0,0,1,0,40
if it’s,610,12,14,1,1,3,0,31
me please,610,6,11,1,1,4,1,24
ceo and,610,8,2,0,0,1,0,11
who makes,609,26,20,5,6,1,1,59
and try,609,21,10,1,3,1,1,37
there’s no,609,11,18,5,1,2,0,37
content 18,609,14,9,5,3,1,2,34
over a,609,7,14,1,0,0,0,22
t s,609,7,7,1,1,1,0,17
they want,609,5,5,1,3,1,0,15
lives and,609,5,5,1,0,0,0,11
trader and,609,2,0,0,0,0,0,2
around and,608,11,17,2,5,1,0,36
girl that,608,0,24,0,0,3,0,27
morgan stanley,608,0,0,0,0,0,0,0
writer -,607,27,33,3,1,7,1,72
beer enthusiast,607,33,14,0,0,0,0,47
anyone else,607,22,18,4,0,2,0,46
about that,607,16,14,3,2,3,1,39
in high,607,20,13,0,3,2,0,38
why are,607,21,10,2,1,0,0,34
you here,607,14,14,0,1,2,1,32
of 2020,607,13,12,1,0,1,1,28
i'm all,607,15,11,1,0,0,0,27
it so,607,9,9,0,3,3,0,24
fan living,607,14,8,0,1,0,0,23
the flow,607,6,11,3,0,1,0,21
that shit,607,2,13,3,0,2,0,20
america is,607,6,5,1,2,1,0,15
a mess,606,21,57,7,2,7,1,95
a video,606,22,11,5,4,1,3,46
just as,606,8,15,4,2,0,0,29
change my,606,11,10,3,1,3,1,29
news for,606,7,3,1,0,0,0,11
police officer,606,1,3,0,0,0,0,4
the dallas,606,4,0,0,0,0,0,4
personal opinions,605,25,26,1,0,0,0,52
cool stuff,605,26,13,1,4,2,2,48
of minnesota,605,8,15,0,0,2,0,25
will ever,605,5,14,2,0,0,1,22
browns fan,605,6,4,0,0,0,0,10
blm resist,604,18,46,1,1,0,0,66
whatever else,604,24,25,3,1,1,0,54
friends with,604,13,17,3,2,2,0,37
disabled veteran,604,7,12,1,0,1,0,21
am and,604,8,7,2,1,1,0,19
grow your,604,1,0,0,0,0,0,1
https //music,604,1,0,0,0,0,0,1
and amateur,603,29,26,7,3,2,0,67
all a,603,9,15,1,2,1,0,28
why you,603,5,12,1,0,2,0,20
proud owner,602,20,10,3,3,4,0,40
and student,602,15,12,0,0,1,0,28
me when,602,7,13,1,1,2,0,24
music food,602,12,10,0,0,1,0,23
this year,602,6,10,0,1,0,1,18
d e,602,5,9,1,1,2,0,18
nerd i,601,40,39,6,5,7,0,97
love movies,601,23,13,3,1,2,0,42
and that’s,601,9,19,3,0,4,0,35
professor and,601,17,13,1,1,1,0,33
smart ass,601,12,20,1,0,0,0,33
man on,601,18,1,1,0,0,1,21
n s,601,4,3,1,0,0,0,8
growth and,601,4,4,0,0,0,0,8
women’s basketball,601,0,4,0,0,0,0,4
de coraz,601,1,0,0,1,0,0,2
wanna see,600,11,15,3,3,2,0,34
use it,600,14,9,4,2,0,0,29
it but,600,8,10,1,1,2,0,22
you give,600,4,10,0,0,1,0,15
dream in,600,5,8,0,0,0,0,13
and head,600,7,3,1,0,1,0,12
right and,600,3,7,0,0,0,0,10
of 2021,599,17,15,2,4,0,0,38
health is,599,4,14,2,2,1,0,23
not by,599,5,9,4,0,1,0,19
life that,599,6,6,1,0,0,0,13
and kids,599,4,8,0,0,0,0,12
certified personal,599,2,4,0,0,1,0,7
and star,598,42,43,3,2,5,0,95
anime video,598,48,32,7,2,2,1,92
on fire,598,15,18,2,4,3,0,42
that way,598,8,14,1,1,1,0,25
beach bum,598,5,15,0,0,0,0,20
we just,598,6,13,1,0,0,0,20
on everything,598,6,10,3,0,1,0,20
and grandfather,598,3,0,0,0,0,0,3
my fav,597,16,18,3,1,3,0,41
that's what,597,12,13,0,0,0,0,25
don’t need,597,6,17,1,0,0,0,24
animal advocate,597,1,21,0,0,1,0,23
vietnam vet,597,2,0,0,0,0,0,2
global health,596,15,44,0,1,0,1,61
left of,596,24,16,1,2,1,1,45
but love,596,9,16,2,1,2,0,30
the social,596,7,14,1,1,2,0,25
4 years,596,7,5,0,0,1,0,13
democracy and,596,3,7,0,0,0,0,10
read a,595,9,45,6,1,3,1,65
and listen,595,12,14,0,1,4,0,31
since 2013,595,7,15,2,1,1,1,27
saints fan,595,3,5,0,0,0,1,9
25 year,594,22,17,8,0,4,3,54
democratic party,594,11,7,0,0,1,0,19
it if,594,12,2,1,0,1,0,16
designer of,593,37,21,2,3,1,0,64
just call,593,15,20,7,1,5,4,52
our customers,593,1,0,0,0,0,0,1
all conference,593,0,0,0,0,0,0,0
blacklivesmatter stopasianhate,592,93,72,7,6,13,0,191
a plan,592,9,5,2,0,2,0,18
fighting to,592,5,11,2,0,0,0,18
only live,592,2,7,0,0,0,0,9
3d printing,591,52,10,6,3,4,0,75
favorite things,591,9,20,2,1,2,0,34
big heart,591,9,18,4,0,2,0,33
people will,591,15,9,1,0,1,0,26
everyone has,591,3,6,0,1,1,0,11
all glory,591,2,0,0,0,0,0,2
6 gpa,591,0,0,0,0,0,0,0
or dm,590,22,16,6,5,4,0,53
lifelong democrat,590,3,16,0,0,0,0,19
woman with,590,0,14,1,0,1,1,17
for small,590,5,7,1,0,0,0,13
love peace,590,3,7,0,0,1,1,12
reach their,590,0,1,0,0,0,0,1
assistant prof,589,39,87,0,0,1,0,127
on yt,589,19,10,3,0,1,0,33
enemy of,589,13,6,2,0,1,0,22
here you,589,7,9,3,1,1,0,21
using the,589,8,8,2,1,0,0,19
the spirit,589,6,5,1,1,2,0,15
critical thinker,589,6,6,0,1,0,0,13
are looking,589,3,3,1,0,0,0,7
i luv,588,7,17,6,0,4,0,34
my hero,588,14,13,2,1,2,0,32
real world,588,8,7,1,0,2,0,18
o r,588,3,7,4,0,0,0,14
wife mommy,588,0,12,0,0,0,0,12
daily news,588,3,3,0,1,1,0,8
peace of,588,2,4,1,0,0,0,7
s de,588,0,1,0,0,0,0,1
and streamer,587,27,15,3,5,2,3,55
i grow,587,10,31,4,0,6,0,51
beer drinker,587,17,19,1,0,1,0,38
political activist,587,13,11,3,1,0,3,31
hey guys,587,8,8,3,1,0,0,20
spread the,587,6,6,2,0,2,0,16
life’s a,587,5,6,1,0,3,0,15
team in,587,5,1,1,0,0,0,7
me ig,587,1,4,0,0,0,0,5
jesus my,587,0,3,1,0,0,0,4
and around,587,2,0,0,1,1,0,4
a movement,587,1,0,0,0,0,0,1
account -,586,28,35,3,3,1,3,73
//www patreon,586,24,21,7,2,1,0,55
lover -,586,22,19,0,3,3,0,47
kindness and,586,9,31,0,1,2,1,44
time of,586,11,13,1,0,3,0,28
manager -,586,15,9,0,0,0,0,24
i lost,586,10,9,1,1,0,0,21
days a,586,9,7,1,1,0,0,18
mother sister,586,0,10,0,0,0,0,10
amante del,586,1,0,0,0,0,0,1
christian father,586,1,0,0,0,0,0,1
do stuff,585,30,17,6,2,5,0,60
particular order,585,15,22,2,0,1,1,41
i ever,585,8,15,2,2,2,0,29
one tweet,585,10,10,0,2,0,1,23
more http,585,7,8,0,1,1,0,17
podcast hosted,585,4,5,0,0,0,0,9
great state,585,3,1,1,0,0,0,5
the texas,585,3,2,0,0,0,0,5
gamer nerd,584,47,34,5,4,3,0,93
all just,584,20,18,3,1,1,0,43
these tweets,584,23,18,1,0,1,0,43
the fire,584,9,14,2,0,1,0,26
woman and,584,4,17,0,0,1,0,22
http //linkedin,584,10,3,0,1,2,0,16
stop by,584,3,5,2,0,1,2,13
physical education,584,2,0,0,0,0,0,2
web dev,583,53,30,4,4,4,0,95
don’t make,583,5,12,2,0,4,0,23
are and,583,7,6,0,0,1,0,14
click on,583,2,5,1,0,0,1,9
fan de,583,0,5,0,0,0,0,5
com is,583,0,3,0,0,0,0,3
going through,582,12,21,4,4,3,0,44
this site,582,10,5,2,1,0,0,18
xbox gt,582,10,2,0,0,0,0,12
just follow,582,5,4,1,1,0,0,11
hope and,582,2,3,0,0,1,0,6
programs and,582,3,2,0,0,0,0,5
eat the,581,40,58,18,7,12,2,137
me https,581,7,12,5,0,2,0,26
and instagram,581,9,8,7,0,0,0,24
when you're,581,10,11,0,2,0,0,23
an adventure,581,7,9,0,2,0,0,18
own business,581,8,6,1,2,0,0,17
and want,581,9,7,0,0,0,0,16
former republican,581,5,8,0,0,1,0,14
marketing consultant,581,3,9,0,0,1,0,13
rip dad,581,1,6,0,0,0,0,7
and analysis,581,1,1,0,0,1,1,4
battle rap,581,1,1,0,0,0,0,2
my clients,581,1,0,0,0,0,0,1
games music,580,43,26,5,3,6,1,84
wars fan,580,42,22,1,1,0,0,66
person you,580,6,11,4,1,4,0,26
podcast http,580,16,8,0,0,0,0,24
your opinion,580,9,9,2,1,0,0,21
opinion and,580,9,8,1,1,1,0,20
in for,580,9,4,2,1,0,0,16
the local,580,3,9,1,0,0,0,13
retired educator,580,1,6,0,0,0,0,7
livin life,580,1,5,0,0,0,0,6
through education,580,0,1,0,0,1,0,2
are good,579,19,18,2,2,4,2,47
like your,579,12,17,3,3,0,0,35
works for,579,13,9,3,2,3,0,30
day of,579,5,13,0,0,2,0,20
of war,579,9,6,1,0,0,0,16
and international,579,6,6,0,1,0,0,13
cardinals fan,579,2,9,0,0,1,0,12
and training,579,3,1,1,1,0,0,6
an asshole,578,17,19,5,2,4,0,47
cool guy,578,27,1,1,1,0,2,32
would have,578,8,12,0,1,2,0,23
weather and,578,11,5,0,4,0,0,20
http //tiktok,578,8,7,1,1,2,0,19
little girl,578,1,13,1,0,0,1,16
have 3,578,3,4,2,0,0,0,9
development of,578,5,1,0,1,0,0,7
is located,578,0,1,0,0,0,0,1
not of,577,18,15,4,0,1,0,38
on some,577,16,10,2,1,1,2,32
at an,577,13,3,0,1,3,0,20
in denver,577,7,4,1,1,1,0,14
your way,577,2,8,0,1,1,0,12
agent in,577,0,3,1,0,0,0,4
opinions here,576,31,33,3,3,2,0,72
i'm pretty,576,27,25,4,2,0,1,59
this time,576,10,16,1,1,2,1,31
the weather,576,8,15,3,1,1,0,28
makes the,576,9,12,3,2,1,0,27
city and,576,8,12,0,0,0,0,20
women of,576,2,8,0,2,1,0,13
with 3,576,3,5,1,0,1,0,10
track coach,576,3,1,0,0,0,0,4
young people,575,3,19,1,0,0,0,23
that’s it,575,4,13,2,1,2,0,22
software development,574,27,5,1,1,1,0,35
8th grade,574,5,18,0,0,1,0,24
i buy,574,7,7,2,2,1,0,19
to please,574,4,7,3,1,0,1,16
rule of,574,8,7,0,0,0,0,15
a veces,574,4,8,0,0,0,1,13
of miami,574,5,5,0,1,0,0,11
grinding for,574,3,1,0,0,0,0,4
sports in,574,3,0,0,0,1,0,4
support me,573,33,26,12,3,3,3,80
gamer -,573,39,14,4,2,6,0,65
by any,573,7,9,3,1,1,0,21
science technology,573,7,9,0,0,0,0,16
who like,573,7,5,1,1,1,0,15
institute for,573,7,7,0,0,0,0,14
get up,573,6,7,0,0,1,0,14
knicks fan,573,11,1,0,0,0,0,12
university alumnus,573,10,0,0,1,0,0,11
jesus lover,573,3,6,0,0,0,0,9
pittsburgh steelers,573,2,1,0,0,0,0,3
indie game,572,67,18,6,5,4,1,101
the dead,572,11,20,6,4,3,0,44
needs a,572,13,23,2,2,1,0,41
for other,572,12,14,4,2,2,0,34
what's up,572,13,9,1,1,1,1,26
big booty,572,5,8,1,0,2,1,17
leadership and,572,8,7,0,0,0,0,15
always down,571,24,12,4,2,0,0,42
and economic,571,8,6,1,0,2,0,17
leader and,571,3,5,1,1,1,0,11
analysis and,571,6,2,0,0,1,0,9
3 and,571,2,5,0,0,1,0,8
biz owner,570,7,22,0,1,1,0,31
outside of,570,8,6,0,1,2,0,17
long learner,570,4,9,0,0,1,0,14
in silence,570,2,9,0,1,0,0,12
news updates,570,0,4,0,0,0,0,4
artist with,569,14,34,18,6,7,1,80
games are,569,34,14,1,3,5,0,57
boy who,569,26,3,1,4,0,0,34
interior designer,569,6,10,2,0,1,0,19
let’s have,569,10,2,2,1,1,0,16
county public,569,2,5,0,0,0,0,7
recruiting coordinator,569,2,2,0,0,0,0,4
if i'm,568,18,20,4,4,3,0,49
check the,568,11,15,0,3,2,0,31
en espa,568,6,7,2,0,0,0,15
something you,568,2,6,0,1,0,0,9
news on,568,5,2,0,1,0,0,8
humble and,568,2,2,0,0,0,0,4
dolphins fan,568,1,1,0,0,0,0,2
and space,567,17,17,4,1,1,0,40
of living,567,11,9,0,1,1,1,23
not only,567,5,8,2,1,2,0,18
news sports,567,3,0,0,0,0,0,3
of anime,566,34,24,7,2,4,1,72
co-author of,566,18,20,0,0,1,0,39
as of,566,9,18,2,1,1,0,31
of anything,566,7,14,3,1,1,0,26
plus size,565,6,38,5,1,5,0,55
block you,565,20,21,0,3,1,0,45
i'm your,565,13,14,3,4,2,1,37
to no,565,17,16,2,1,1,0,37
and old,565,15,13,0,2,2,1,33
youtube content,565,17,2,2,0,0,0,21
in mind,565,5,6,2,0,2,0,15
i gotta,565,3,6,3,0,0,0,12
ceo founder,565,1,7,0,0,0,0,8
m university,565,3,3,2,0,0,0,8
patriot and,565,1,1,0,0,0,0,2
manufacturer of,565,1,0,1,0,0,0,2
represented by,564,25,57,2,1,3,0,88
no particular,564,16,22,2,0,1,2,43
til i,564,11,22,1,1,1,0,36
my day,564,11,21,1,1,1,0,35
alot of,564,15,9,2,2,1,1,30
miami fl,564,1,4,0,0,0,1,6
who dat,564,1,3,0,1,0,0,5
justice advocate,563,13,58,0,0,1,0,72
all sorts,563,22,14,4,1,3,2,46
we’re all,563,12,24,4,2,3,0,45
former teacher,563,5,33,0,1,0,0,39
pack go,563,6,7,0,0,0,0,13
over 40,563,3,5,1,0,0,0,9
and caring,563,1,3,1,0,0,0,5
apple pay,563,1,1,0,0,0,0,2
locally owned,563,0,0,0,0,0,0,0
property management,563,0,0,0,0,0,0,0
affiliate streamer,562,19,12,5,4,4,1,45
fan lover,562,10,17,2,0,1,0,30
playing the,562,8,11,1,0,2,0,22
17 years,562,11,6,1,1,1,2,22
wife sister,562,0,20,0,0,1,0,21
that enjoys,562,10,6,3,2,0,0,21
aim to,562,5,4,0,3,1,0,13
of its,562,4,4,1,0,1,0,10
the leader,562,2,2,0,0,1,0,5
player development,562,0,0,0,0,0,0,0
also do,561,21,13,2,5,4,0,45
my links,561,11,16,7,3,6,1,44
since 2012,561,10,18,1,1,1,0,31
number 1,561,11,13,2,0,3,0,29
don’t do,561,3,11,2,0,2,0,18
video production,561,7,5,1,0,0,0,13
kids i,561,2,8,3,0,0,0,13
great things,561,3,2,0,0,2,0,7
my dm,561,2,3,0,0,1,0,6
theme park,560,54,27,4,3,4,0,92
games movies,560,46,13,1,0,3,0,63
in human,560,11,23,7,1,4,1,47
of virginia,560,5,6,0,0,0,0,11
send a,560,5,2,3,1,0,0,11
get rich,560,0,2,0,1,0,0,3
horror fan,559,58,42,9,4,3,1,117
stay for,559,29,41,4,2,2,1,79
for custom,559,8,21,5,4,4,1,43
cares about,559,12,22,4,1,1,0,40
and drink,559,12,20,2,0,0,2,36
the boys,559,10,21,3,1,0,0,35
m m,558,12,9,0,2,1,0,24
since 2010,558,5,13,0,2,1,0,21
they do,558,5,12,4,0,0,0,21
food wine,558,6,14,0,0,0,0,20
your story,558,3,9,0,1,0,0,13
and when,558,1,7,0,0,3,0,11
of central,558,3,5,0,0,0,0,8
live stream,558,3,1,0,1,0,0,5
and sellers,558,1,1,0,0,0,0,2
a fat,557,10,16,6,4,6,1,43
you ask,557,15,9,6,0,3,1,34
fighting the,557,14,16,2,0,1,1,34
well i,557,9,16,3,1,2,0,31
husband dog,557,28,0,0,1,0,0,29
thing in,557,4,6,1,0,1,0,12
ran by,557,4,5,3,0,0,0,12
best version,557,3,6,0,1,1,0,11
conservative republican,557,0,1,0,0,0,0,1
and views,556,17,24,2,1,1,0,45
https //tinyurl,556,13,17,3,0,2,1,36
porn and,556,18,9,5,2,1,0,35
it would,556,7,17,1,1,1,1,28
a dreamer,556,6,16,2,0,2,0,26
you cannot,556,7,11,1,2,0,0,21
put my,556,8,7,1,3,1,0,20
- father,556,10,0,0,0,0,1,11
what can,556,3,5,0,0,1,0,9
money is,556,3,3,0,0,0,0,6
care to,556,2,2,0,1,0,0,5
por el,556,0,1,0,1,1,1,4
ny yankees,556,1,2,0,0,0,0,3
23 -,555,73,48,20,13,14,4,172
creative writing,555,30,55,6,5,5,2,103
not good,555,28,19,5,1,2,1,56
to vote,555,16,32,0,0,0,0,48
of engineering,555,30,9,0,0,1,1,41
and growing,555,9,10,0,0,0,0,19
i l,555,1,3,4,1,0,0,9
world we,555,4,2,0,0,1,0,7
fashion beauty,555,2,3,0,0,1,0,6
a daughter,555,0,2,0,0,0,0,2
software engineering,554,42,19,2,0,1,0,64
i must,554,11,14,2,1,2,0,30
two great,554,4,6,0,0,0,0,10
18 please,553,36,41,24,12,14,6,133
johns hopkins,553,10,11,0,1,3,1,26
have nothing,553,8,10,5,1,2,0,26
you won't,553,8,11,0,2,2,0,23
of yourself,553,5,11,1,1,0,1,19
my feet,553,4,7,2,0,1,0,14
kc chiefs,553,3,6,0,0,0,0,9
they need,553,2,2,0,0,0,0,4
grandfather of,553,1,1,0,0,0,0,2
trans girl,552,1,170,1,0,44,8,224
working class,552,29,22,2,7,2,0,62
let's make,552,15,15,2,1,0,0,33
sex and,552,8,16,2,2,1,1,30
creator i,552,16,6,1,3,3,1,30
made for,552,5,8,2,3,1,0,19
member and,552,9,6,1,1,1,0,18
2 5,552,3,6,1,1,2,0,13
in arizona,552,3,2,0,1,0,0,6
weight loss,552,2,4,0,0,0,0,6
books music,551,13,31,3,2,1,1,51
content producer,551,19,20,2,0,2,0,43
i'm very,551,16,11,4,3,0,0,34
//tiktok com/,551,8,6,1,1,2,0,18
independent voter,551,3,3,0,0,0,0,6
a minor,550,45,32,13,11,10,4,115
disc golf,550,18,6,0,0,0,0,24
i been,550,0,4,0,0,2,0,6
inbox me,550,0,0,0,0,0,0,0
i saw,549,5,26,1,2,4,0,38
if interested,549,10,12,3,0,5,0,30
of hope,549,4,9,1,2,3,1,20
positive and,549,8,8,0,2,2,0,20
artist ig,549,3,10,2,0,3,0,18
mind of,549,6,9,2,0,0,0,17
we bring,549,0,0,0,0,0,0,0
you’ll ever,548,15,22,1,1,4,0,43
tips to,548,8,21,0,1,1,0,31
brooklyn ny,548,9,6,2,1,0,0,18
n t,548,4,7,1,0,1,0,13
loving father,548,11,0,0,1,0,0,12
tryin to,548,3,7,2,0,0,0,12
protect your,548,1,7,1,0,0,0,9
proud conservative,548,0,0,0,0,0,0,0
llc is,548,0,0,0,0,0,0,0
should have,547,15,18,1,1,0,0,35
a shit,547,10,14,4,2,1,0,31
is fun,547,13,6,2,3,3,0,27
it makes,547,8,6,3,0,0,1,18
to kill,547,7,7,3,1,0,0,18
strive for,547,7,5,0,0,0,0,12
york yankees,547,6,0,0,0,0,0,6
god husband,547,1,0,0,0,0,0,1
unblock fee,546,7,25,10,4,10,1,57
i’d rather,546,8,21,1,0,0,0,30
you'll never,546,10,6,2,2,0,0,20
food travel,546,8,9,0,0,0,1,18
a vibe,546,6,7,0,1,2,0,16
jiu jitsu,546,4,4,0,0,0,0,8
sports card,546,1,0,0,0,0,0,1
writer musician,545,41,23,7,2,2,0,75
stuff for,545,34,19,3,2,2,2,62
links below,545,7,25,4,2,6,0,44
spirit animal,545,18,18,1,0,3,0,40
what if,545,7,21,3,1,4,0,36
the age,545,7,12,1,1,2,0,23
that works,545,10,5,3,2,1,0,21
guns and,545,6,7,2,0,0,1,16
sports i,545,8,6,0,0,1,0,15
down below,545,2,3,3,1,3,0,12
health fitness,545,2,5,0,0,0,0,7
mean i,544,11,10,3,0,1,0,25
and it’s,544,9,12,2,0,2,0,25
no way,544,13,6,2,0,1,1,23
go for,544,5,7,0,4,0,0,16
of excellence,544,1,5,0,0,0,0,6
improving the,544,1,1,0,0,0,0,2
god we,544,0,1,0,0,0,0,1
patriot maga,544,0,1,0,0,0,0,1
or any,543,14,11,15,3,0,1,44
act like,543,10,14,3,2,1,0,30
since 2008,543,8,17,1,0,2,0,28
love food,543,5,10,1,0,2,0,18
4th grade,543,0,15,0,2,0,0,17
of 22,543,7,6,1,0,0,0,14
spirit of,543,5,4,1,1,0,0,11
to increase,543,4,4,0,0,0,0,8
meet the,543,1,5,1,0,0,0,7
the 1st,543,2,4,1,0,0,0,7
happens for,543,2,5,0,0,0,0,7
with and,543,2,2,0,1,0,0,5
simple and,543,0,0,0,0,0,0,0
24 /,542,16,25,12,3,12,2,70
their best,542,7,15,12,3,8,1,46
best friends,542,8,16,1,2,3,2,32
be shy,542,11,7,3,0,1,1,23
critical thinking,542,6,11,0,1,1,0,19
i'm looking,542,3,2,2,0,0,0,7
n c,542,1,4,0,0,1,1,7
by our,542,2,3,0,0,1,0,6
also make,541,30,21,5,3,5,2,66
tweet for,541,13,35,6,2,9,1,66
you probably,541,24,14,4,2,1,0,45
state representative,541,14,21,0,0,0,0,35
remember to,541,10,15,5,0,3,0,33
can also,541,11,13,2,2,1,2,31
in charge,541,14,12,0,1,0,0,27
past president,541,7,15,0,0,0,0,22
all have,541,7,9,2,1,1,0,20
the secret,541,8,7,0,1,1,0,17
es un,541,2,3,0,0,0,0,5
stay true,541,2,2,1,0,0,0,5
the stock,541,1,1,1,0,0,0,3
for crypto,541,0,0,0,0,0,0,0
in time,540,11,13,2,1,2,0,29
of wine,540,6,20,0,0,0,0,26
a wild,540,7,10,2,0,0,0,19
a city,540,8,8,0,0,1,0,17
loyal and,540,1,3,1,0,0,0,5
4 6,540,0,0,0,0,1,0,1
to add,539,14,10,1,2,2,0,29
lack of,539,11,8,2,1,2,0,24
because we,539,11,5,1,1,0,0,18
be real,539,3,12,0,0,1,1,17
to express,539,6,5,2,1,2,1,17
channel http,539,8,6,0,2,1,0,17
r m,539,1,12,0,0,1,0,14
for art,538,34,25,11,6,7,2,85
21 /,538,20,18,11,7,12,1,69
watch anime,538,26,17,3,2,1,0,49
there will,538,23,14,1,1,0,1,40
search for,538,7,7,2,1,1,0,18
professional photographer,538,5,4,2,1,0,0,12
passion and,538,5,4,0,0,0,0,9
no soy,538,3,4,0,0,0,0,7
at our,538,1,5,0,1,0,0,7
the nfl,538,1,2,0,0,0,0,3
bad jokes,537,53,36,4,4,2,2,101
at twitter,537,39,47,4,3,4,0,97
artist //,537,20,42,16,7,8,1,94
dm's open,537,47,19,6,11,5,1,89
world that,537,2,9,1,1,0,0,13
o t,537,4,6,1,1,1,0,13
following the,537,1,7,1,1,1,0,11
football fanatic,537,3,3,0,0,0,0,6
all our,537,3,0,0,1,0,0,4
smash ultimate,536,74,8,4,9,0,1,96
and tweets,536,22,22,3,2,0,0,49
not those,536,20,25,2,0,1,0,48
tolerance for,536,8,20,1,0,0,0,29
do nothing,536,6,9,2,0,1,0,18
my community,536,5,7,1,0,1,0,14
a believer,536,4,1,0,0,0,0,5
streamer i,535,24,13,8,1,8,0,54
god of,535,24,8,3,0,3,0,38
21 year,535,17,12,1,3,2,0,35
at you,535,16,7,2,2,3,0,30
more time,535,8,12,1,1,0,0,22
married mother,535,0,11,0,0,0,0,11
philadelphia eagles,535,5,1,0,0,0,0,6
basically a,534,7,40,3,4,9,1,64
get through,534,16,16,6,0,3,0,41
we should,534,11,8,1,0,0,0,20
3 years,534,6,9,3,0,0,0,18
an opinion,534,6,8,1,2,0,0,17
an nft,534,10,1,2,0,0,0,13
do some,533,22,14,5,3,4,0,48
looks like,533,23,16,2,0,1,2,44
of staff,533,11,18,1,0,2,0,32
school board,533,13,16,0,0,0,0,29
should not,533,13,12,0,1,0,1,27
it we,533,6,9,1,1,0,0,17
regardless of,533,6,6,0,0,1,0,13
give us,533,3,6,0,0,1,0,10
do me,533,2,2,1,0,2,0,7
but sometimes,532,17,38,7,3,3,2,70
solely my,532,27,23,3,0,0,0,53
or two,532,10,14,2,2,0,0,28
the death,532,10,14,1,0,0,0,25
go with,532,5,11,2,1,2,0,21
the high,532,9,8,1,1,2,0,21
of men,532,9,7,0,0,1,0,17
when life,532,2,10,1,0,2,0,15
aspects of,532,6,4,1,0,0,0,11
huge sports,532,1,2,0,0,0,0,3
residential and,532,1,0,0,0,0,0,1
p e,531,7,5,1,0,0,0,13
life by,531,1,6,1,1,2,0,11
are our,531,3,3,2,0,0,0,8
to gain,531,4,3,0,0,1,0,8
sports guy,531,7,0,0,0,0,0,7
superintendent of,531,0,2,0,0,0,0,2
stray kids,530,9,59,3,1,6,0,78
boomer sooner,530,2,5,1,0,0,0,8
a really,529,22,29,3,0,3,0,57
streamer twitch,529,20,25,3,2,4,2,56
than me,529,19,20,3,3,2,0,47
political scientist,529,17,19,2,2,1,0,41
voice over,529,17,8,2,2,1,1,31
dean of,529,11,20,0,0,0,0,31
whole life,529,9,8,0,0,4,0,21
you read,529,8,4,0,0,0,2,14
your money,529,5,2,0,0,0,0,7
and stream,528,19,10,6,4,6,1,46
the science,528,17,20,0,0,0,0,37
love myself,528,5,21,2,1,2,0,31
not mine,528,11,10,1,1,2,1,26
refuse to,528,4,15,2,0,2,0,23
will you,528,6,13,1,1,1,1,23
go gators,528,3,5,0,0,0,0,8
passive income,528,0,0,0,0,0,0,0
other games,527,36,21,2,1,1,2,63
make them,527,11,14,1,1,1,0,28
im here,527,4,5,1,3,2,1,16
and with,527,6,6,1,0,1,0,14
on whatsapp,527,0,0,0,0,0,0,0
just not,526,10,15,2,0,0,2,29
i choose,526,5,10,1,0,1,0,17
our planet,526,4,12,1,0,0,0,17
who do,526,6,6,0,2,0,0,14
best for,526,1,2,1,1,1,0,6
brother and,526,3,0,1,0,1,0,5
art in,525,20,26,9,5,11,2,73
mental illness,525,2,38,7,2,6,1,56
so please,525,16,17,2,3,1,0,39
return to,525,14,15,2,1,2,0,34
there was,525,6,8,0,0,0,0,14
than to,525,4,9,0,0,0,0,13
thing called,525,1,8,2,0,0,1,12
tomorrow is,525,2,3,0,0,1,0,6
and resources,525,1,3,0,0,1,0,5
ms in,524,18,25,3,0,1,0,47
at any,524,14,15,1,3,5,1,39
ask about,524,12,11,9,3,0,0,35
you that,524,10,14,1,2,0,0,27
and innovation,524,6,4,0,0,0,0,10
to enhance,524,1,2,0,0,0,0,3
service for,524,0,1,0,0,0,0,1
i listen,523,14,17,3,3,4,0,41
weather enthusiast,523,13,5,1,1,2,0,22
have time,523,7,10,0,0,0,1,18
of free,523,7,4,0,1,0,0,12
we support,523,1,5,1,0,0,1,8
sports medicine,523,4,1,0,0,0,0,5
of success,523,0,2,0,0,0,0,2
more fun,522,11,13,3,1,1,0,29
don't make,522,9,7,2,1,0,1,20
did it,522,7,5,0,1,1,2,16
of how,522,10,5,0,0,0,0,15
education in,522,3,4,1,0,0,1,9
everyday is,522,6,2,0,0,1,0,9
eu sou,522,1,1,0,0,0,0,2
words are,521,24,27,4,2,3,0,60
in portland,521,16,11,7,1,2,0,37
they don't,521,3,12,3,0,1,0,19
human resources,521,3,4,0,0,0,0,7
freedom fighter,521,0,7,0,0,0,0,7
es el,521,0,0,0,0,0,0,0
inventor of,520,14,6,0,1,1,1,23
kids in,520,6,11,2,0,0,0,19
all and,520,9,7,0,1,0,0,17
university graduate,520,6,1,2,1,0,0,10
love helping,520,1,1,0,0,0,0,2
whole lot,519,16,29,3,3,1,1,53
of and,519,20,15,4,1,1,0,41
much i,519,11,20,3,2,3,1,40
i’m gonna,519,7,24,1,0,6,0,38
wife i,519,12,16,0,0,1,0,29
say i'm,519,12,10,2,0,4,0,28
it means,519,7,7,1,1,3,0,19
tv news,519,7,9,0,1,0,0,17
people for,519,8,6,2,1,0,0,17
the needs,519,2,2,0,1,0,0,5
scientist and,518,17,28,1,0,0,0,46
all times,518,12,8,5,2,5,1,33
for anyone,518,15,12,0,2,1,0,30
my blood,518,8,13,2,2,0,0,25
i learn,518,7,10,1,0,2,0,20
all other,518,11,5,1,2,0,0,19
y no,518,0,2,0,0,1,0,3
29 years,517,13,11,1,1,2,3,31
can go,517,9,12,1,0,2,1,25
for public,517,4,9,1,0,0,1,15
a master,517,5,7,0,0,1,0,13
native of,517,5,4,1,0,0,0,10
perfect but,517,3,5,0,1,1,0,10
for local,517,4,2,0,0,0,0,6
avid golfer,517,2,1,0,0,0,0,3
buy or,517,1,1,0,0,0,0,2
be funny,516,25,16,2,7,2,1,53
know is,516,4,20,6,1,6,0,37
/ music,516,11,9,5,2,0,0,27
interior design,516,4,10,1,0,0,0,15
no man,516,5,3,1,0,0,0,9
georgia southern,516,4,2,0,0,0,0,6
provides a,516,0,0,0,0,0,0,0
tweets do,515,31,24,5,2,1,1,64
the kids,515,8,16,5,0,0,0,29
in sarcasm,515,6,17,0,0,3,0,26
me because,515,3,6,1,0,3,0,13
in 2020,515,4,6,0,0,0,1,11
offensive coordinator,515,0,0,0,0,0,0,0
donate to,514,14,25,6,3,5,0,53
firm believer,514,10,25,1,2,2,0,40
of light,514,14,13,2,3,4,0,36
dj producer,514,6,3,2,2,1,1,15
the central,514,3,1,0,0,0,0,4
support to,514,2,2,0,0,0,0,4
republican party,514,1,2,0,0,0,0,3
or paypal,514,0,1,1,0,0,0,2
baseball alum,514,1,0,0,0,0,0,1
get by,513,13,16,3,4,3,0,39
liberal and,513,10,22,1,0,0,0,33
agree with,513,6,10,0,0,0,0,16
understand the,513,4,9,0,0,1,0,14
great outdoors,513,2,9,0,0,0,0,11
of football,513,5,1,0,0,0,0,6
over 50,513,5,0,0,0,0,0,5
sound designer,512,64,18,11,5,2,0,100
ma in,512,18,42,1,1,6,0,68
news producer,512,16,20,1,0,2,0,39
dose of,512,7,9,1,0,1,0,18
2 4,512,3,9,1,0,1,0,14
go out,512,4,7,0,1,0,1,13
college sports,512,4,7,0,0,0,0,11
- go,512,2,8,0,1,0,0,11
commitment to,512,2,4,0,0,0,0,6
love one,511,11,21,2,0,0,0,34
specialist for,511,5,25,1,0,1,0,32
instructional coach,511,7,21,0,0,0,0,28
it better,511,4,15,0,2,1,0,22
the front,511,7,7,0,2,1,0,17
change in,511,2,12,0,0,1,0,15
courage to,511,2,9,1,0,0,1,13
and beauty,511,3,3,1,0,0,0,7
i wrote,510,28,24,4,0,2,0,58
don't believe,510,9,10,4,1,0,0,24
not real,510,8,7,2,2,4,0,23
step at,510,9,12,0,0,1,1,23
is at,510,14,6,1,0,0,0,21
of pittsburgh,510,9,10,0,1,0,0,20
the sunshine,510,2,17,0,0,1,0,20
to making,510,9,3,2,1,0,0,15
think for,510,4,2,1,0,0,0,7
plant mom,509,1,109,1,0,12,0,123
photographer writer,509,14,22,7,3,1,0,47
of age,509,16,13,5,4,2,5,45
walking dead,509,7,11,1,0,1,0,20
person to,509,7,8,2,1,0,0,18
down and,509,5,7,1,1,1,0,15
years to,509,4,4,1,0,0,0,9
sports entertainment,509,2,2,0,0,0,0,4
comic artist,508,54,69,26,14,13,1,177
gamer anime,508,18,16,3,1,2,0,40
the bio,508,7,7,4,0,2,0,20
in on,508,2,9,3,1,2,1,18
analyst and,508,5,6,2,1,2,0,16
old guy,508,13,0,0,0,0,0,13
fear is,508,7,3,0,0,0,0,10
son husband,508,2,0,0,1,0,0,3
vision of,508,1,1,0,0,0,0,2
https //ko-fi,507,38,74,19,11,11,2,155
only to,507,7,9,2,1,4,0,23
normal guy,507,14,0,0,0,0,0,14
i walk,507,4,7,0,1,1,0,13
world full,507,3,6,1,1,1,0,12
that have,507,5,2,2,0,0,0,9
of chaos,506,18,29,5,4,6,3,65
equality and,506,9,22,1,0,0,0,32
in social,506,11,14,0,2,1,1,29
currently living,506,14,11,1,0,0,0,26
surrounded by,506,5,12,0,0,1,0,18
taking it,506,5,9,1,0,0,0,15
hello everyone,506,8,1,1,1,3,1,15
3 great,506,3,5,0,0,1,0,9
for promotion,506,0,0,0,0,0,0,0
of media,505,12,14,3,0,0,2,31
a piece,505,8,14,0,0,3,0,25
with life,505,6,9,1,1,2,0,19
against me,505,9,8,0,0,1,0,18
new world,505,6,7,2,1,0,0,16
kids are,505,3,6,1,0,1,0,11
no bio,505,3,3,0,1,0,0,7
are committed,505,0,0,0,0,0,0,0
keeps me,504,9,14,1,0,0,0,24
fun of,504,8,7,2,2,0,0,19
also enjoy,504,9,4,1,0,1,0,15
let you,504,5,9,1,0,0,0,15
bears and,504,4,4,1,0,0,0,9
for trump,504,2,0,0,0,0,0,2
that specializes,504,1,0,0,0,0,0,1
howard u,503,14,40,2,6,7,2,71
/ writer,503,21,18,8,3,5,0,55
an account,503,13,18,5,1,3,1,41
photographer for,503,18,14,2,1,1,0,36
whole world,503,6,10,1,0,1,0,18
a look,503,1,4,3,0,1,0,9
jesus family,503,1,1,0,0,0,0,2
figuring out,502,21,32,4,4,7,0,68
a friendly,502,21,13,4,2,4,3,47
even the,502,10,12,0,1,1,0,24
joined twitter,502,4,16,0,0,1,0,21
domestic violence,502,1,11,1,0,2,0,15
aka the,502,7,5,1,1,0,0,14
100 of,502,4,7,1,0,0,1,13
dm is,502,4,2,1,1,0,0,8
program in,502,2,3,0,0,0,0,5
teacher mom,501,0,48,0,0,0,0,48
reiki master,501,3,19,3,1,0,0,26
even though,501,8,9,1,0,3,1,22
of cincinnati,501,6,14,1,0,0,0,21
in fl,501,5,12,1,0,1,0,19
of children,501,3,11,0,0,0,0,14
over 25,501,1,3,0,1,0,0,5
country i,501,1,2,0,0,0,0,3
bitcoin and,501,1,0,0,0,0,0,1
former journalist,500,6,22,1,1,2,0,32
since 2011,500,12,12,1,0,1,0,26
made up,500,10,10,2,1,3,0,26
born with,500,6,8,0,0,2,1,17
make an,500,6,6,1,0,1,0,14
north dakota,500,3,5,0,0,0,1,9
or may,499,13,22,7,3,1,2,48
to its,499,1,9,0,1,1,0,12
but this,498,18,24,5,1,2,0,50
may or,498,12,19,7,3,1,1,43
alter ego,498,14,13,1,1,2,0,31
all forms,498,8,15,3,2,2,0,30
the storm,498,7,6,1,0,1,0,15
to what,498,6,7,0,0,0,0,13
f r,498,3,3,2,1,1,0,10
gaming news,498,6,3,0,0,0,0,9
can not,498,2,4,1,0,1,0,8
in downtown,498,1,1,1,0,0,0,3
family sports,498,0,1,0,0,0,0,1
22 -,497,45,50,16,10,10,1,132
the space,497,7,11,5,1,0,0,24
to solve,497,9,4,1,0,1,0,15
the struggle,497,5,8,0,0,0,0,13
friends family,497,4,6,0,0,1,0,11
houston texas,497,1,1,0,1,0,0,3
rooting for,496,8,27,1,0,4,0,40
pissed off,496,5,26,5,0,0,0,36
alum i,496,11,21,1,0,0,0,33
boy with,496,23,1,1,2,0,0,27
a second,496,6,13,2,0,1,0,22
medicine and,496,3,11,0,0,1,0,15
see is,496,5,6,1,0,1,1,14
strives to,496,3,2,0,0,0,0,5
art on,495,22,33,10,7,10,3,85
designer artist,495,18,35,5,2,6,0,66
com i,495,20,12,3,1,1,1,38
a nurse,495,4,15,0,0,1,0,20
and rock,495,8,11,1,0,0,0,20
of humanity,495,2,14,0,1,0,0,17
determined to,495,6,6,0,0,0,0,12
a purpose,495,3,5,1,0,2,0,11
and management,495,0,6,0,0,1,0,7
eth sol,495,2,2,0,0,0,0,4
an art,494,11,22,8,1,5,0,47
mechanical engineering,494,16,13,1,4,2,0,36
attorney and,494,10,18,0,0,1,0,29
online and,494,7,7,2,0,0,0,16
it easy,494,3,9,0,2,1,0,15
yankees and,494,8,2,0,0,0,0,10
concept artist,493,55,46,15,9,10,4,139
of horror,493,34,18,5,6,8,2,73
one else,493,10,11,1,1,2,0,25
need for,493,5,6,1,1,1,0,14
ncaa football,493,0,0,0,0,0,0,0
happily taken,492,37,19,5,4,7,3,75
music teacher,492,17,35,4,1,0,1,58
might as,492,8,18,2,1,2,0,31
in many,492,18,10,1,0,2,0,31
director producer,492,10,16,1,2,1,0,30
the food,492,11,15,0,0,2,0,28
have never,492,11,7,1,3,2,0,24
and sexy,492,6,12,1,3,1,0,23
good friends,492,8,7,2,1,0,0,18
planning and,492,6,6,0,0,1,0,13
of 23,492,2,4,2,1,0,0,9
life without,492,2,5,0,0,0,0,7
stuff that,491,20,10,0,2,1,0,33
life member,491,2,3,0,1,0,0,6
c/o 22,491,1,1,0,0,0,0,2
and software,490,25,7,1,1,1,0,35
to collab,490,15,6,6,2,4,0,33
get lost,490,6,10,4,4,3,0,27
when you’re,490,3,19,1,1,2,0,26
http //goo,490,9,6,1,0,0,0,16
say no,490,4,12,0,0,0,0,16
line of,490,4,10,1,0,0,0,15
of commerce,490,2,0,0,0,0,0,2
and cute,489,29,59,13,5,6,1,113
fascinated by,489,12,19,2,0,1,0,34
especially the,489,13,11,3,0,3,0,30
still have,489,9,14,2,1,0,0,26
a content,489,14,8,0,2,0,2,26
since 2007,489,7,15,2,0,1,0,25
chiefs royals,489,3,1,1,0,0,0,5
the st,489,1,3,0,0,0,0,4
licensed real,489,0,3,0,0,0,0,3
the founder,489,2,0,0,0,0,0,2
be cool,488,17,12,4,1,1,1,36
year of,488,13,18,2,0,1,0,34
be at,488,11,16,0,0,1,0,28
to remember,488,12,7,2,1,4,0,26
so i'm,488,16,7,0,1,1,0,25
go and,488,6,10,1,0,1,0,18
maga patriot,488,0,0,0,0,0,0,0
alum former,487,13,25,0,0,0,0,38
if my,487,6,16,3,2,1,0,28
believe the,487,0,8,0,1,0,0,9
sun moon,486,14,55,8,2,12,0,91
associate editor,486,17,59,2,0,2,0,80
u know,486,3,24,4,1,9,0,41
and equality,486,11,24,0,0,0,0,35
run the,486,16,7,1,1,0,1,26
and even,486,6,10,1,1,1,0,19
media is,486,4,1,1,0,0,0,6
- music,485,25,11,3,2,1,0,42
we call,485,8,9,2,0,1,0,20
i'm only,485,4,10,2,0,3,1,20
don't think,485,3,10,1,2,1,0,17
owner -,485,7,7,0,0,0,0,14
years now,485,2,4,0,0,0,0,6
military and,485,0,2,0,0,0,0,2
resources to,485,0,1,0,0,0,0,1
but will,484,17,16,3,1,3,0,40
engineer in,484,19,10,3,2,1,0,35
to care,484,9,16,2,3,3,0,33
political and,484,11,7,1,1,1,0,21
to walk,484,4,10,1,0,0,0,15
to spend,484,6,7,1,0,0,0,14
estudiante de,484,0,5,0,0,1,0,6
of service,484,0,2,1,0,0,1,4
a decent,483,18,22,1,2,3,1,47
like it's,483,5,17,0,1,1,0,24
work out,483,7,8,2,1,1,0,19
and back,483,6,5,1,1,4,0,17
many people,483,9,7,0,0,0,0,16
our future,483,2,3,0,0,1,0,6
drinker of,482,18,34,0,1,2,0,55
my interests,482,19,23,5,3,3,0,53
fighter for,482,7,25,0,1,0,0,33
and hot,482,9,10,5,3,5,0,32
travel food,482,8,11,0,0,0,0,19
c c,482,7,6,0,0,2,0,15
booking info,482,1,1,2,1,1,1,7
1 source,482,3,1,0,0,0,0,4
cleveland browns,482,1,0,0,0,0,0,1
donald j,482,0,0,0,0,0,0,0
stuff sometimes,481,37,38,16,7,9,1,108
university grad,481,2,4,0,1,0,0,7
for bts,480,1,66,1,0,0,0,68
newsletter http,480,11,14,1,0,0,0,26
me laugh,480,8,13,0,0,1,0,22
for who,480,9,4,3,2,0,0,18
a choice,480,1,10,1,0,0,0,12
golden knights,480,4,2,0,0,1,0,7
also play,479,32,10,1,2,3,0,48
medical student,479,16,24,0,0,1,0,41
because i’m,479,13,16,2,0,7,1,39
be taken,479,16,11,1,1,1,0,30
builder of,479,18,10,0,1,0,0,29
enjoy your,479,13,5,3,2,3,1,27
/ former,479,11,13,0,0,2,0,26
/ -,479,6,6,3,4,3,0,22
creator /,479,9,5,3,4,0,0,21
that all,479,3,7,3,0,0,0,13
needed to,479,4,4,0,0,0,0,8
for information,479,2,2,0,0,0,0,4
probably not,478,24,31,2,3,4,0,64
2 cats,478,13,33,3,0,1,0,50
and highly,478,4,6,1,0,2,0,13
of guy,478,5,1,0,0,0,0,6
business finance,478,0,0,0,0,0,0,0
j trump,478,0,0,0,0,0,0,0
my mouth,477,10,11,2,2,1,0,26
who doesn't,477,9,9,5,0,1,0,24
to everything,477,5,14,3,0,0,0,22
the small,477,7,5,1,0,1,0,14
attention to,477,7,4,0,0,0,0,11
are one,477,2,5,0,0,1,0,8
of west,477,2,4,0,0,0,0,6
my faith,477,1,3,0,0,0,0,4
a crypto,477,1,2,0,0,0,0,3
age in,476,42,70,27,26,30,1,196
18 //,476,26,30,7,8,6,1,78
producer writer,476,10,20,2,1,5,0,38
off and,476,14,5,1,0,1,0,21
bigger than,476,5,6,1,0,1,0,13
both sides,476,4,6,0,0,1,0,11
to transform,476,0,5,1,0,0,0,6
art design,475,12,19,1,2,5,1,40
and kindness,475,9,16,1,0,0,1,27
and security,475,15,4,1,1,0,0,21
and through,475,4,8,1,1,1,1,16
excited to,475,2,9,1,2,1,0,15
vikings fan,475,8,5,0,0,0,0,13
the grind,475,2,5,2,1,0,0,10
day 1,475,5,3,0,0,1,0,9
facebook and,475,2,3,1,0,1,0,7
take photos,474,17,20,3,3,5,0,48
books movies,474,13,29,1,0,2,0,45
or at,474,8,9,3,0,2,1,23
did not,474,12,9,0,0,0,0,21
make content,474,13,2,4,0,1,0,20
insta -,474,4,10,0,1,1,0,16
former pro,474,5,6,0,0,0,0,11
of global,474,4,4,1,0,0,0,9
the bag,474,1,5,0,0,1,0,7
built on,474,1,4,0,0,1,0,6
devoted husband,474,5,0,0,0,0,0,5
my game,473,16,11,1,1,2,0,31
a secret,473,8,10,0,1,2,0,21
since 2005,473,6,5,1,0,2,0,14
on sale,473,5,7,0,0,1,0,13
process of,473,5,6,0,1,0,0,12
life so,473,5,5,1,0,0,0,11
follow all,473,4,3,0,0,0,0,7
facebook instagram,473,1,2,0,0,0,0,3
love football,473,1,0,0,0,0,0,1
and illustrator,472,25,37,12,2,10,1,87
and comics,472,45,17,5,2,1,1,71
it back,472,6,6,1,3,1,0,17
independent artist,472,5,6,3,1,0,0,15
matter where,472,1,8,1,0,1,0,11
add a,472,5,3,1,2,0,0,11
and national,472,4,3,2,0,0,0,9
baseball is,472,7,2,0,0,0,0,9
bitcoin miner,472,0,0,0,0,0,0,0
the cat,471,19,37,4,0,1,0,61
her own,471,0,30,0,0,2,0,32
being an,471,12,13,1,0,4,0,30
u alum,471,8,12,0,1,2,0,23
and best,471,4,3,1,0,0,1,9
a native,471,2,5,0,1,0,0,8
science nerd,470,21,43,3,1,8,1,77
and designer,470,21,20,2,3,0,0,46
in psychology,470,12,24,4,1,3,0,44
to discuss,470,7,9,3,0,1,0,20
it’s time,470,3,9,1,1,0,0,14
program at,470,5,3,0,0,2,0,10
things happen,470,2,7,0,0,0,0,9
wife my,470,3,5,1,0,0,0,9
of tech,469,20,16,1,1,1,0,39
of old,469,15,13,1,0,2,0,31
light and,469,6,6,1,1,1,0,15
play in,469,7,3,1,0,1,0,12
commercial and,469,1,0,0,0,0,0,1
i mainly,468,27,21,3,3,0,2,56
the force,468,14,13,0,0,3,1,31
good girl,468,1,18,3,1,6,1,30
low key,468,9,9,0,1,0,0,19
life through,468,3,4,0,0,0,1,8
a call,468,1,0,0,0,0,0,1
equal housing,468,0,0,0,0,0,0,0
- opinions,467,30,18,2,3,4,0,57
my diary,467,1,18,2,2,5,0,28
the boston,467,6,8,0,0,0,0,14
mom friend,466,0,60,0,1,10,0,71
engineer /,466,17,3,1,1,1,0,23
health services,466,5,13,0,0,0,0,18
control of,466,6,4,1,0,3,0,14
write for,465,20,18,1,2,2,0,43
- dm,465,22,11,3,1,1,1,39
the back,465,8,11,1,2,0,0,22
by his,465,3,0,0,2,0,0,5
artist songwriter,465,0,1,1,0,1,0,3
things sometimes,464,41,39,13,7,5,5,110
a band,464,19,19,2,1,2,1,44
love gaming,464,12,8,1,0,0,1,22
was my,464,7,10,1,2,0,0,20
power and,464,5,5,0,0,1,0,11
here looking,464,3,2,0,0,0,0,5
the blockchain,464,0,2,0,0,0,0,2
sinner saved,464,0,0,0,0,0,0,0
dog mama,463,0,55,0,0,2,0,57
i’m trying,463,18,29,2,0,3,0,52
and computer,463,22,5,1,2,1,1,32
any kind,463,6,12,0,2,0,1,21
far from,463,3,7,1,0,2,0,13
you up,463,7,5,1,0,0,0,13
are going,463,4,5,1,1,0,0,11
proud texan,463,2,5,0,0,1,0,8
technology science,463,3,2,0,0,0,0,5
bi guy,462,30,0,0,3,0,0,33
thought i,462,7,17,2,0,2,0,28
in philly,462,21,6,0,0,0,0,27
and dance,462,4,12,1,1,1,0,19
since 1998,462,8,6,1,0,1,0,16
in philadelphia,462,6,8,0,0,0,0,14
former marine,462,4,1,0,0,1,0,6
a successful,462,3,2,0,0,0,0,5
and conditioning,462,1,1,0,0,0,0,2
the surrounding,462,1,0,0,0,0,0,1
better at,461,26,20,1,4,2,0,53
thing is,461,10,5,0,1,3,0,19
family guy,461,8,4,2,0,0,0,14
pop punk,460,29,29,8,5,4,1,76
discord server,460,31,11,4,2,8,2,58
everyone i,460,7,6,2,1,6,0,22
woman i,460,4,13,2,0,1,0,20
please dm,460,5,9,2,1,2,1,20
rn bsn,460,2,13,2,1,0,0,18
go get,460,7,9,0,0,1,0,17
and lifestyle,460,4,2,0,0,0,0,6
i suck,459,14,14,1,1,5,0,35
one that,459,4,6,2,0,1,0,13
boise state,459,4,7,1,0,0,0,12
my self,459,5,5,1,0,0,0,11
district of,459,2,3,0,0,0,0,5
wide receiver,459,0,0,0,0,0,0,0
aspiring artist,458,47,21,9,3,5,4,89
talk a,458,19,28,6,4,5,2,64
hey i’m,458,21,19,7,3,8,0,58
addict and,458,17,19,1,0,1,0,38
representative of,458,16,15,3,2,1,0,37
saving the,458,4,18,0,0,0,0,22
http //m,458,9,7,2,1,0,0,19
head and,458,5,9,0,0,1,0,15
a princess,458,0,11,0,0,1,0,12
healthy and,458,1,2,1,0,0,0,4
to hang,457,11,6,3,2,1,1,24
music -,457,12,7,1,2,1,0,23
are more,457,13,9,0,0,0,0,22
chef and,457,10,7,2,2,0,0,21
observer of,457,9,5,0,1,0,1,16
she will,457,1,7,0,0,0,0,8
discover the,457,1,0,0,1,0,0,2
my beloved,456,16,28,7,6,13,0,70
and chill,456,8,9,2,1,0,0,20
times and,456,5,9,0,0,0,0,14
y m,456,4,2,0,1,1,0,8
marine veteran,456,4,0,0,1,0,0,5
el que,456,0,1,0,0,0,0,1
that's it,455,12,12,2,2,3,0,31
like everyone,455,11,8,2,2,3,0,26
home mom,455,1,16,1,0,1,0,19
f a,455,6,5,0,1,1,0,13
in beautiful,455,4,5,0,0,0,0,9
to discover,455,3,4,0,1,1,0,9
the website,455,2,3,0,0,1,0,6
young black,455,2,2,0,0,0,0,4
business that,455,1,2,0,0,0,0,3
chaotic neutral,454,40,64,17,7,18,1,147
dm and,454,30,9,6,1,2,0,48
book of,454,16,18,1,2,1,0,38
and tell,454,10,15,2,1,1,0,29
always the,454,11,9,1,0,0,1,22
or do,454,4,6,2,0,1,0,13
a wise,454,3,4,0,0,0,0,7
minors will,453,55,26,16,7,12,4,120
of directors,453,14,19,1,0,0,0,34
one with,453,4,15,2,0,0,0,21
better and,453,9,6,0,0,0,1,16
leading the,453,2,3,0,0,0,0,5
on tumblr,452,20,66,15,5,12,3,121
sorry for,452,13,17,4,2,4,2,42
a light,452,6,11,3,0,1,0,21
to hold,452,2,10,2,0,0,0,14
journal of,452,6,7,0,0,0,1,14
last name,451,18,37,6,0,1,0,62
people say,451,14,18,0,1,0,0,33
gives me,451,6,10,2,1,2,0,21
gun owner,451,5,7,0,0,0,1,13
taking care,451,4,5,2,0,0,0,11
senior fellow,451,4,5,0,0,1,0,10
eat sleep,451,4,3,0,0,0,0,7
drag queen,450,14,23,15,7,10,5,74
loves video,450,27,17,6,0,1,1,52
my hand,450,7,14,1,0,2,0,24
6th grade,450,4,8,1,0,0,0,13
orlando fl,450,3,3,0,0,0,0,6
we like,450,1,3,0,0,1,0,5
vaccinated and,449,8,28,1,0,4,1,42
in pa,449,7,14,0,0,1,1,23
changed my,449,4,9,1,0,0,0,14
this my,449,5,4,0,0,0,0,9
dm with,449,3,4,0,0,1,0,8
artificial intelligence,449,3,3,0,0,0,0,6
que te,449,0,3,0,0,0,0,3
strength conditioning,449,0,0,0,0,0,0,0
mom nana,448,0,17,0,0,0,0,17
on her,448,2,10,1,0,3,0,16
through and,448,3,9,1,1,1,1,16
level 1,448,5,6,0,0,0,0,11
leading provider,448,0,0,0,0,0,0,0
writer with,447,19,28,5,0,6,0,58
wine enthusiast,447,9,18,0,0,0,0,27
my voice,447,5,17,0,0,0,0,22
kindergarten teacher,447,2,12,0,0,1,0,15
the enemy,447,3,3,0,1,0,0,7
a network,447,1,1,0,0,0,0,2
our constitution,447,0,0,0,0,0,0,0
available in,446,5,6,1,1,1,0,14
com a,446,7,3,0,0,1,0,11
lot and,445,21,28,6,6,4,1,66
doesn't mean,445,8,9,2,0,0,0,19
wisdom is,445,3,3,1,0,0,0,7
share with,445,0,5,1,0,0,0,6
remember the,444,8,5,1,0,2,0,16
time you,444,4,7,4,0,0,0,15
2 years,444,7,3,3,0,0,0,13
xbox one,444,6,4,0,2,0,0,12
sports management,444,1,5,0,0,0,0,6
my purpose,444,3,0,0,0,2,0,5
crypto lover,444,0,0,0,0,0,0,0
i laugh,443,11,14,1,0,3,0,29
political news,443,5,7,0,0,0,1,13
is god,443,4,5,0,0,2,0,11
her she,443,2,2,0,0,0,0,4
3 girls,442,5,3,0,0,0,0,8
father veteran,442,7,0,0,0,0,0,7
fans of,442,2,3,0,0,1,0,6
doctoral candidate,441,14,30,2,0,0,0,46
kill me,441,11,9,4,1,3,0,28
out this,441,6,9,4,1,1,0,21
follows me,441,6,9,1,1,1,1,19
and any,441,6,8,0,1,2,0,17
dog is,440,18,26,2,1,2,4,53
and pretty,440,15,16,4,4,2,1,42
hey i,440,12,11,6,2,1,0,32
i fight,440,14,11,1,0,0,1,27
come hang,440,12,6,3,1,2,1,25
a right,440,11,10,1,0,1,0,23
book a,440,3,14,1,2,2,0,22
since 2001,440,2,12,0,0,0,1,15
business page,440,0,1,0,1,2,0,4
tools to,439,6,2,0,1,0,0,9
and private,439,5,1,0,0,0,0,6
news editor,438,23,36,1,2,2,0,64
good boy,438,37,3,3,10,2,2,57
women are,438,5,28,2,1,5,0,41
at large,438,21,13,2,0,0,0,36
my mother,438,10,12,2,0,1,0,25
best thing,438,5,7,0,1,1,0,14
greater than,438,4,6,0,0,1,0,11
praying for,438,3,5,0,0,0,0,8
nfl draft,438,6,1,0,0,0,0,7
of nfts,438,3,0,0,0,0,0,3
professional sports,438,1,1,0,0,0,0,2
write things,437,33,59,16,3,4,1,116
rp account,437,17,23,2,3,3,1,49
since 1996,437,2,10,1,0,1,0,14
better life,437,1,8,0,0,0,0,9
mind to,437,5,2,0,0,0,0,7
de ser,437,1,1,0,0,0,0,2
truth social,437,0,0,0,0,0,0,0
photographer artist,436,5,22,2,2,1,0,32
systems and,436,14,12,1,0,2,0,29
food music,436,10,15,0,0,2,0,27
fine arts,436,4,13,1,1,0,0,19
lover music,436,5,13,0,0,1,0,19
wild and,436,2,10,2,1,1,1,17
my yt,436,5,9,1,1,1,0,17
s h,436,2,7,1,0,0,0,10
christian patriot,436,0,0,0,0,0,0,0
waiting to,435,3,14,3,0,1,0,21
and can,435,8,8,2,0,1,0,19
o l,435,4,4,0,0,1,0,9
very proud,435,4,3,1,0,0,0,8
one under,434,20,5,2,4,2,1,34
that just,434,5,20,4,1,1,0,31
using my,434,12,13,2,0,0,0,27
raised by,434,8,16,0,0,2,0,26
music videos,434,7,7,3,2,0,0,19
it's your,434,7,5,1,0,1,0,14
in its,434,2,7,3,0,1,0,13
music production,434,5,1,2,1,3,0,12
and off,434,2,6,1,1,0,0,10
cute things,433,27,84,7,4,14,2,138
my house,433,10,17,1,1,1,1,31
reach me,433,8,18,1,1,2,0,30
for many,433,6,6,1,1,0,0,14
miss my,433,5,9,0,0,0,0,14
and better,433,6,4,1,0,1,0,12
giants and,433,6,2,2,0,0,0,10
oh my,432,16,22,3,1,3,0,45
who works,432,12,12,1,1,1,0,27
the thing,432,11,10,1,0,2,0,24
environment and,432,9,11,0,0,1,0,21
and red,432,6,5,1,2,1,0,15
wonderful wife,432,6,1,0,0,0,0,7
tv host,432,2,2,0,0,0,0,4
twitter user,431,12,17,2,2,2,0,35
enough for,431,14,13,1,3,2,0,33
teacher -,431,7,15,2,2,0,0,26
and craft,431,8,11,0,0,1,0,20
con el,431,0,0,0,0,1,0,1
minister of,430,14,6,1,0,1,0,22
say the,430,4,10,2,0,1,1,18
fan also,430,7,7,0,0,1,1,16
0 1,430,12,2,0,0,2,0,16
youth and,430,4,10,2,0,0,0,16
sister and,430,0,8,0,0,0,0,8
training for,430,3,1,0,2,0,0,6
si no,430,3,0,0,1,0,0,4
eater of,429,26,31,2,2,2,0,63
even more,429,8,11,1,0,2,0,22
just know,429,5,3,0,1,2,0,11
in tampa,429,6,1,0,0,0,0,7
specialized in,429,2,0,0,0,0,0,2
in stem,428,12,57,9,1,6,0,85
in digital,428,8,10,1,0,1,1,21
talk my,428,1,6,0,0,0,1,8
communities and,428,4,2,0,0,0,0,6
your cashapp,428,0,0,0,0,0,0,0
amateur artist,427,47,33,6,7,5,1,99
associate prof,427,24,52,0,1,0,1,78
lady of,427,0,27,0,0,2,0,29
films and,427,8,14,2,3,0,0,27
life's a,427,5,8,1,0,1,0,15
the poor,427,7,4,1,1,0,0,13
only god,427,3,2,0,0,1,0,6
when your,427,2,2,1,0,0,0,5
sports director,427,2,1,0,0,0,0,3
boston celtics,427,2,1,0,0,0,0,3
the magic,426,7,12,1,1,3,0,24
social change,426,2,16,2,0,1,0,21
the company,426,8,8,0,0,1,0,17
embrace the,426,6,6,1,0,1,0,14
views on,426,8,4,1,0,1,0,14
way the,426,2,7,0,1,0,0,10
you did,425,5,7,1,2,1,0,16
back i,425,4,5,1,0,1,0,11
hair stylist,425,2,8,0,0,0,0,10
your profile,425,3,4,1,1,0,0,9
for high,425,4,2,0,0,0,0,6
understanding of,425,1,1,2,1,0,0,5
business administration,425,1,2,0,0,0,0,3
making money,425,0,0,1,0,0,0,1
bitcoin eth,425,0,0,0,0,0,1,1
catholic high,425,0,0,0,0,0,0,0
state senator,424,16,13,0,0,0,0,29
wife friend,424,0,27,0,0,0,1,28
daughter friend,424,0,19,0,0,0,0,19
who they,424,12,4,1,0,0,0,17
and tweet,423,19,12,4,2,2,0,39
over and,423,16,4,1,0,1,0,22
hoping for,423,6,9,0,0,0,0,15
university in,423,4,5,0,0,0,0,9
chronically ill,422,8,113,40,9,36,1,207
or on,422,5,5,5,0,0,1,16
d o,422,5,8,0,1,1,0,15
for sure,422,6,5,2,1,1,0,15
my hubby,422,2,5,1,0,0,0,8
your daily,422,1,3,0,0,0,0,4
career and,422,1,2,0,0,0,0,3
a project,421,5,4,1,1,0,0,11
of 2026,421,2,3,0,0,0,1,6
this place,420,13,16,3,0,1,1,34
sorts of,420,18,7,3,1,1,2,32
no reason,420,14,9,2,0,1,0,26
than ever,420,4,5,5,0,1,0,15
helping the,420,4,4,0,0,0,0,8
on ebay,420,0,3,0,0,0,1,4
experience the,420,0,1,1,0,0,0,2
not medical,419,16,26,0,0,0,0,42
anything is,419,4,5,0,0,0,0,9
my employers,418,33,14,3,3,0,0,53
movie and,418,11,8,2,0,1,0,22
they were,418,14,4,1,0,0,0,19
big deal,418,8,6,2,0,0,0,16
your ass,418,6,8,1,0,0,0,15
news tips,418,5,9,0,0,1,0,15
told you,418,1,8,1,1,0,0,11
sports are,418,6,1,0,0,0,0,7
war veteran,418,2,3,0,1,0,0,6
at gmail,417,40,35,8,7,5,0,95
stop me,417,17,16,4,1,2,1,41
software and,417,18,3,0,1,0,1,23
good fight,417,8,12,1,0,0,1,22
free the,417,3,9,1,0,1,0,14
will love,417,5,4,2,0,0,1,12
solutions and,417,0,1,0,0,0,0,1
i'm probably,416,14,19,1,3,5,0,42
and sarcasm,416,3,18,0,0,1,0,22
be that,416,9,9,2,0,0,0,20
written by,416,10,5,0,2,0,0,17
high and,416,5,1,3,1,0,1,11
hasta la,416,3,4,1,1,0,0,9
baton rouge,416,4,2,0,0,0,0,6
detroit lions,416,2,2,2,0,0,0,6
musician writer,415,23,11,5,1,7,0,47
dad /,415,19,0,1,1,0,0,21
get spoil,415,0,0,0,0,0,0,0
20 i,414,23,24,10,6,8,1,72
say hello,414,11,2,0,0,0,0,13
for years,414,2,5,4,0,0,0,11
calm and,414,1,5,1,2,0,0,9
united fan,414,2,0,0,0,0,0,2
20 //,413,20,29,9,7,9,2,76
pop music,413,34,24,2,4,5,0,69
random shit,413,12,19,4,3,4,0,42
news director,413,7,12,0,0,0,0,19
to catch,413,7,4,3,0,3,0,17
4 and,413,6,7,2,0,0,0,15
mom grandmother,413,0,6,0,0,0,0,6
//www paypal,412,7,8,6,2,1,0,24
all pronouns,412,6,3,6,3,0,2,20
in vegas,412,7,5,1,0,1,0,14
f k,412,4,3,0,1,1,0,9
opinion only,412,5,2,0,0,0,0,7
about people,411,11,18,3,1,3,1,37
it doesn’t,411,4,14,1,0,0,0,19
cat person,410,17,59,10,0,5,1,92
big and,410,7,9,2,2,0,0,20
he can,410,12,0,0,0,0,0,12
rock roll,410,6,4,0,0,0,0,10
austin texas,410,3,4,0,0,0,0,7
agent for,410,5,1,0,0,1,0,7
your worth,410,3,3,0,0,0,0,6
video out,410,2,0,1,0,0,0,3
coalition of,410,0,0,0,0,0,0,0
meet me,409,7,13,1,2,2,0,25
the hot,409,6,13,3,0,2,0,24
use your,409,5,14,1,0,2,0,22
4 3,409,0,0,0,0,1,0,1
buy me,408,20,34,5,1,7,0,67
reflect those,408,23,27,3,4,2,2,61
send tips,408,8,20,0,1,3,0,32
a sea,408,9,17,1,0,0,0,27
content dm,408,7,8,2,1,1,0,19
we play,408,6,3,1,0,0,1,11
am married,408,2,7,0,0,1,0,10
help them,408,1,0,0,1,0,0,2
retired air,408,0,0,0,0,0,0,0
the revolution,407,9,16,1,2,1,0,29
paid for,407,11,10,0,1,0,0,22
yt channel,407,8,8,2,0,1,0,19
an eye,407,5,8,2,1,1,0,17
dream and,407,2,6,1,0,0,1,10
interact with,406,24,19,5,1,3,1,53
artist creator,406,8,14,5,2,2,0,31
this profile,406,11,8,1,1,0,0,21
and daughter,406,4,11,0,1,0,0,16
after all,406,5,9,0,0,1,0,15
a silly,405,26,24,8,9,5,1,73
about crypto,405,3,0,0,0,0,0,3
anime nerd,404,24,25,1,2,2,1,55
over my,404,11,31,2,2,3,0,49
designer -,404,23,12,3,2,2,0,42
house and,404,7,7,2,1,3,0,20
tv producer,404,10,9,0,0,0,0,19
in pittsburgh,404,9,5,0,0,0,0,14
an army,404,1,11,1,0,0,0,13
of common,404,2,5,0,0,0,0,7
nfl mlb,404,1,0,0,0,0,0,1
i vote,403,7,16,1,0,0,0,24
behavioral health,403,6,11,0,0,0,0,17
creator http,403,4,5,3,0,0,0,12
them i,402,12,16,1,1,2,0,32
my big,402,4,9,6,3,0,0,22
all content,402,6,8,0,1,0,1,16
or in,402,5,4,4,1,0,0,14
in law,402,4,5,0,0,0,0,9
closer to,401,2,6,2,0,1,0,11
ally blm,400,31,57,1,3,1,0,93
fan art,400,25,45,8,2,6,1,87
taco bell,400,18,24,4,2,3,0,51
my phone,400,14,14,1,3,0,0,32
nicki minaj,400,9,7,0,2,0,0,18
best-selling author,400,3,8,0,1,0,0,12
the blood,400,2,5,2,0,0,0,9
financial planning,400,1,3,0,0,0,0,4
firm specializing,400,0,0,0,0,0,0,0
plants and,399,20,45,6,1,3,0,75
guy you,399,28,1,0,0,0,0,29
me unless,399,9,12,3,0,3,2,29
through it,399,7,17,2,1,0,0,27
the cool,399,12,6,1,2,0,0,21
that’s why,399,4,11,0,1,1,0,17
for personal,399,9,2,1,2,1,0,15
to every,399,4,6,0,0,0,0,10
inside the,399,2,2,1,0,1,0,6
lead pastor,399,2,1,0,0,0,0,3
actor director,398,19,8,4,2,2,1,36
for everybody,398,4,11,2,1,3,0,21
don’t believe,398,3,9,1,0,1,0,14
science in,398,3,7,0,1,0,0,11
local and,398,5,3,0,0,0,0,8
a lonely,397,6,13,2,1,0,0,22
raised on,397,8,11,0,0,1,0,20
and twitter,397,3,10,0,1,0,1,15
feed the,397,5,6,1,1,1,0,14
host for,397,7,6,0,0,0,0,13
rather than,397,4,5,0,0,0,0,9
no limits,397,2,4,1,0,1,0,8
covering all,397,0,1,0,1,0,0,2
sf bay,396,10,13,0,4,1,1,29
emmy winner,396,9,5,0,1,1,0,16
a beach,396,5,6,0,0,0,1,12
to experience,396,3,3,4,1,0,0,11
the town,396,0,3,1,0,0,0,4
mentally ill,395,14,38,21,7,16,3,99
walk in,394,1,6,4,0,0,0,11
found me,394,3,8,0,0,0,0,11
a spiritual,394,2,4,1,1,2,0,10
you become,394,1,6,0,0,0,0,7
nothing less,394,2,2,1,0,0,0,5
senior software,393,46,14,1,0,2,0,63
dick pics,393,8,8,1,3,0,1,21
to chill,393,6,7,1,3,1,0,18
holder of,393,4,7,1,2,1,0,15
you lose,393,3,3,0,0,0,0,6
wonderful children,393,1,0,0,0,0,0,1
cofounder of,392,14,16,1,1,0,0,32
the street,392,7,7,1,1,0,0,16
3 awesome,392,3,2,0,0,0,0,5
asst coach,392,2,1,0,0,0,0,3
tampa fl,392,1,1,0,1,0,0,3
good books,391,5,23,0,1,1,0,30
people love,391,2,6,3,0,1,0,12
you’ll never,391,5,3,0,0,1,0,9
2 daughters,391,3,4,0,0,0,0,7
on soundcloud,391,3,1,0,1,1,0,6
facebook https,391,0,0,0,0,0,0,0
born at,390,29,11,2,1,2,1,46
small streamer,390,7,6,4,1,3,1,22
the sound,390,4,12,0,2,0,1,19
since 1995,390,2,10,0,0,0,1,13
treat others,390,6,5,1,0,0,0,12
be around,390,3,6,0,2,0,0,11
concerned about,390,7,2,0,0,1,0,10
aol com,390,4,3,0,0,0,0,7
hit that,390,4,1,1,0,0,0,6
over at,389,36,22,3,1,7,0,69
hello i’m,389,18,13,5,6,5,1,48
and rt,389,11,12,6,1,4,0,34
open and,389,17,7,3,4,2,0,33
politics history,389,9,3,1,0,0,0,13
you laugh,389,3,6,1,0,0,1,11
in finance,389,5,5,0,0,0,0,10
basketball football,389,1,1,0,0,0,0,2
not funny,388,26,21,4,2,4,0,57
account so,388,10,18,2,0,3,0,33
21 and,388,9,8,4,1,3,0,25
game nerd,387,44,22,4,3,3,0,76
the bills,387,11,6,0,1,0,0,18
always love,387,3,13,1,0,0,0,17
the development,387,2,1,0,0,0,0,3
http //etsy,386,8,35,9,1,10,2,65
a coffee,386,15,28,4,1,4,0,52
more just,386,4,14,0,0,0,0,18
photographer in,386,7,8,2,0,0,0,17
in pursuit,386,4,10,0,0,0,0,14
and https,385,10,3,0,1,0,0,14
an official,385,3,5,2,2,1,0,13
to that,385,3,6,4,0,0,0,13
their business,385,0,0,0,0,0,0,0
nft promoter,385,0,0,0,0,0,0,0
bring me,384,6,23,0,1,1,1,32
watch movies,384,16,8,1,0,1,0,26
clinical research,384,5,11,1,0,1,0,18
and state,384,3,8,0,0,0,0,11
wisconsin sports,384,3,3,1,0,0,0,7
raiders fan,384,2,5,0,0,0,0,7
organization of,384,0,0,0,0,0,0,0
i’m your,383,9,5,4,2,0,0,20
streamer content,383,11,5,1,0,1,0,18
beat writer,383,10,2,0,0,0,0,12
yourself to,383,2,10,0,0,0,0,12
love women,382,6,7,3,0,3,0,19
the stories,382,2,9,1,0,0,0,12
i drive,382,9,2,0,0,0,0,11
army combat,382,4,0,0,0,0,0,4
teacher i,381,8,15,1,0,1,1,26
and us,381,2,7,0,0,1,0,10
22 ig,381,0,7,1,1,1,0,10
gusta el,381,1,1,0,0,1,0,3
nft world,381,0,0,0,0,0,0,0
here trying,380,7,16,2,0,0,0,25
reality is,380,2,5,1,0,1,0,9
m b,380,1,4,0,0,0,0,5
not at,379,11,11,2,0,2,0,26
tools and,379,1,1,1,0,0,0,3
digital transformation,379,0,1,0,0,0,0,1
special teams,379,0,0,0,0,0,0,0
and climate,377,14,18,2,1,4,0,39
too i,377,13,7,2,2,1,1,26
to fly,377,6,10,1,1,1,0,19
of m,377,5,10,2,0,0,0,17
the hard,377,5,9,1,0,0,0,15
a company,377,6,2,1,0,1,0,10
t c,377,4,2,0,0,0,0,6
forever and,376,5,16,2,0,1,1,25
late night,376,4,14,0,0,2,0,20
fortnite player,376,3,0,2,0,0,0,5
nyc based,375,12,6,5,0,1,0,24
past and,375,7,8,1,0,0,0,16
my pinned,374,7,20,2,1,3,0,33
of government,374,10,5,0,0,0,0,15
products to,374,1,3,0,0,0,0,4
dream chaser,374,1,0,0,0,0,0,1
science at,373,19,8,1,1,1,0,30
where i’m,373,4,9,0,2,1,0,16
is 1,373,6,3,0,0,2,0,11
love big,373,3,4,0,1,1,1,10
experts in,373,0,0,0,0,0,0,0
running back,373,0,0,0,0,0,0,0
her hers,373,0,0,0,0,0,0,0
moon rising,372,11,52,6,2,8,0,79
for equality,372,11,27,1,0,0,0,39
can follow,372,8,8,0,1,2,0,19
am so,372,4,8,3,0,0,0,15
you who,372,2,6,0,0,0,0,8
sports -,372,6,0,0,0,0,0,6
lover proud,371,7,15,1,0,0,0,23
personal opinion,371,9,11,1,1,0,0,22
it seems,371,6,7,0,1,1,0,15
the brave,371,2,6,0,0,3,0,11
fire department,371,1,0,0,0,0,0,1
am looking,371,0,1,0,0,0,0,1
baseball commit,371,0,0,0,0,0,0,0
and women's,370,3,15,1,0,1,0,20
and america,370,3,1,0,0,0,0,4
the beat,369,5,5,0,3,1,0,14
now you,369,6,5,0,0,0,0,11
pretty girl,369,1,5,0,0,0,0,6
cooler than,368,12,11,7,2,1,1,34
the common,368,4,7,0,0,0,0,11
hop artist,368,1,0,1,1,0,0,3
investor nft,368,0,0,0,0,0,0,0
draw stuff,367,28,26,17,6,4,3,84
watcher of,367,15,17,2,1,1,0,36
or your,367,8,8,2,1,2,0,21
of beer,367,3,8,1,1,0,1,14
show love,367,3,8,0,1,1,0,13
graduate from,366,9,7,1,0,2,0,19
always ready,366,7,6,2,2,1,0,18
to order,366,1,5,2,0,0,0,8
of golf,366,0,1,0,0,0,0,1
point guard,366,0,0,0,0,0,0,0
at once,365,12,23,4,0,0,2,41
put it,365,11,6,0,1,1,0,19
pittsburgh pa,365,4,4,1,0,0,0,9
kingdom of,365,0,2,1,0,0,0,3
rts endorsement,364,12,10,1,0,2,0,25
at life,364,11,4,2,0,1,0,18
white and,364,5,6,4,1,0,0,16
of nothing,364,3,5,1,1,2,0,12
website https,364,4,4,1,1,0,0,10
des moines,364,4,4,0,0,0,0,8
florida gators,364,4,2,0,0,0,0,6
or anything,363,15,4,6,1,2,0,28
whole lotta,363,5,10,0,0,4,1,20
http //open,363,10,3,0,0,0,0,13
your self,363,1,1,2,0,0,0,4
guy here,363,3,0,0,0,0,0,3
auto repair,363,0,0,0,0,0,0,0
everyday life,361,3,4,0,0,1,0,8
of finance,361,4,1,1,0,0,0,6
one man,361,6,0,0,0,0,0,6
buyers sellers,361,0,0,0,0,0,0,0
veteran owned,361,0,0,0,0,0,0,0
leader for,360,9,6,1,0,0,0,16
just dm,360,7,2,2,1,0,0,12
will to,360,2,4,2,0,1,0,9
valorant player,360,3,3,0,1,0,0,7
a las,360,2,0,0,0,0,0,2
doing things,359,13,13,2,2,1,1,32
play on,359,10,10,0,1,2,0,23
me an,359,7,10,1,0,1,0,19
meaning of,359,3,6,2,0,1,0,12
podcast that,359,1,2,2,0,0,1,6
officials agencies,359,0,0,0,0,0,0,0
shit talker,358,4,4,0,0,1,0,9
4 boys,358,0,8,0,0,0,0,8
kappa alpha,358,1,2,0,0,1,0,4
for tomorrow,358,2,1,0,0,0,0,3
entertainment purposes,358,1,2,0,0,0,0,3
a comprehensive,358,1,0,0,0,0,0,1
i shoot,357,7,2,0,0,0,0,9
company and,357,3,1,0,0,0,0,4
the republican,357,1,1,0,0,1,0,3
kansas state,357,1,0,0,0,0,0,1
gov officials,357,0,0,0,0,0,0,0
cartoons and,356,23,22,9,4,7,1,66
content strategist,356,9,28,1,0,0,0,38
the games,356,15,4,4,0,1,0,24
multimedia journalist,356,5,13,0,0,0,0,18
lucky to,356,6,7,4,0,0,0,17
from you,356,6,3,1,0,0,0,10
arsenal fc,356,6,1,0,0,0,0,7
vida y,356,1,0,0,0,0,0,1
- gamer,355,32,9,3,1,3,0,48
and technical,355,2,4,0,0,0,0,6
sons and,355,2,0,0,0,0,0,2
chronic illness,354,1,69,8,2,11,0,91
portrait photographer,354,10,12,2,2,2,0,28
ohio university,354,3,17,0,0,1,0,21
to open,354,8,4,0,0,2,0,14
of view,354,4,7,0,0,2,0,13
hbcu grad,354,1,9,0,0,0,0,10
making things,353,17,21,7,1,4,1,51
a graphic,353,9,8,2,2,1,0,22
getting better,353,11,5,1,1,2,0,20
the young,353,5,1,0,1,1,0,8
live streaming,353,2,0,0,0,0,1,3
like dogs,352,8,23,2,2,3,0,38
of design,352,15,10,0,0,3,0,28
whatever it,352,5,8,0,0,1,0,14
our great,352,1,1,0,0,0,0,2
than people,351,5,18,2,0,2,1,28
and pizza,351,10,11,2,1,1,1,26
so my,351,7,6,1,2,1,0,17
i learned,351,3,10,0,0,1,0,14
instagram snapchat,351,2,1,1,0,0,0,4
politically homeless,351,2,1,0,0,0,0,3
ball is,351,1,2,0,0,0,0,3
army officer,351,2,0,0,0,0,0,2
good with,350,6,13,2,1,2,2,26
at what,350,6,8,2,1,0,0,17
and care,350,5,4,0,2,3,0,14
assistant baseball,350,1,0,0,0,0,0,1
if that,348,17,14,3,0,3,0,37
a model,348,3,3,0,0,0,0,6
lil bit,347,8,12,0,1,4,0,25
18 19,347,9,10,0,1,2,0,22
game i,347,7,8,3,3,0,0,21
me nice,347,1,7,1,0,1,0,10
retired nurse,347,3,7,0,0,0,0,10
political analyst,347,5,4,0,0,0,0,9
you care,346,13,9,1,0,0,1,24
since 2000,346,3,8,0,0,0,0,11
jewelry and,346,2,9,0,0,0,0,11
student athletes,346,0,0,0,0,0,0,0
good human,345,6,21,1,0,2,0,30
us as,345,3,0,0,0,0,0,3
wellness coach,345,0,3,0,0,0,0,3
hard fan,345,1,1,0,0,0,0,2
the sport,345,1,0,0,0,0,0,1
based photographer,344,5,3,1,2,1,0,12
helping clients,344,0,1,0,0,0,0,1
sound engineer,343,18,8,1,0,1,0,28
dad gamer,343,27,0,0,0,0,0,27
website and,343,5,0,0,0,0,0,5
through faith,343,0,1,0,0,0,0,1
music my,342,5,8,0,2,0,0,15
19 i,341,14,18,4,2,5,0,43
disney and,341,14,23,0,0,1,0,38
former tv,341,5,3,0,0,0,0,8
with real,341,3,3,0,0,0,0,6
the unknown,340,2,2,1,0,1,0,6
producer artist,339,5,2,2,1,0,0,10
news is,339,0,4,0,0,1,0,5
for college,339,0,3,0,0,1,0,4
the swamp,339,0,1,2,0,0,0,3
integrity and,339,1,2,0,0,0,0,3
games sometimes,338,35,27,4,7,4,0,77
i game,338,16,8,3,2,1,0,30
good heart,338,0,7,0,0,1,0,8
great people,337,2,4,0,0,0,0,6
of basketball,336,4,3,0,0,0,0,7
0 0,336,4,0,1,0,1,1,7
but i'll,335,13,20,2,0,2,1,38
and disney,335,14,14,0,0,3,0,31
streamer who,335,8,6,3,0,2,0,19
girls only,335,1,12,2,0,0,0,15
the f,335,4,5,0,1,1,0,11
kids my,335,4,5,0,0,1,0,10
the full,335,1,2,0,0,1,0,4
it at,334,9,4,1,0,3,0,17
stories about,333,6,28,2,1,2,0,39
a school,333,1,7,0,0,0,0,8
from ny,333,4,1,1,0,0,0,6
experience to,333,0,0,1,0,0,0,1
// insta,331,4,20,1,1,4,0,30
offices in,331,0,0,0,0,0,0,0
politics junkie,330,9,18,0,0,0,0,27
the scenes,330,3,1,0,0,1,1,6
spoiler free,329,15,77,17,9,18,1,137
nsfw /,329,24,12,7,5,3,2,53
left handed,329,10,10,0,1,2,0,23
the boy,329,10,2,0,0,0,0,12
s /,329,4,4,0,2,1,0,11
santa fe,329,2,4,1,0,0,0,7
suspended at,329,0,4,1,0,0,0,5
and bitcoin,329,0,0,0,0,0,0,0
environmental justice,328,11,35,0,2,3,0,51
here now,328,13,8,0,1,0,0,22
want more,328,5,3,2,0,0,0,10
columnist for,327,3,12,0,0,0,0,15
love photography,327,4,3,1,0,0,0,8
// the,326,16,20,1,0,5,0,42
seattle wa,326,10,9,2,1,0,1,23
human services,326,5,4,1,0,0,0,10
of missouri,326,1,3,0,0,0,0,4
like girls,325,1,16,1,0,7,0,25
below average,325,10,9,0,1,0,0,20
firm with,325,0,0,0,0,0,0,0
straight up,324,11,13,1,2,6,0,33
ad astra,324,12,15,2,0,0,0,29
game on,324,5,5,2,0,0,0,12
law of,324,5,2,1,0,2,0,10
fear the,324,5,1,0,0,0,0,6
years with,324,2,2,0,0,0,0,4
christian i,324,3,1,0,0,0,0,4
and unique,324,0,0,0,0,1,0,1
best things,323,2,7,0,0,0,0,9
life just,323,4,0,0,0,0,0,4
schools in,323,1,1,0,0,0,0,2
you forever,322,3,9,2,0,1,0,15
on politics,321,6,12,1,0,1,0,20
fine artist,321,3,11,2,0,0,0,16
move in,321,2,6,0,0,0,0,8
we ball,321,3,4,0,1,0,0,8
and nascar,321,6,2,0,0,0,0,8
gonna get,320,9,10,1,1,2,0,23
representative for,319,4,8,1,0,0,0,13
executive coach,319,3,5,0,0,0,0,8
christian mom,319,0,7,0,0,0,0,7
an actual,318,19,15,6,3,4,0,47
a word,317,5,12,1,0,0,0,18
stay on,317,3,5,1,0,1,0,10
and chief,317,6,3,0,0,0,0,9
alum opinions,316,19,25,1,0,0,0,45
a fine,316,4,6,3,0,1,0,14
south central,316,0,5,0,0,1,0,6
valley high,315,0,3,0,0,0,0,3
school 2023,315,0,0,1,0,0,0,1
occasional writer,314,32,29,7,0,7,0,75
have opinions,314,14,18,1,3,2,0,38
please i,314,8,11,10,0,0,2,31
this guy,314,24,0,0,0,0,0,24
serves the,314,0,3,0,1,0,0,4
la muerte,314,1,2,0,0,0,0,3
are those,313,10,6,0,0,1,0,17
years we,313,0,0,0,0,0,0,0
your neighborhood,312,2,12,3,1,1,0,19
my social,311,6,3,2,0,1,0,12
fa o,311,0,1,0,0,0,0,1
dude in,310,14,1,0,1,0,0,16
busca de,310,0,0,0,0,0,0,0
tech support,308,24,5,4,4,1,0,38
either way,308,2,8,0,1,1,2,14
i bring,308,4,7,1,0,0,0,12
fight against,307,2,2,0,0,0,0,4
for future,306,0,8,1,0,0,1,10
the club,306,1,6,1,0,2,0,10
site is,306,2,2,0,0,0,0,4
students for,306,1,1,0,0,0,0,2
i cuss,305,9,22,0,1,1,0,33
or visit,305,0,2,1,1,0,0,4
owned business,305,0,3,1,0,0,0,4
today to,305,1,1,0,0,0,0,2
pitching coach,305,2,0,0,0,0,0,2
studies and,304,10,14,4,0,0,0,28
toys and,304,11,7,2,1,0,0,21
not take,304,5,8,2,0,0,1,16
wwe aew,304,2,0,0,0,1,0,3
figure skating,303,6,44,2,1,0,0,53
sound of,303,4,11,1,1,0,0,17
conservative love,303,0,0,0,0,0,0,0
trans women,302,9,31,6,2,3,2,53
1/4 of,302,20,17,2,2,2,0,43
stranger things,302,9,22,1,0,4,0,36
tacos and,302,9,7,1,0,0,0,17
glass of,302,4,10,0,0,0,0,14
since 1991,302,5,7,0,1,0,0,13
everyone in,302,1,2,1,0,0,1,5
seattle seahawks,302,1,0,0,0,0,0,1
kick ass,301,2,12,1,0,1,0,16
of pharmacy,301,6,6,0,0,0,0,12
rams fan,300,3,2,0,0,0,0,5
backup page,300,0,0,0,0,0,0,0
local government,299,11,9,0,0,0,0,20
until it,299,5,5,1,1,0,0,12
5 star,299,6,2,0,1,0,0,9
don’t judge,299,3,5,0,0,0,0,8
my peace,299,0,5,0,1,0,0,6
stuff at,298,37,11,2,4,1,0,55
dream to,297,0,6,0,0,0,0,6
a giant,296,24,17,2,3,0,0,46
in fact,296,7,11,1,0,3,0,22
jersey shore,296,2,3,0,0,0,0,5
central texas,296,1,0,0,0,0,0,1
justice in,295,6,16,1,0,0,0,23
mine i,295,11,8,3,0,0,0,22
only you,295,2,3,1,3,0,0,9
social issues,294,5,11,2,0,3,1,22
gotta do,294,2,7,3,0,1,0,13
will win,294,6,5,0,0,1,0,12
bts fan,293,3,58,0,0,2,0,63
not spoiler,292,11,75,14,8,16,1,125
am now,292,5,3,0,0,1,0,9
stand out,291,2,0,0,0,1,0,3
followers on,290,3,3,2,0,1,0,9
services that,289,0,0,0,0,0,0,0
food i,287,11,1,0,0,0,0,12
of 25,287,3,2,1,0,0,0,6
s gueme,287,0,1,0,0,0,0,1
never seen,286,2,5,0,1,0,2,10
en las,286,0,1,0,0,0,0,1
have done,285,5,3,0,1,0,0,9
28 year,284,12,4,5,3,3,3,30
takes and,284,8,3,2,4,0,0,17
stand by,284,4,4,0,1,1,0,10
friends my,284,3,4,0,0,1,0,8
faith is,284,2,3,0,0,0,0,5
term limits,284,0,0,0,0,0,0,0
to creating,282,1,1,0,0,0,0,2
/ love,281,7,6,0,0,0,0,13
on patreon,280,18,13,9,3,2,1,46
nasty woman,280,0,30,0,0,0,1,31
of tweets,280,12,14,1,0,0,1,28
politics i,280,10,8,1,0,1,0,20
and corporate,280,2,1,0,0,0,1,4
seen a,278,6,3,2,1,1,0,13
i sleep,277,4,9,1,1,0,1,16
it i'm,277,4,9,1,1,0,1,16
your smile,277,1,9,0,0,0,0,10
people together,276,2,2,0,0,0,0,4
for beats,276,1,0,0,0,0,0,1
freelance graphic,275,6,10,1,0,3,0,20
the summer,274,6,4,0,0,0,0,10
s y,274,3,3,0,1,0,0,7
opposite of,273,7,12,2,0,1,0,22
bring it,273,5,4,0,0,0,0,9
war vet,273,3,1,0,0,0,0,4
laughter and,272,3,11,0,0,0,0,14
intellectual property,272,8,4,0,0,1,0,13
lover all,272,3,5,1,0,1,0,10
shoes and,272,0,5,1,0,1,0,7
main in,271,32,12,2,5,2,2,55
and 3d,271,18,4,4,4,4,1,35
newsletter https,271,5,6,0,0,1,0,12
man can,271,2,0,0,0,0,0,2
dms i,270,3,4,0,0,0,0,7
38 years,270,1,2,1,1,0,0,5
eu n,269,0,1,0,0,0,0,1
lover cat,267,12,24,1,0,2,0,39
que n,267,0,0,0,0,0,0,0
courtesy of,266,17,14,1,1,0,1,34
podcaster and,266,18,9,0,1,1,0,29
people don't,266,2,2,0,0,0,0,4
have too,264,15,18,4,0,5,0,42
story and,264,4,3,2,0,0,0,9
school head,264,0,0,0,0,0,0,0
be yours,262,22,9,0,0,1,0,32
got nothing,262,4,11,0,0,3,0,18
school i,261,5,5,0,0,0,1,11
trust your,257,4,5,0,0,0,0,9
about us,257,3,5,0,0,0,0,8
grace through,256,0,1,0,0,0,0,1
art /,254,8,8,3,3,4,1,27
and thank,251,5,6,1,0,4,1,17
the court,249,5,3,0,0,0,0,8
people by,249,1,2,1,0,0,0,4
takes to,248,5,3,0,1,0,0,9
me it's,248,3,2,0,1,0,0,6
the super,244,3,1,0,0,0,0,4
my angels,244,0,1,0,0,0,0,1
hard but,242,1,4,2,0,0,1,8
justice is,239,7,11,0,2,0,0,20
mon master,238,22,11,1,2,3,0,39
landscape photographer,238,6,6,0,0,0,0,12
cat parent,237,16,23,48,9,21,1,118
don’t try,237,3,6,1,0,2,0,12
create content,237,2,3,1,0,2,0,8
style and,237,1,7,0,0,0,0,8
philosophy of,236,12,5,2,2,1,0,22
people but,236,6,6,0,0,1,0,13
to collaborate,236,3,2,0,0,0,0,5
been married,236,0,2,0,0,0,0,2
of porn,233,11,3,3,4,1,0,22
among others,229,6,8,1,2,1,1,19
tweets/opinions are,228,13,18,0,0,0,0,31
believe i,228,4,7,0,0,0,0,11
are bad,227,25,13,3,0,3,0,44
near the,226,3,4,0,0,0,0,7
of greater,226,0,0,0,0,0,0,0
- helping,225,1,0,0,0,0,0,1
both of,222,7,5,2,1,1,1,17
like most,221,6,7,1,0,1,0,15
world's first,219,3,3,0,0,0,0,6
two time,217,9,4,0,0,0,0,13
creative mind,217,1,4,1,0,1,1,8
save democracy,215,1,4,1,0,0,0,6
never trump,214,1,2,0,0,0,0,3
with just,213,3,4,2,0,0,0,9
the colorado,213,3,1,0,0,1,0,5
p gina,210,0,0,0,0,0,0,0
gmail dot,208,19,14,3,4,3,2,45
in medical,206,2,4,0,0,0,0,6
in omaha,205,3,2,0,0,0,0,5
life time,197,1,0,0,0,0,0,1
de mim,195,0,0,0,0,0,0,0
cryptocurrency and,194,0,0,1,0,0,0,1
much fun,194,0,0,0,0,0,0,0
i dare,193,1,6,1,1,2,0,11
artist my,186,5,7,1,2,1,1,17
change i,183,3,3,0,1,1,0,8
or venmo,182,2,3,0,1,0,0,6
promoter and,182,0,0,0,0,0,0,0
chiefs kingdom,171,2,2,0,0,0,0,4
in ur,169,5,10,3,1,5,0,24
nerd at,165,4,12,1,0,0,0,17
cycling and,164,6,1,2,0,0,0,9
mom music,154,0,11,0,0,0,0,11
former hs,153,3,5,0,0,1,0,9
since my,147,2,1,1,0,0,1,5
former executive,133,4,3,0,0,0,0,7
and puns,105,8,8,1,0,1,0,18
and cardinals,89,3,1,0,0,0,0,4
honk honk,85,1,1,0,0,0,0,2
circleblack circleblack,66,0,0,0,0,0,0,0
austin austin,19,0,0,0,0,0,0,0
helio chiquito,10,0,0,0,0,0,0,0
