user_id,has_pronouns,followers_sampled,raw_match,raw_non_match,percent_match,percent_non_match
1138110338396753920,1,128,15,113,0.1171875,0.8828125
2318244175,0,88,86,2,0.9772727272727273,0.022727272727272728
899739689359462401,1,15,2,13,0.13333333333333333,0.8666666666666667
1155609842092056577,0,270,269,1,0.9962962962962963,0.003703703703703704
112780053,1,1000,60,940,0.06,0.94
2771862471,0,45,45,0,1.0,0.0
2288912777,0,1000,983,17,0.983,0.017
4724860400,1,503,137,366,0.27236580516898606,0.7276341948310139
1198198151162650624,0,1000,991,9,0.991,0.009
970674664904232967,1,945,106,839,0.11216931216931217,0.8878306878306879
1090037582162026496,0,1000,1000,0,1.0,0.0
1137208069,1,341,41,300,0.12023460410557185,0.8797653958944281
2353985840,0,964,955,9,0.9906639004149378,0.00933609958506224
1633863440,1,812,44,768,0.054187192118226604,0.9458128078817734
1347603010004914181,0,515,500,15,0.970873786407767,0.02912621359223301
35417305,1,312,41,271,0.13141025641025642,0.8685897435897436
2357199966,0,1000,989,11,0.989,0.011
1130869553464991744,1,123,9,114,0.07317073170731707,0.926829268292683
321690767,0,175,171,4,0.9771428571428571,0.022857142857142857
135372984,1,1000,19,981,0.019,0.981
944297449,0,267,267,0,1.0,0.0
894466572802183168,1,301,29,272,0.09634551495016612,0.9036544850498339
41004079,0,1000,993,7,0.993,0.007
30679327,1,798,45,753,0.05639097744360902,0.943609022556391
745061820499517440,0,1000,1000,0,1.0,0.0
1775244276,1,554,19,535,0.03429602888086643,0.9657039711191335
962639547686252550,0,14,14,0,1.0,0.0
30385559,1,353,5,348,0.014164305949008499,0.9858356940509915
71385061,0,1000,949,51,0.949,0.051
1102018806132760576,1,79,2,77,0.02531645569620253,0.9746835443037974
809555758652137472,0,141,116,25,0.8226950354609929,0.1773049645390071
773231454906159104,1,156,11,145,0.07051282051282051,0.9294871794871795
1482621509256556548,0,12,12,0,1.0,0.0
1313607883498688514,1,59,9,50,0.15254237288135594,0.847457627118644
1501977459159355409,0,88,88,0,1.0,0.0
1033586091155177473,0,564,560,4,0.9929078014184397,0.0070921985815602835
4825604960,1,1000,174,826,0.174,0.826
1302093284,0,171,170,1,0.9941520467836257,0.005847953216374269
1525752824,1,1000,48,952,0.048,0.952
1394613676435406850,0,14,14,0,1.0,0.0
991758379008880644,1,150,21,129,0.14,0.86
1501283094845960197,0,2,2,0,1.0,0.0
974614220124942337,1,328,42,286,0.12804878048780488,0.8719512195121951
961530018,0,239,239,0,1.0,0.0
1025633378630942721,1,1000,255,745,0.255,0.745
2650072758,0,129,124,5,0.9612403100775194,0.03875968992248062
47138128,1,89,12,77,0.1348314606741573,0.8651685393258427
740379061625593856,0,359,356,3,0.9916434540389972,0.008356545961002786
22333574,1,386,15,371,0.038860103626943004,0.961139896373057
1365497598103023616,0,16,16,0,1.0,0.0
1385494831,1,153,13,140,0.08496732026143791,0.9150326797385621
710348157972910081,0,63,63,0,1.0,0.0
2463693410,1,682,119,563,0.1744868035190616,0.8255131964809385
253278423,0,1000,981,19,0.981,0.019
56103984,1,452,9,443,0.01991150442477876,0.9800884955752213
1522571050613149697,0,6,6,0,1.0,0.0
65806351,1,593,39,554,0.0657672849915683,0.9342327150084317
3090684624,0,50,50,0,1.0,0.0
1076895473091268608,1,310,25,285,0.08064516129032258,0.9193548387096774
1358888482723233795,0,1,1,0,1.0,0.0
1522936096430120960,1,2,0,2,0.0,1.0
501562179,0,46,46,0,1.0,0.0
1057274101109264387,1,277,75,202,0.27075812274368233,0.7292418772563177
1727357161,0,190,186,4,0.9789473684210527,0.021052631578947368
702628629814124545,1,1000,14,986,0.014,0.986
66892957,0,1000,966,34,0.966,0.034
2838568457,1,254,13,241,0.051181102362204724,0.9488188976377953
974742575054839808,0,1000,901,99,0.901,0.099
979716408,1,1000,87,913,0.087,0.913
184451938,0,90,85,5,0.9444444444444444,0.05555555555555555
707414189040599040,1,273,52,221,0.19047619047619047,0.8095238095238095
1253844647320801280,0,259,182,77,0.7027027027027027,0.2972972972972973
991770439570649088,1,50,7,43,0.14,0.86
257181988,0,21,21,0,1.0,0.0
3081444396,1,159,45,114,0.2830188679245283,0.7169811320754716
767504935676063745,0,53,51,2,0.9622641509433962,0.03773584905660377
897679537,1,637,166,471,0.260596546310832,0.7394034536891679
614878441,0,52,52,0,1.0,0.0
31564334,1,1000,43,957,0.043,0.957
978147798804783104,0,95,94,1,0.9894736842105263,0.010526315789473684
885161473,1,267,56,211,0.20973782771535582,0.7902621722846442
1224174033576611840,1,60,2,58,0.03333333333333333,0.9666666666666667
1410277598555381760,0,3,3,0,1.0,0.0
941815559980765184,1,6,2,4,0.3333333333333333,0.6666666666666666
1033213244444295168,0,252,215,37,0.8531746031746031,0.14682539682539683
18873073,1,1000,78,922,0.078,0.922
1383275401,0,460,453,7,0.9847826086956522,0.015217391304347827
354889536,1,412,16,396,0.038834951456310676,0.9611650485436893
145270982,0,98,98,0,1.0,0.0
1234348203090337794,1,123,18,105,0.14634146341463414,0.8536585365853658
1477428207301316608,0,13,13,0,1.0,0.0
200556557,1,1000,31,969,0.031,0.969
794391955052621824,0,293,289,4,0.9863481228668942,0.013651877133105802
73283784,1,1000,22,978,0.022,0.978
873371538270978048,0,164,160,4,0.975609756097561,0.024390243902439025
1292427115,1,1000,58,942,0.058,0.942
15256214,0,526,524,2,0.9961977186311787,0.0038022813688212928
862822188512038912,1,445,69,376,0.1550561797752809,0.8449438202247191
753315540098101249,0,229,228,1,0.9956331877729258,0.004366812227074236
377974659,1,351,30,321,0.08547008547008547,0.9145299145299145
542785678,0,137,125,12,0.9124087591240876,0.08759124087591241
1283610254622810113,1,96,34,62,0.3541666666666667,0.6458333333333334
17887132,0,1000,957,43,0.957,0.043
2521548734,1,60,11,49,0.18333333333333332,0.8166666666666667
12452,0,499,489,10,0.9799599198396793,0.02004008016032064
1362677679313584128,1,277,6,271,0.021660649819494584,0.9783393501805054
23694068,0,764,698,66,0.9136125654450262,0.08638743455497382
2219191202,1,454,68,386,0.14977973568281938,0.8502202643171806
1369851431587622913,0,19,15,4,0.7894736842105263,0.21052631578947367
1478738430850912257,1,142,21,121,0.14788732394366197,0.852112676056338
1050262844527337473,0,563,546,17,0.9698046181172292,0.03019538188277087
2791231357,1,136,21,115,0.15441176470588236,0.8455882352941176
930006877,0,77,77,0,1.0,0.0
725598012,1,160,26,134,0.1625,0.8375
1306785712608546816,0,1000,825,175,0.825,0.175
12668762,1,170,7,163,0.041176470588235294,0.9588235294117647
1208795479733145602,0,42,42,0,1.0,0.0
3351081610,1,467,30,437,0.06423982869379015,0.9357601713062098
91889927,0,1000,998,2,0.998,0.002
1035855301902139393,1,140,7,133,0.05,0.95
3249551024,0,24,23,1,0.9583333333333334,0.041666666666666664
1031750622738042885,1,14,0,14,0.0,1.0
1508387378041434117,0,2,2,0,1.0,0.0
869072363618422785,1,1000,141,859,0.141,0.859
305419941,0,854,849,5,0.9941451990632318,0.00585480093676815
1160035092036636672,1,293,70,223,0.23890784982935154,0.7610921501706485
1480366077787922438,0,38,35,3,0.9210526315789473,0.07894736842105263
4663966219,1,140,40,100,0.2857142857142857,0.7142857142857143
196304599,0,29,29,0,1.0,0.0
17468042,1,195,80,115,0.41025641025641024,0.5897435897435898
1412796954950709249,0,7,7,0,1.0,0.0
18677637,1,1000,55,945,0.055,0.945
35464527,0,490,490,0,1.0,0.0
620618198,1,542,11,531,0.02029520295202952,0.9797047970479705
1574101495,0,250,249,1,0.996,0.004
11807552,1,153,39,114,0.2549019607843137,0.7450980392156863
1004361098286510080,0,17,17,0,1.0,0.0
14391289,1,341,15,326,0.04398826979472141,0.9560117302052786
1238283035642081281,0,516,388,128,0.751937984496124,0.24806201550387597
251947022,1,1000,84,916,0.084,0.916
1214245278,0,1000,834,166,0.834,0.166
14592636,1,117,12,105,0.10256410256410256,0.8974358974358975
5341622,1,1000,48,952,0.048,0.952
4905375957,0,767,766,1,0.9986962190352021,0.001303780964797914
25427818,1,124,26,98,0.20967741935483872,0.7903225806451613
1459292042606309376,0,39,39,0,1.0,0.0
2172675464,1,325,9,316,0.027692307692307693,0.9723076923076923
4722440833,0,641,640,1,0.9984399375975039,0.0015600624024961
3009542587,1,507,1,506,0.0019723865877712033,0.9980276134122288
1172264620989517824,0,28,23,5,0.8214285714285714,0.17857142857142858
976185944305909760,1,1000,36,964,0.036,0.964
44366636,0,236,232,4,0.9830508474576272,0.01694915254237288
932757055,1,290,20,270,0.06896551724137931,0.9310344827586207
15477995,0,541,541,0,1.0,0.0
1295104430736642048,1,387,58,329,0.14987080103359174,0.8501291989664083
1284167966083420160,0,343,343,0,1.0,0.0
826947720535379968,1,50,7,43,0.14,0.86
387528152,0,116,115,1,0.9913793103448276,0.008620689655172414
1451366849107664897,1,19,2,17,0.10526315789473684,0.8947368421052632
1332777072050266116,0,290,290,0,1.0,0.0
1056529634391658496,1,18,0,18,0.0,1.0
3172673105,1,249,17,232,0.06827309236947791,0.9317269076305221
988661137,0,1000,1000,0,1.0,0.0
1082797164605120512,1,46,2,44,0.043478260869565216,0.9565217391304348
1254286709967040512,0,1000,964,36,0.964,0.036
190397731,1,1000,447,553,0.447,0.553
68824017,0,231,230,1,0.9956709956709957,0.004329004329004329
2834477125,1,175,10,165,0.05714285714285714,0.9428571428571428
384717995,0,702,661,41,0.9415954415954416,0.0584045584045584
24487329,1,128,4,124,0.03125,0.96875
342467221,0,813,806,7,0.991389913899139,0.008610086100861008
1064717551354241025,1,22,5,17,0.22727272727272727,0.7727272727272727
776578692957007872,0,22,22,0,1.0,0.0
939706443980312578,1,55,4,51,0.07272727272727272,0.9272727272727272
1526993471340433409,0,6,6,0,1.0,0.0
359351638,0,1000,1000,0,1.0,0.0
3383257209,1,81,24,57,0.2962962962962963,0.7037037037037037
858818041240596480,0,577,561,16,0.9722703639514731,0.02772963604852686
1277345716508274689,1,13,3,10,0.23076923076923078,0.7692307692307693
429376464,0,1000,993,7,0.993,0.007
1621166258,1,1000,128,872,0.128,0.872
1483974261836505089,0,1,1,0,1.0,0.0
38498397,1,265,12,253,0.045283018867924525,0.9547169811320755
6188122,0,1000,972,28,0.972,0.028
1386485125169520642,1,35,10,25,0.2857142857142857,0.7142857142857143
1330693428372508674,0,109,109,0,1.0,0.0
2620942551,1,32,10,22,0.3125,0.6875
482960164,0,1000,997,3,0.997,0.003
977899620050317312,1,72,9,63,0.125,0.875
1507255760149159938,0,3,3,0,1.0,0.0
1245305605725851649,1,237,38,199,0.16033755274261605,0.8396624472573839
1206410335328129024,0,110,110,0,1.0,0.0
973773366527184896,1,1000,6,994,0.006,0.994
439359543,0,355,355,0,1.0,0.0
397590616,1,177,47,130,0.2655367231638418,0.7344632768361582
50669617,0,1000,988,12,0.988,0.012
1094382761387876352,1,362,22,340,0.06077348066298342,0.9392265193370166
1502715791527055362,0,5,5,0,1.0,0.0
22509706,1,377,8,369,0.021220159151193633,0.9787798408488063
1420396298323349510,1,29,13,16,0.4482758620689655,0.5517241379310345
1378944271521316865,0,152,147,5,0.9671052631578947,0.03289473684210526
2571543308,1,1000,145,855,0.145,0.855
847623361261850624,0,304,241,63,0.7927631578947368,0.20723684210526316
910629851345965056,1,137,7,130,0.051094890510948905,0.948905109489051
762326145631031296,0,262,258,4,0.9847328244274809,0.015267175572519083
1088611707583221760,1,1000,46,954,0.046,0.954
184675250,0,1000,973,27,0.973,0.027
3134297587,1,431,37,394,0.08584686774941995,0.91415313225058
873424244092293120,0,19,18,1,0.9473684210526315,0.05263157894736842
1267809438209126402,1,1000,27,973,0.027,0.973
20958216,0,1000,985,15,0.985,0.015
18339778,1,1000,47,953,0.047,0.953
4809285087,0,338,337,1,0.9970414201183432,0.0029585798816568047
867549546544365568,1,102,21,81,0.20588235294117646,0.7941176470588235
1162088088132132864,0,19,19,0,1.0,0.0
847722803822383104,1,101,1,100,0.009900990099009901,0.9900990099009901
581443378,0,737,593,144,0.8046132971506106,0.19538670284938942
713516272403750914,1,183,6,177,0.03278688524590164,0.9672131147540983
4215723873,0,657,653,4,0.9939117199391172,0.0060882800608828
32415148,1,147,13,134,0.08843537414965986,0.9115646258503401
1606283354,0,201,160,41,0.7960199004975125,0.20398009950248755
21156711,1,575,24,551,0.04173913043478261,0.9582608695652174
1391450995549474816,0,35,35,0,1.0,0.0
1101318347696820225,1,467,54,413,0.11563169164882227,0.8843683083511777
1097742220013326337,0,1000,998,2,0.998,0.002
1186297936444919808,1,366,39,327,0.10655737704918032,0.8934426229508197
1311972469,0,335,331,4,0.9880597014925373,0.011940298507462687
2268163730,1,35,7,28,0.2,0.8
22410938,0,109,104,5,0.9541284403669725,0.045871559633027525
381356453,1,1000,10,990,0.01,0.99
1433216631598092289,0,480,467,13,0.9729166666666667,0.027083333333333334
2861253616,1,200,64,136,0.32,0.68
22306971,0,480,469,11,0.9770833333333333,0.022916666666666665
330708452,1,79,6,73,0.0759493670886076,0.9240506329113924
970390054236499969,0,135,134,1,0.9925925925925926,0.007407407407407408
3117516616,1,1000,165,835,0.165,0.835
454152744,0,349,345,4,0.9885386819484241,0.011461318051575931
423831170,1,578,54,524,0.09342560553633218,0.9065743944636678
3291010518,0,1000,996,4,0.996,0.004
1103348163719528449,1,265,13,252,0.04905660377358491,0.9509433962264151
1449114149250863106,0,542,537,5,0.9907749077490775,0.00922509225092251
526998851,0,159,153,6,0.9622641509433962,0.03773584905660377
17973052,1,228,18,210,0.07894736842105263,0.9210526315789473
23162679,0,61,59,2,0.9672131147540983,0.03278688524590164
858725413354225664,1,1000,216,784,0.216,0.784
746803796769050625,0,172,170,2,0.9883720930232558,0.011627906976744186
870780833707241472,1,62,4,58,0.06451612903225806,0.9354838709677419
234447666,0,296,294,2,0.9932432432432432,0.006756756756756757
17587059,1,620,34,586,0.054838709677419356,0.9451612903225807
114671685,0,1000,994,6,0.994,0.006
1106472974,1,333,62,271,0.18618618618618618,0.8138138138138138
4254683596,1,237,68,169,0.2869198312236287,0.7130801687763713
2573343391,0,69,64,5,0.927536231884058,0.07246376811594203
1382931684,1,139,7,132,0.050359712230215826,0.9496402877697842
42913249,0,1000,991,9,0.991,0.009
2562622145,1,917,69,848,0.0752453653217012,0.9247546346782988
340356626,0,107,107,0,1.0,0.0
778244239633162247,1,77,0,77,0.0,1.0
445822892,0,1000,938,62,0.938,0.062
1441456587491577859,1,42,1,41,0.023809523809523808,0.9761904761904762
1434734920472084480,0,7,7,0,1.0,0.0
3011600026,1,248,17,231,0.06854838709677419,0.9314516129032258
95421708,0,78,75,3,0.9615384615384616,0.038461538461538464
264459583,1,1000,11,989,0.011,0.989
177666268,0,1000,994,6,0.994,0.006
1025412335933038592,1,1000,138,862,0.138,0.862
1261983831537696769,0,335,335,0,1.0,0.0
838618637724450816,1,165,12,153,0.07272727272727272,0.9272727272727272
1480072800610275332,0,65,64,1,0.9846153846153847,0.015384615384615385
15280039,1,1000,26,974,0.026,0.974
1136762866629873664,0,45,45,0,1.0,0.0
374313795,1,1000,41,959,0.041,0.959
3982084699,0,1000,973,27,0.973,0.027
865682003600998401,1,108,35,73,0.32407407407407407,0.6759259259259259
2151968168,0,1000,996,4,0.996,0.004
3341362094,1,1000,117,883,0.117,0.883
2363026495,0,779,772,7,0.9910141206675225,0.008985879332477536
2158724590,1,149,8,141,0.053691275167785234,0.9463087248322147
337749839,0,250,250,0,1.0,0.0
1429560969596919817,1,177,2,175,0.011299435028248588,0.9887005649717514
1084612782367096833,0,32,31,1,0.96875,0.03125
99703959,1,34,0,34,0.0,1.0
1225717039282651136,0,19,19,0,1.0,0.0
446852119,1,753,15,738,0.0199203187250996,0.9800796812749004
4884962979,0,7,7,0,1.0,0.0
1380504408459476993,1,600,63,537,0.105,0.895
1052426645934628864,0,1000,841,159,0.841,0.159
1248707082120986636,1,80,24,56,0.3,0.7
364540286,0,216,214,2,0.9907407407407407,0.009259259259259259
1000995072127549440,1,367,34,333,0.09264305177111716,0.9073569482288828
282910010,0,68,68,0,1.0,0.0
1331762862226857984,1,163,17,146,0.10429447852760736,0.8957055214723927
912119118572265472,0,84,84,0,1.0,0.0
367820872,1,1000,108,892,0.108,0.892
463246083,1,1000,121,879,0.121,0.879
16827335,0,91,89,2,0.978021978021978,0.02197802197802198
16952910,1,638,23,615,0.03605015673981191,0.9639498432601881
1020794714071547904,0,15,15,0,1.0,0.0
29493196,1,103,5,98,0.04854368932038835,0.9514563106796117
57870600,0,976,971,5,0.9948770491803278,0.005122950819672131
1344147584793776128,1,18,2,16,0.1111111111111111,0.8888888888888888
14065981,0,1000,985,15,0.985,0.015
8816482,1,1000,71,929,0.071,0.929
743651953499045888,0,294,293,1,0.9965986394557823,0.003401360544217687
547097840,1,294,4,290,0.013605442176870748,0.9863945578231292
378171631,0,52,50,2,0.9615384615384616,0.038461538461538464
4843011586,1,54,17,37,0.3148148148148148,0.6851851851851852
25237780,0,459,453,6,0.9869281045751634,0.013071895424836602
871063417,1,140,20,120,0.14285714285714285,0.8571428571428571
1393806645789003782,0,27,27,0,1.0,0.0
614320813,1,1000,153,847,0.153,0.847
1517815209934524416,0,10,10,0,1.0,0.0
1518331146,1,168,15,153,0.08928571428571429,0.9107142857142857
1006069100634824704,0,78,78,0,1.0,0.0
2887817125,1,58,12,46,0.20689655172413793,0.7931034482758621
255888116,0,77,77,0,1.0,0.0
2944838691,1,56,9,47,0.16071428571428573,0.8392857142857143
1429505560773201922,0,4,4,0,1.0,0.0
224517275,1,1000,62,938,0.062,0.938
844435626,0,101,100,1,0.9900990099009901,0.009900990099009901
1022546294005542919,1,212,76,136,0.3584905660377358,0.6415094339622641
364007698,0,142,142,0,1.0,0.0
1274545002736164864,1,1000,5,995,0.005,0.995
129050856,0,1000,971,29,0.971,0.029
2342768816,1,1000,42,958,0.042,0.958
1342887390537510912,0,2,2,0,1.0,0.0
1236184439287406592,1,1000,105,895,0.105,0.895
1438157987097546754,1,1000,31,969,0.031,0.969
34027316,0,680,669,11,0.9838235294117647,0.016176470588235296
972682466,1,1000,215,785,0.215,0.785
380736511,0,574,573,1,0.9982578397212544,0.0017421602787456446
1085391391,1,1000,300,700,0.3,0.7
1647854161,0,1000,989,11,0.989,0.011
334162223,1,1000,23,977,0.023,0.977
927189280304324608,1,143,1,142,0.006993006993006993,0.993006993006993
288016375,0,114,114,0,1.0,0.0
952956400568864768,1,919,206,713,0.22415669205658323,0.7758433079434167
786754544193540096,0,117,117,0,1.0,0.0
16000711,1,1000,113,887,0.113,0.887
231241446,0,484,483,1,0.9979338842975206,0.002066115702479339
69039416,1,143,13,130,0.09090909090909091,0.9090909090909091
708885216899674112,0,454,454,0,1.0,0.0
1269340731262599170,1,83,18,65,0.21686746987951808,0.7831325301204819
1407386316225101827,0,6,6,0,1.0,0.0
1311040584946249729,1,173,5,168,0.028901734104046242,0.9710982658959537
21319922,0,763,762,1,0.9986893840104849,0.001310615989515072
96595448,1,577,35,542,0.060658578856152515,0.9393414211438474
1456098101685481474,0,15,15,0,1.0,0.0
20193302,1,198,18,180,0.09090909090909091,0.9090909090909091
1292355209075793927,0,40,40,0,1.0,0.0
1114716965074087936,1,1000,26,974,0.026,0.974
263017895,0,330,329,1,0.996969696969697,0.0030303030303030303
881659835355410433,1,155,26,129,0.16774193548387098,0.832258064516129
1852064478,0,1000,993,7,0.993,0.007
2200600644,1,495,44,451,0.08888888888888889,0.9111111111111111
588774998,0,367,364,3,0.9918256130790191,0.008174386920980926
423038114,1,385,63,322,0.16363636363636364,0.8363636363636363
1403192726343008259,0,30,28,2,0.9333333333333333,0.06666666666666667
17918028,1,332,22,310,0.06626506024096386,0.9337349397590361
727104763565871106,0,1000,961,39,0.961,0.039
3235530932,1,255,29,226,0.11372549019607843,0.8862745098039215
1183375310869258240,0,793,792,1,0.9987389659520807,0.0012610340479192938
1262484777254490117,1,1000,116,884,0.116,0.884
1047861525774589954,0,86,84,2,0.9767441860465116,0.023255813953488372
1202404187017007104,1,1000,108,892,0.108,0.892
1473887721265373184,0,4,4,0,1.0,0.0
1331645491608633350,1,327,26,301,0.07951070336391437,0.9204892966360856
839515922293473281,0,4,4,0,1.0,0.0
817426296,1,183,33,150,0.18032786885245902,0.819672131147541
1452856907228712961,0,1000,852,148,0.852,0.148
1392845401338826759,1,32,7,25,0.21875,0.78125
2162889819,0,136,132,4,0.9705882352941176,0.029411764705882353
274726979,1,1000,76,924,0.076,0.924
3239247607,0,431,431,0,1.0,0.0
12125182,1,1000,68,932,0.068,0.932
920120535589285888,0,158,157,1,0.9936708860759493,0.006329113924050633
411297647,1,238,8,230,0.03361344537815126,0.9663865546218487
826156521885143042,0,1000,999,1,0.999,0.001
1194420861903630343,1,908,33,875,0.03634361233480176,0.9636563876651982
21464616,0,53,50,3,0.9433962264150944,0.05660377358490566
394826045,0,821,818,3,0.9963459196102314,0.0036540803897685747
31502636,1,168,6,162,0.03571428571428571,0.9642857142857143
1008442466188648449,0,20,20,0,1.0,0.0
1954569852,1,126,1,125,0.007936507936507936,0.9920634920634921
877187245010300929,0,83,83,0,1.0,0.0
3430459648,1,142,13,129,0.09154929577464789,0.9084507042253521
344480335,0,412,412,0,1.0,0.0
978462074920607744,1,109,24,85,0.22018348623853212,0.7798165137614679
2204046111,0,1000,996,4,0.996,0.004
3179596315,1,1000,163,837,0.163,0.837
1253187347828613120,0,9,9,0,1.0,0.0
1460488442085720064,1,85,3,82,0.03529411764705882,0.9647058823529412
1569450224,0,226,222,4,0.9823008849557522,0.017699115044247787
2990959606,1,91,7,84,0.07692307692307693,0.9230769230769231
2471776002,0,329,315,14,0.9574468085106383,0.0425531914893617
831918909628567552,1,1000,71,929,0.071,0.929
874205856,0,1000,961,39,0.961,0.039
2339402106,1,33,8,25,0.24242424242424243,0.7575757575757576
457639192,0,1000,970,30,0.97,0.03
56705240,1,543,12,531,0.022099447513812154,0.9779005524861878
68536644,0,653,653,0,1.0,0.0
11834472,1,176,4,172,0.022727272727272728,0.9772727272727273
357645151,0,178,177,1,0.9943820224719101,0.0056179775280898875
818219580,1,222,33,189,0.14864864864864866,0.8513513513513513
1536633980090556416,0,25,23,2,0.92,0.08
176320484,1,147,13,134,0.08843537414965986,0.9115646258503401
339806487,0,205,203,2,0.9902439024390244,0.00975609756097561
778244239633162247,1,77,0,77,0.0,1.0
1047558228001865730,0,278,277,1,0.9964028776978417,0.0035971223021582736
1243323044061483010,1,24,2,22,0.08333333333333333,0.9166666666666666
885573169,0,695,693,2,0.9971223021582734,0.0028776978417266188
1294466142984077315,1,261,77,184,0.2950191570881226,0.7049808429118773
2938980461,0,171,171,0,1.0,0.0
3281935087,1,214,2,212,0.009345794392523364,0.9906542056074766
845311566769786880,0,42,42,0,1.0,0.0
1042869696964358144,1,104,7,97,0.0673076923076923,0.9326923076923077
1193319639121571841,0,1000,961,39,0.961,0.039
622477634,1,606,40,566,0.066006600660066,0.933993399339934
548583973,0,804,803,1,0.9987562189054726,0.0012437810945273632
178724519,1,352,46,306,0.13068181818181818,0.8693181818181818
15153376,0,222,221,1,0.9954954954954955,0.0045045045045045045
1049099587041091584,1,202,25,177,0.12376237623762376,0.8762376237623762
129237021,0,345,338,7,0.9797101449275363,0.020289855072463767
21833337,1,1000,104,896,0.104,0.896
1422767387749797894,0,65,59,6,0.9076923076923077,0.09230769230769231
929210781178126336,1,46,8,38,0.17391304347826086,0.8260869565217391
15985831,0,1000,945,55,0.945,0.055
1136127550738984961,1,642,36,606,0.056074766355140186,0.9439252336448598
295225178,0,1000,999,1,0.999,0.001
554827658,1,1000,91,909,0.091,0.909
603537453,0,1000,994,6,0.994,0.006
1259540681145618435,1,148,30,118,0.20270270270270271,0.7972972972972973
954629180,0,791,790,1,0.9987357774968394,0.0012642225031605564
1865131279,1,377,15,362,0.03978779840848806,0.9602122015915119
1275572281,0,187,187,0,1.0,0.0
3372697454,1,556,115,441,0.2068345323741007,0.7931654676258992
8073492,0,1000,926,74,0.926,0.074
4649246601,1,47,8,39,0.1702127659574468,0.8297872340425532
865160334,0,368,367,1,0.9972826086956522,0.002717391304347826
1240086948217147392,1,43,2,41,0.046511627906976744,0.9534883720930233
1458823307986276358,0,39,39,0,1.0,0.0
612172411,1,133,23,110,0.17293233082706766,0.8270676691729323
715602013179027456,0,210,210,0,1.0,0.0
949551653996417024,0,8,8,0,1.0,0.0
881120305686736896,1,163,17,146,0.10429447852760736,0.8957055214723927
2327227421,0,49,49,0,1.0,0.0
1441756054732218369,1,5,1,4,0.2,0.8
283834294,0,185,184,1,0.9945945945945946,0.005405405405405406
2578584944,1,465,11,454,0.023655913978494623,0.9763440860215054
43468873,0,89,89,0,1.0,0.0
1156427463552983044,1,16,0,16,0.0,1.0
1303371939730391046,1,9,0,9,0.0,1.0
15355243,0,581,573,8,0.9862306368330465,0.013769363166953529
2445506808,1,388,36,352,0.09278350515463918,0.9072164948453608
2567587466,0,308,298,10,0.9675324675324676,0.032467532467532464
755701578,1,941,6,935,0.006376195536663124,0.9936238044633369
1615352454,0,40,40,0,1.0,0.0
1893571578,1,34,15,19,0.4411764705882353,0.5588235294117647
1587084366,0,353,350,3,0.9915014164305949,0.0084985835694051
13906652,1,833,8,825,0.009603841536614645,0.9903961584633854
1564036711,0,647,622,25,0.9613601236476044,0.03863987635239567
1080277826530619394,1,122,16,106,0.13114754098360656,0.8688524590163934
40283859,0,199,199,0,1.0,0.0
11647642,1,184,14,170,0.07608695652173914,0.9239130434782609
501827509,0,155,145,10,0.9354838709677419,0.06451612903225806
1452650862317289481,1,1,0,1,0.0,1.0
780793636032094209,0,42,42,0,1.0,0.0
620320805,1,356,127,229,0.35674157303370785,0.6432584269662921
973342295574679553,0,388,372,16,0.9587628865979382,0.041237113402061855
511314090,1,455,23,432,0.05054945054945055,0.9494505494505494
1209603074,0,1000,997,3,0.997,0.003
801774151,1,494,112,382,0.22672064777327935,0.7732793522267206
333861206,0,13,13,0,1.0,0.0
393777544,1,382,7,375,0.01832460732984293,0.981675392670157
497222316,0,237,229,8,0.9662447257383966,0.03375527426160337
1115965906448863232,1,1000,203,797,0.203,0.797
2585960286,0,687,652,35,0.9490538573508006,0.050946142649199416
17884749,1,307,57,250,0.18566775244299674,0.8143322475570033
1427609044852912217,0,692,690,2,0.9971098265895953,0.002890173410404624
1393155193815044096,1,43,4,39,0.09302325581395349,0.9069767441860465
1415303747547418625,0,53,53,0,1.0,0.0
325123970,0,666,644,22,0.9669669669669669,0.03303303303303303
201945025,0,74,73,1,0.9864864864864865,0.013513513513513514
1351864963913150465,1,89,5,84,0.056179775280898875,0.9438202247191011
47730407,0,1000,998,2,0.998,0.002
89821652,1,306,64,242,0.20915032679738563,0.7908496732026143
953500390888177664,0,63,63,0,1.0,0.0
453707218,1,894,145,749,0.1621923937360179,0.8378076062639821
1474956024104853507,0,59,54,5,0.9152542372881356,0.0847457627118644
994031112,1,1000,154,846,0.154,0.846
59818030,0,100,100,0,1.0,0.0
1012669192091389952,1,85,23,62,0.27058823529411763,0.7294117647058823
767532127399317505,0,1000,968,32,0.968,0.032
1602635011,1,448,81,367,0.18080357142857142,0.8191964285714286
625685795,0,1000,999,1,0.999,0.001
738749719783047169,1,56,7,49,0.125,0.875
1011019151807336448,0,658,658,0,1.0,0.0
1286987416293838850,1,321,49,272,0.1526479750778816,0.8473520249221184
3048778215,0,359,331,28,0.9220055710306406,0.07799442896935933
289052208,1,200,11,189,0.055,0.945
1427422254279774209,0,4,4,0,1.0,0.0
40804505,1,254,19,235,0.07480314960629922,0.9251968503937008
704081204019073026,0,789,789,0,1.0,0.0
3637228109,1,700,88,612,0.12571428571428572,0.8742857142857143
345121176,0,637,637,0,1.0,0.0
3031691,1,1000,192,808,0.192,0.808
873787452,0,212,211,1,0.9952830188679245,0.0047169811320754715
1446003469278531585,1,10,2,8,0.2,0.8
866495000103849984,0,56,56,0,1.0,0.0
190727531,1,811,95,716,0.11713933415536375,0.8828606658446363
1150318266759491586,0,19,19,0,1.0,0.0
706273,1,746,121,625,0.16219839142091153,0.8378016085790885
401866867,0,10,10,0,1.0,0.0
1140336094510272512,1,251,46,205,0.18326693227091634,0.8167330677290837
1216968213612892161,0,216,215,1,0.9953703703703703,0.004629629629629629
1353803340598177792,1,116,25,91,0.21551724137931033,0.7844827586206896
1429974526788620290,0,8,8,0,1.0,0.0
1146142185060012038,1,71,4,67,0.056338028169014086,0.9436619718309859
4799624958,0,447,441,6,0.9865771812080537,0.013422818791946308
65657237,1,1000,202,798,0.202,0.798
634912227,0,1000,969,31,0.969,0.031
1199449033040965633,1,14,3,11,0.21428571428571427,0.7857142857142857
147650020,0,272,269,3,0.9889705882352942,0.011029411764705883
3277245751,1,1000,73,927,0.073,0.927
56835640,0,230,223,7,0.9695652173913043,0.030434782608695653
1436156274631118854,1,6,1,5,0.16666666666666666,0.8333333333333334
20823709,0,149,149,0,1.0,0.0
32804510,1,1000,151,849,0.151,0.849
1679521568,0,25,24,1,0.96,0.04
1049793118344630272,1,148,17,131,0.11486486486486487,0.8851351351351351
775727157293252608,0,253,227,26,0.8972332015810277,0.10276679841897234
34086513,1,439,26,413,0.05922551252847381,0.9407744874715261
1389060862527348738,0,1,1,0,1.0,0.0
1018556266795425793,1,150,10,140,0.06666666666666667,0.9333333333333333
16176125,0,952,946,6,0.9936974789915967,0.0063025210084033615
765652158389727232,1,332,50,282,0.15060240963855423,0.8493975903614458
43206111,0,192,190,2,0.9895833333333334,0.010416666666666666
2620942551,1,32,10,22,0.3125,0.6875
913380600433840130,0,30,30,0,1.0,0.0
1086557140083339264,1,1000,133,867,0.133,0.867
1412083202861146113,0,119,119,0,1.0,0.0
4197382517,1,190,47,143,0.24736842105263157,0.7526315789473684
3003875079,0,1000,998,2,0.998,0.002
1516156564528324609,1,4,0,4,0.0,1.0
1633646822,0,47,46,1,0.9787234042553191,0.02127659574468085
1360805186499969025,1,15,2,13,0.13333333333333333,0.8666666666666667
867131,0,1000,990,10,0.99,0.01
1306605448427188232,1,1000,31,969,0.031,0.969
1517958873713459203,0,21,21,0,1.0,0.0
2789822088,1,545,178,367,0.326605504587156,0.673394495412844
1392893441433026560,0,30,30,0,1.0,0.0
766667481100541954,1,169,16,153,0.09467455621301775,0.9053254437869822
279713976,0,1000,998,2,0.998,0.002
1132231642796445697,1,29,3,26,0.10344827586206896,0.896551724137931
1384116447480143880,0,58,54,4,0.9310344827586207,0.06896551724137931
773921741202677760,1,156,48,108,0.3076923076923077,0.6923076923076923
231164709,0,1000,1000,0,1.0,0.0
771788466,1,390,61,329,0.1564102564102564,0.8435897435897436
1432739704210927624,0,16,16,0,1.0,0.0
244141742,1,85,4,81,0.047058823529411764,0.9529411764705882
1222298330207784960,0,61,44,17,0.7213114754098361,0.2786885245901639
913132429006819329,1,54,6,48,0.1111111111111111,0.8888888888888888
800487798,0,124,124,0,1.0,0.0
1101664005641388032,1,108,23,85,0.21296296296296297,0.7870370370370371
1296913195748253696,0,1000,995,5,0.995,0.005
291279225,1,1000,72,928,0.072,0.928
16043688,0,286,251,35,0.8776223776223776,0.12237762237762238
126175805,1,1000,135,865,0.135,0.865
914961663203463170,0,2,2,0,1.0,0.0
18571895,1,966,79,887,0.08178053830227744,0.9182194616977226
544627267,0,894,888,6,0.9932885906040269,0.006711409395973154
2497492825,1,585,46,539,0.07863247863247863,0.9213675213675213
775859756342710272,0,155,149,6,0.9612903225806452,0.03870967741935484
197165928,1,249,65,184,0.26104417670682734,0.7389558232931727
1089698244442116096,0,162,137,25,0.845679012345679,0.15432098765432098
877796820684087296,0,117,117,0,1.0,0.0
3241292470,1,22,5,17,0.22727272727272727,0.7727272727272727
25449770,0,222,221,1,0.9954954954954955,0.0045045045045045045
779774153478008832,1,150,56,94,0.37333333333333335,0.6266666666666667
837327991558586368,0,89,88,1,0.9887640449438202,0.011235955056179775
1493334987701055489,0,1000,883,117,0.883,0.117
29441839,1,58,3,55,0.05172413793103448,0.9482758620689655
1177440647764004865,0,223,220,3,0.9865470852017937,0.013452914798206279
362274857,1,104,20,84,0.19230769230769232,0.8076923076923077
1055242744380248064,0,3,3,0,1.0,0.0
3144960008,1,174,10,164,0.05747126436781609,0.9425287356321839
1423730237305667592,0,316,315,1,0.9968354430379747,0.0031645569620253164
240001922,1,1000,143,857,0.143,0.857
1906483400,0,64,64,0,1.0,0.0
1381724921341079556,1,212,30,182,0.14150943396226415,0.8584905660377359
1249360997716017152,0,137,137,0,1.0,0.0
1060286883593416705,1,689,71,618,0.10304789550072568,0.8969521044992743
488715310,0,1000,986,14,0.986,0.014
829162897242734592,1,82,6,76,0.07317073170731707,0.926829268292683
109487627,0,64,64,0,1.0,0.0
1070076146279047168,1,31,0,31,0.0,1.0
1242187238462631939,0,1000,961,39,0.961,0.039
979430964882423808,1,55,22,33,0.4,0.6
2256796113,0,801,799,2,0.9975031210986267,0.0024968789013732834
26865422,1,268,93,175,0.34701492537313433,0.6529850746268657
399855628,0,355,355,0,1.0,0.0
1592516240,1,215,13,202,0.06046511627906977,0.9395348837209302
1183789133375799298,0,71,71,0,1.0,0.0
2983475031,1,1000,207,793,0.207,0.793
1016882395902070784,1,294,46,248,0.1564625850340136,0.8435374149659864
1013115491202854914,0,151,150,1,0.9933774834437086,0.006622516556291391
218525830,1,126,10,116,0.07936507936507936,0.9206349206349206
174086862,0,1000,990,10,0.99,0.01
947619221911035904,1,137,11,126,0.08029197080291971,0.9197080291970803
418996024,0,1000,991,9,0.991,0.009
98577940,1,31,10,21,0.3225806451612903,0.6774193548387096
1283861244475252760,0,125,125,0,1.0,0.0
1199431820,1,1000,32,968,0.032,0.968
77894698,0,343,342,1,0.9970845481049563,0.0029154518950437317
768633002733830144,1,56,7,49,0.125,0.875
1459038422291472385,0,94,92,2,0.9787234042553191,0.02127659574468085
2275536008,1,110,4,106,0.03636363636363636,0.9636363636363636
1127011681,0,91,91,0,1.0,0.0
820114289923072000,1,198,55,143,0.2777777777777778,0.7222222222222222
2193526074,0,482,477,5,0.9896265560165975,0.01037344398340249
3246873891,1,388,25,363,0.06443298969072164,0.9355670103092784
1470583808068132869,0,32,21,11,0.65625,0.34375
713346822,1,165,25,140,0.15151515151515152,0.8484848484848485
636693268,0,1000,977,23,0.977,0.023
1334507734818033669,1,53,16,37,0.3018867924528302,0.6981132075471698
832813859534667776,0,32,32,0,1.0,0.0
94862059,1,66,20,46,0.30303030303030304,0.696969696969697
1008120974040895488,0,27,25,2,0.9259259259259259,0.07407407407407407
385707719,1,1000,182,818,0.182,0.818
1066739944536854528,0,370,370,0,1.0,0.0
1284621045606031361,1,882,388,494,0.4399092970521542,0.5600907029478458
748422156,0,4,4,0,1.0,0.0
2822932748,1,173,3,170,0.017341040462427744,0.9826589595375722
41594550,0,1000,997,3,0.997,0.003
3041427490,0,476,476,0,1.0,0.0
1481385895504850947,1,9,1,8,0.1111111111111111,0.8888888888888888
1439427384906862592,0,5,5,0,1.0,0.0
848261502,1,89,4,85,0.0449438202247191,0.9550561797752809
1396083626723381254,0,1000,992,8,0.992,0.008
451174232,1,293,82,211,0.27986348122866894,0.7201365187713311
2469696254,0,759,759,0,1.0,0.0
1035267850083098624,1,277,29,248,0.10469314079422383,0.8953068592057761
48478803,0,164,164,0,1.0,0.0
1279221582,1,402,24,378,0.05970149253731343,0.9402985074626866
1282531466732134400,0,57,46,11,0.8070175438596491,0.19298245614035087
94398120,1,325,71,254,0.21846153846153846,0.7815384615384615
753798712305090560,0,75,75,0,1.0,0.0
1359191386453606407,1,379,101,278,0.26649076517150394,0.7335092348284961
1128504166475812869,0,1000,1000,0,1.0,0.0
888864569036242945,1,44,2,42,0.045454545454545456,0.9545454545454546
353329347,0,790,782,8,0.9898734177215189,0.010126582278481013
396151542,1,137,13,124,0.0948905109489051,0.9051094890510949
1369314843208146945,1,27,0,27,0.0,1.0
963581510,0,1000,994,6,0.994,0.006
42991734,1,582,30,552,0.05154639175257732,0.9484536082474226
1269379671172567040,0,10,10,0,1.0,0.0
2716310098,1,220,2,218,0.00909090909090909,0.990909090909091
1190570586746933253,0,377,377,0,1.0,0.0
50262254,1,68,4,64,0.058823529411764705,0.9411764705882353
1231380956,0,1000,992,8,0.992,0.008
17047660,1,1000,61,939,0.061,0.939
1483520240847925249,0,248,239,9,0.9637096774193549,0.036290322580645164
1138488530907336710,1,43,1,42,0.023255813953488372,0.9767441860465116
19423069,0,369,366,3,0.991869918699187,0.008130081300813009
1390634528079745026,1,177,34,143,0.192090395480226,0.807909604519774
34477453,0,135,134,1,0.9925925925925926,0.007407407407407408
1700432372,1,183,7,176,0.03825136612021858,0.9617486338797814
41045762,0,1000,998,2,0.998,0.002
427749472,1,319,15,304,0.047021943573667714,0.9529780564263323
255735532,1,368,23,345,0.0625,0.9375
1372239878117789697,0,968,868,100,0.8966942148760331,0.10330578512396695
773478954820919296,1,64,16,48,0.25,0.75
363485921,0,5,5,0,1.0,0.0
14777534,1,320,41,279,0.128125,0.871875
1363990375870976001,0,14,14,0,1.0,0.0
3223418882,1,45,2,43,0.044444444444444446,0.9555555555555556
887764871932239873,0,32,32,0,1.0,0.0
1050740032120741888,1,307,65,242,0.21172638436482086,0.7882736156351792
104383981,0,117,116,1,0.9914529914529915,0.008547008547008548
911056263584370689,1,49,6,43,0.12244897959183673,0.8775510204081632
786315297393303552,0,764,746,18,0.9764397905759162,0.02356020942408377
1029457498619686913,1,9,1,8,0.1111111111111111,0.8888888888888888
1028535592471154688,0,64,64,0,1.0,0.0
1415338602075090944,1,727,128,599,0.17606602475928473,0.8239339752407153
1283855868350603271,0,96,94,2,0.9791666666666666,0.020833333333333332
1158431764630704128,1,13,2,11,0.15384615384615385,0.8461538461538461
1396492501800861698,0,43,43,0,1.0,0.0
771536284317736961,1,115,30,85,0.2608695652173913,0.7391304347826086
1516524938919915530,0,42,42,0,1.0,0.0
1555653932,1,74,21,53,0.28378378378378377,0.7162162162162162
1048742056271572992,0,57,57,0,1.0,0.0
2506918817,1,238,41,197,0.1722689075630252,0.8277310924369747
210944478,0,91,90,1,0.989010989010989,0.01098901098901099
813187257490345984,1,317,43,274,0.13564668769716087,0.8643533123028391
1183199846016126976,0,1000,1000,0,1.0,0.0
874098692,1,484,66,418,0.13636363636363635,0.8636363636363636
470464467,0,22,22,0,1.0,0.0
948348976360701952,1,219,74,145,0.3378995433789954,0.6621004566210046
3309740367,0,214,212,2,0.9906542056074766,0.009345794392523364
2920898570,1,188,10,178,0.05319148936170213,0.9468085106382979
58657851,0,1000,832,168,0.832,0.168
2713494042,1,162,0,162,0.0,1.0
1386471743787880449,0,33,32,1,0.9696969696969697,0.030303030303030304
3288001537,1,109,0,109,0.0,1.0
760160721724243970,0,43,42,1,0.9767441860465116,0.023255813953488372
192019544,1,111,9,102,0.08108108108108109,0.918918918918919
3379608189,0,18,18,0,1.0,0.0
19170579,1,206,6,200,0.02912621359223301,0.970873786407767
15858586,0,461,457,4,0.9913232104121475,0.008676789587852495
956371354936381440,1,167,27,140,0.16167664670658682,0.8383233532934131
822688262,0,615,566,49,0.9203252032520325,0.07967479674796749
2859051958,0,1000,854,146,0.854,0.146
1306455313592119296,1,1000,13,987,0.013,0.987
4151219135,0,40,40,0,1.0,0.0
970839397594738688,1,268,9,259,0.033582089552238806,0.9664179104477612
3228581296,0,61,61,0,1.0,0.0
1051619987012620289,1,1000,94,906,0.094,0.906
731086272232574976,0,827,825,2,0.9975816203143894,0.0024183796856106408
16265961,1,1000,58,942,0.058,0.942
16184095,0,1000,999,1,0.999,0.001
22863388,1,30,7,23,0.23333333333333334,0.7666666666666667
2983690057,0,308,302,6,0.9805194805194806,0.01948051948051948
4755189105,1,61,1,60,0.01639344262295082,0.9836065573770492
4252315409,0,1000,996,4,0.996,0.004
249372208,0,49,49,0,1.0,0.0
572724807,1,1000,51,949,0.051,0.949
1047002138,0,155,119,36,0.7677419354838709,0.23225806451612904
4663866134,1,120,7,113,0.058333333333333334,0.9416666666666667
59664961,0,1000,996,4,0.996,0.004
376494870,1,267,33,234,0.12359550561797752,0.8764044943820225
1457214044562022403,0,31,30,1,0.967741935483871,0.03225806451612903
323716957,1,62,8,54,0.12903225806451613,0.8709677419354839
21162920,0,40,40,0,1.0,0.0
832295363990188032,1,121,41,80,0.33884297520661155,0.6611570247933884
2858023907,0,281,280,1,0.99644128113879,0.0035587188612099642
890969515336642562,1,1000,25,975,0.025,0.975
1496168576893472771,0,78,78,0,1.0,0.0
932466105838219264,1,23,3,20,0.13043478260869565,0.8695652173913043
69939838,0,463,462,1,0.9978401727861771,0.0021598272138228943
1151518984635920384,1,1000,121,879,0.121,0.879
1210655869240840194,0,122,122,0,1.0,0.0
849742351207735296,1,65,9,56,0.13846153846153847,0.8615384615384616
1867355108,0,371,334,37,0.9002695417789758,0.09973045822102426
2908302806,0,8,8,0,1.0,0.0
3194835763,1,1000,246,754,0.246,0.754
1073317201514512393,0,50,45,5,0.9,0.1
1496634333607514112,1,38,3,35,0.07894736842105263,0.9210526315789473
907787723754414080,0,213,213,0,1.0,0.0
2990064106,1,34,2,32,0.058823529411764705,0.9411764705882353
1479153738820599808,0,26,24,2,0.9230769230769231,0.07692307692307693
767885643590594561,1,336,86,250,0.25595238095238093,0.7440476190476191
1140694321,1,1000,209,791,0.209,0.791
374433912,0,48,48,0,1.0,0.0
582053525,1,447,68,379,0.15212527964205816,0.8478747203579419
72944831,0,1000,1000,0,1.0,0.0
575833859,1,723,10,713,0.013831258644536652,0.9861687413554634
853536133510189057,0,164,163,1,0.9939024390243902,0.006097560975609756
844729824,1,1000,15,985,0.015,0.985
1263899969590898689,0,607,561,46,0.9242174629324547,0.0757825370675453
164141007,1,307,6,301,0.019543973941368076,0.9804560260586319
425048481,0,846,843,3,0.9964539007092199,0.0035460992907801418
32666093,1,133,8,125,0.06015037593984962,0.9398496240601504
3300989785,0,208,205,3,0.9855769230769231,0.014423076923076924
1435313893807738883,1,165,25,140,0.15151515151515152,0.8484848484848485
968677923644325888,0,36,34,2,0.9444444444444444,0.05555555555555555
416516456,1,130,21,109,0.16153846153846155,0.8384615384615385
1089622774593789953,0,657,654,3,0.9954337899543378,0.0045662100456621
1465070826491944974,1,18,8,10,0.4444444444444444,0.5555555555555556
1385325727722008576,0,19,17,2,0.8947368421052632,0.10526315789473684
1047666587690590208,1,26,0,26,0.0,1.0
916555627509432321,0,42,37,5,0.8809523809523809,0.11904761904761904
1890411570,1,1000,238,762,0.238,0.762
355319908,0,1000,972,28,0.972,0.028
1282113682353401857,1,223,39,184,0.17488789237668162,0.8251121076233184
1465720139718938626,0,211,209,2,0.990521327014218,0.009478672985781991
1333975627381215232,1,415,105,310,0.25301204819277107,0.7469879518072289
879192315046363136,0,33,33,0,1.0,0.0
55040835,1,294,30,264,0.10204081632653061,0.8979591836734694
1236439458964267009,0,24,24,0,1.0,0.0
48214455,0,150,148,2,0.9866666666666667,0.013333333333333334
6621852,1,119,14,105,0.11764705882352941,0.8823529411764706
59490143,0,311,309,2,0.9935691318327974,0.006430868167202572
14358790,1,521,63,458,0.12092130518234165,0.8790786948176583
22451602,0,91,90,1,0.989010989010989,0.01098901098901099
1240064451178639361,1,109,10,99,0.09174311926605505,0.908256880733945
1478506564038414343,0,200,197,3,0.985,0.015
1083788568,1,1000,266,734,0.266,0.734
1260909108,0,358,349,9,0.9748603351955307,0.025139664804469275
8097882,1,240,8,232,0.03333333333333333,0.9666666666666667
1328872286342897664,0,46,38,8,0.8260869565217391,0.17391304347826086
763731080671289344,0,63,63,0,1.0,0.0
959163617156399104,1,425,10,415,0.023529411764705882,0.9764705882352941
483495655,0,245,238,7,0.9714285714285714,0.02857142857142857
14173908,1,689,42,647,0.06095791001451379,0.9390420899854862
164516846,0,726,723,3,0.9958677685950413,0.004132231404958678
138129281,1,515,64,451,0.12427184466019417,0.8757281553398059
1313833877694115842,0,4,4,0,1.0,0.0
1323670286273826818,1,190,22,168,0.11578947368421053,0.8842105263157894
1077023946468458496,0,69,67,2,0.9710144927536232,0.028985507246376812
2779289484,1,375,107,268,0.2853333333333333,0.7146666666666667
1358381133990424576,0,18,18,0,1.0,0.0
344813850,1,187,22,165,0.11764705882352941,0.8823529411764706
54149631,0,1000,997,3,0.997,0.003
312463534,1,521,17,504,0.03262955854126679,0.9673704414587332
1027346209168654337,0,3,3,0,1.0,0.0
974185277337063426,1,126,29,97,0.23015873015873015,0.7698412698412699
717398961993023489,0,8,8,0,1.0,0.0
623492345,1,174,27,147,0.15517241379310345,0.8448275862068966
66283506,0,50,49,1,0.98,0.02
103385129,1,1000,74,926,0.074,0.926
940962363381108736,0,82,81,1,0.9878048780487805,0.012195121951219513
830964515990806528,1,154,3,151,0.01948051948051948,0.9805194805194806
1523904780199862272,0,100,100,0,1.0,0.0
993903713784868865,1,54,14,40,0.25925925925925924,0.7407407407407407
785531665506590720,0,56,56,0,1.0,0.0
1226531379002912769,1,197,50,147,0.25380710659898476,0.7461928934010152
2208334832,0,957,956,1,0.9989550679205852,0.0010449320794148381
164758769,1,377,76,301,0.20159151193633953,0.7984084880636605
1490478497369931783,0,36,36,0,1.0,0.0
329068624,1,21,1,20,0.047619047619047616,0.9523809523809523
729099555451457537,0,181,178,3,0.9834254143646409,0.016574585635359115
1224402321720741888,1,1000,250,750,0.25,0.75
762316489919565824,0,59,57,2,0.9661016949152542,0.03389830508474576
2454236102,1,69,1,68,0.014492753623188406,0.9855072463768116
1403714772563017732,0,124,124,0,1.0,0.0
2342542213,1,102,11,91,0.10784313725490197,0.8921568627450981
302747911,0,890,829,61,0.9314606741573034,0.06853932584269663
102888825,1,786,30,756,0.03816793893129771,0.9618320610687023
2678154672,0,603,576,27,0.9552238805970149,0.04477611940298507
380473362,1,735,111,624,0.1510204081632653,0.8489795918367347
413919151,0,1000,1000,0,1.0,0.0
1250117823562686475,1,310,63,247,0.2032258064516129,0.7967741935483871
800867410492407808,0,53,53,0,1.0,0.0
915413352,1,335,71,264,0.21194029850746268,0.7880597014925373
478142287,0,467,462,5,0.9892933618843683,0.010706638115631691
1170723997,1,87,2,85,0.022988505747126436,0.9770114942528736
569569042,0,423,419,4,0.9905437352245863,0.009456264775413711
905763512,1,216,47,169,0.2175925925925926,0.7824074074074074
1229119407466651649,0,1,1,0,1.0,0.0
308220608,0,153,153,0,1.0,0.0
2978752669,1,270,35,235,0.12962962962962962,0.8703703703703703
869670424011001856,0,404,401,3,0.9925742574257426,0.007425742574257425
14433597,1,496,28,468,0.056451612903225805,0.9435483870967742
1332527318250741761,0,287,287,0,1.0,0.0
1246464192019943425,1,18,2,16,0.1111111111111111,0.8888888888888888
91108970,0,31,28,3,0.9032258064516129,0.0967741935483871
1165320605429690368,1,228,73,155,0.3201754385964912,0.6798245614035088
1115442157,0,38,38,0,1.0,0.0
1202548146057949184,1,345,28,317,0.08115942028985507,0.9188405797101449
2839021875,0,127,126,1,0.9921259842519685,0.007874015748031496
1070005202,1,1000,83,917,0.083,0.917
1306719160357986312,0,38,38,0,1.0,0.0
291199456,1,1000,160,840,0.16,0.84
330413310,0,109,109,0,1.0,0.0
1266553010576113669,1,195,41,154,0.21025641025641026,0.7897435897435897
1335589138247151617,0,136,136,0,1.0,0.0
139514686,0,488,488,0,1.0,0.0
1223123167,1,1000,89,911,0.089,0.911
2752619855,0,204,203,1,0.9950980392156863,0.004901960784313725
237389357,1,1000,176,824,0.176,0.824
1483511341,0,1000,1000,0,1.0,0.0
969986747944914945,1,315,8,307,0.025396825396825397,0.9746031746031746
83606303,0,377,332,45,0.8806366047745358,0.11936339522546419
18090957,1,222,19,203,0.08558558558558559,0.9144144144144144
106221006,0,1000,973,27,0.973,0.027
1016819542545321985,1,509,128,381,0.25147347740667975,0.7485265225933202
859840579525525505,0,1000,907,93,0.907,0.093
1305491287827718144,1,1000,159,841,0.159,0.841
1267218396719935488,0,70,68,2,0.9714285714285714,0.02857142857142857
637089436,1,263,40,223,0.1520912547528517,0.8479087452471483
2828577249,0,507,501,6,0.9881656804733728,0.011834319526627219
242357017,1,371,77,294,0.20754716981132076,0.7924528301886793
36423762,0,1000,997,3,0.997,0.003
17126370,1,869,109,760,0.12543153049482164,0.8745684695051784
156065107,0,143,143,0,1.0,0.0
1368017040,1,1000,24,976,0.024,0.976
403072828,0,377,375,2,0.9946949602122016,0.005305039787798408
1127753212365291521,1,74,8,66,0.10810810810810811,0.8918918918918919
2233536522,0,84,84,0,1.0,0.0
263966954,1,208,11,197,0.052884615384615384,0.9471153846153846
1044770771736956929,0,4,4,0,1.0,0.0
497492750,1,493,13,480,0.02636916835699797,0.973630831643002
455743091,0,28,28,0,1.0,0.0
1512247734899814402,1,110,1,109,0.00909090909090909,0.990909090909091
463712330,0,1000,1000,0,1.0,0.0
18766578,1,230,29,201,0.12608695652173912,0.8739130434782608
28977089,0,21,21,0,1.0,0.0
1273365075324211200,1,7,3,4,0.42857142857142855,0.5714285714285714
822897171590709248,0,84,82,2,0.9761904761904762,0.023809523809523808
253315691,1,154,14,140,0.09090909090909091,0.9090909090909091
71096544,0,1000,996,4,0.996,0.004
2801094269,1,297,45,252,0.15151515151515152,0.8484848484848485
226695357,0,730,725,5,0.9931506849315068,0.00684931506849315
1248451505247547393,1,168,8,160,0.047619047619047616,0.9523809523809523
774395205281656836,0,7,7,0,1.0,0.0
1096320008521564160,1,205,31,174,0.15121951219512195,0.848780487804878
898637231153451008,0,136,133,3,0.9779411764705882,0.022058823529411766
2756680974,1,77,4,73,0.05194805194805195,0.948051948051948
1105240227310985218,0,158,157,1,0.9936708860759493,0.006329113924050633
3221735509,1,213,10,203,0.046948356807511735,0.9530516431924883
111956106,0,454,448,6,0.986784140969163,0.013215859030837005
1476355941717221376,1,10,1,9,0.1,0.9
3116846303,0,35,35,0,1.0,0.0
4671200239,1,97,24,73,0.24742268041237114,0.7525773195876289
1009754401,0,84,82,2,0.9761904761904762,0.023809523809523808
950047816197472257,1,1000,139,861,0.139,0.861
53177915,0,1000,990,10,0.99,0.01
1121548881278455810,1,2,1,1,0.5,0.5
3510228205,0,1000,987,13,0.987,0.013
575724472,1,107,6,101,0.056074766355140186,0.9439252336448598
257181988,0,21,21,0,1.0,0.0
2361581918,1,238,28,210,0.11764705882352941,0.8823529411764706
1163541897626959874,0,1000,999,1,0.999,0.001
74637876,1,970,174,796,0.17938144329896907,0.8206185567010309
191252289,0,1000,989,11,0.989,0.011
405954527,1,1000,414,586,0.414,0.586
156533310,0,250,248,2,0.992,0.008
108491206,1,516,33,483,0.06395348837209303,0.936046511627907
275851512,0,838,838,0,1.0,0.0
1518055612814442496,0,20,20,0,1.0,0.0
1471926076343402496,1,15,6,9,0.4,0.6
470648381,0,106,99,7,0.9339622641509434,0.0660377358490566
343634330,1,997,163,834,0.16349047141424272,0.8365095285857572
838243544078802945,0,145,144,1,0.993103448275862,0.006896551724137931
3035349549,1,1000,195,805,0.195,0.805
3000467168,0,371,371,0,1.0,0.0
213569632,1,292,4,288,0.0136986301369863,0.9863013698630136
850148863558250496,0,11,11,0,1.0,0.0
1161349573224407041,1,1000,36,964,0.036,0.964
543792620,0,561,560,1,0.9982174688057041,0.0017825311942959
1166921783531864064,1,232,45,187,0.1939655172413793,0.8060344827586207
534661633,0,236,236,0,1.0,0.0
34944221,1,1000,229,771,0.229,0.771
230779834,0,116,115,1,0.9913793103448276,0.008620689655172414
1083237187997462530,1,46,15,31,0.32608695652173914,0.6739130434782609
1043487563728740355,0,28,27,1,0.9642857142857143,0.03571428571428571
1201704336130224133,1,1000,7,993,0.007,0.993
773694445007073280,0,14,14,0,1.0,0.0
23524722,1,149,28,121,0.18791946308724833,0.8120805369127517
2484722900,0,891,891,0,1.0,0.0
743148388061941760,1,121,4,117,0.03305785123966942,0.9669421487603306
113214799,0,290,281,9,0.9689655172413794,0.03103448275862069
4397753255,1,161,24,137,0.14906832298136646,0.8509316770186336
992217672124436481,0,15,15,0,1.0,0.0
1069689219877138433,1,14,5,9,0.35714285714285715,0.6428571428571429
948478578605293569,0,64,64,0,1.0,0.0
19044094,1,641,24,617,0.0374414976599064,0.9625585023400937
551128508,0,99,98,1,0.98989898989899,0.010101010101010102
605159733,1,1000,201,799,0.201,0.799
451556685,0,68,66,2,0.9705882352941176,0.029411764705882353
1369886935838167045,1,75,13,62,0.17333333333333334,0.8266666666666667
1153898944231071744,0,134,128,6,0.9552238805970149,0.04477611940298507
1246926850007478272,1,31,7,24,0.22580645161290322,0.7741935483870968
187692906,0,755,753,2,0.9973509933774835,0.0026490066225165563
1137054868596613120,1,210,13,197,0.06190476190476191,0.9380952380952381
1468949654054256642,0,69,66,3,0.9565217391304348,0.043478260869565216
1121564265880666116,1,6,1,5,0.16666666666666666,0.8333333333333334
1403649500,0,874,871,3,0.9965675057208238,0.003432494279176201
334365418,1,1000,122,878,0.122,0.878
915442240440299521,0,10,10,0,1.0,0.0
218518224,1,1000,134,866,0.134,0.866
1932298974,0,100,100,0,1.0,0.0
2802168272,1,153,22,131,0.1437908496732026,0.8562091503267973
896102139323441153,0,354,351,3,0.9915254237288136,0.00847457627118644
382923319,1,370,74,296,0.2,0.8
478809497,0,240,232,8,0.9666666666666667,0.03333333333333333
794533837019770884,1,173,21,152,0.12138728323699421,0.8786127167630058
1245046444106625025,0,69,66,3,0.9565217391304348,0.043478260869565216
1467910947918516230,1,18,4,14,0.2222222222222222,0.7777777777777778
1239689066490322948,0,13,13,0,1.0,0.0
1134662455039287296,1,67,11,56,0.16417910447761194,0.835820895522388
1807351,0,210,188,22,0.8952380952380953,0.10476190476190476
1161301123,1,41,2,39,0.04878048780487805,0.9512195121951219
1380442475958050816,0,2,2,0,1.0,0.0
1447662950,1,547,55,492,0.10054844606946983,0.8994515539305301
1153850028022272000,0,668,666,2,0.9970059880239521,0.0029940119760479044
2988985222,1,152,12,140,0.07894736842105263,0.9210526315789473
964542538551046144,0,178,177,1,0.9943820224719101,0.0056179775280898875
507682913,1,651,109,542,0.1674347158218126,0.8325652841781874
825059535572250624,0,880,823,57,0.9352272727272727,0.06477272727272727
1070398562599612417,1,138,13,125,0.09420289855072464,0.9057971014492754
20792477,0,1000,998,2,0.998,0.002
612346175,1,696,5,691,0.007183908045977011,0.992816091954023
934543266359496705,0,279,279,0,1.0,0.0
606808082,1,605,58,547,0.09586776859504133,0.9041322314049587
824315004,0,725,725,0,1.0,0.0
1332690035183923202,1,63,1,62,0.015873015873015872,0.9841269841269841
68627256,0,137,129,8,0.9416058394160584,0.058394160583941604
9670592,1,923,46,877,0.04983748645720477,0.9501625135427952
99359884,0,157,156,1,0.9936305732484076,0.006369426751592357
891560742998212609,1,164,4,160,0.024390243902439025,0.975609756097561
1486728148779614224,0,9,9,0,1.0,0.0
1481144183976984580,1,218,53,165,0.24311926605504589,0.7568807339449541
104036353,0,1000,1000,0,1.0,0.0
1268143777698336769,1,843,46,797,0.054567022538552785,0.9454329774614472
754043773,0,1000,988,12,0.988,0.012
1233046776,1,370,9,361,0.024324324324324326,0.9756756756756757
1357408496505901056,0,1000,1000,0,1.0,0.0
2956096859,1,233,26,207,0.11158798283261803,0.8884120171673819
2360158458,0,203,196,7,0.9655172413793104,0.034482758620689655
114927287,1,1000,219,781,0.219,0.781
1418536456667213824,0,690,675,15,0.9782608695652174,0.021739130434782608
3233076997,1,757,260,497,0.34346103038309117,0.6565389696169088
1493370947088302082,0,4,4,0,1.0,0.0
1247605656024166404,1,1000,28,972,0.028,0.972
74753884,0,633,630,3,0.995260663507109,0.004739336492890996
6352892,1,355,24,331,0.0676056338028169,0.9323943661971831
1523727791962918912,0,86,86,0,1.0,0.0
988979061329399808,1,18,4,14,0.2222222222222222,0.7777777777777778
1406660360355057672,1,480,75,405,0.15625,0.84375
18810996,0,252,244,8,0.9682539682539683,0.031746031746031744
407476898,1,1000,295,705,0.295,0.705
709488712338567169,0,1000,962,38,0.962,0.038
16327747,1,1000,126,874,0.126,0.874
1097018978,0,169,167,2,0.9881656804733728,0.011834319526627219
2505385214,1,943,100,843,0.10604453870625663,0.8939554612937434
1493305379786305545,0,9,9,0,1.0,0.0
1044503000918634496,1,104,16,88,0.15384615384615385,0.8461538461538461
1388337031,0,1000,964,36,0.964,0.036
295373588,1,183,27,156,0.14754098360655737,0.8524590163934426
413538584,0,122,122,0,1.0,0.0
1483755229,1,258,8,250,0.031007751937984496,0.9689922480620154
925748711774449665,0,1000,977,23,0.977,0.023
3054074586,1,899,185,714,0.20578420467185762,0.7942157953281423
1294395423189340165,0,651,546,105,0.8387096774193549,0.16129032258064516
1611542916,1,176,22,154,0.125,0.875
84319854,0,54,54,0,1.0,0.0
989209371195465730,1,301,16,285,0.053156146179401995,0.946843853820598
3871186753,0,19,19,0,1.0,0.0
3001560431,1,290,15,275,0.05172413793103448,0.9482758620689655
62897464,0,177,177,0,1.0,0.0
14818387,1,1000,51,949,0.051,0.949
167442996,0,1000,997,3,0.997,0.003
1025205056839331841,1,449,98,351,0.2182628062360802,0.7817371937639198
1340080656844468224,0,745,594,151,0.7973154362416107,0.20268456375838925
1022143236742291457,1,794,110,684,0.1385390428211587,0.8614609571788413
3683985512,0,134,130,4,0.9701492537313433,0.029850746268656716
130584469,1,1000,78,922,0.078,0.922
80654513,0,253,251,2,0.9920948616600791,0.007905138339920948
1377919069,1,11,2,9,0.18181818181818182,0.8181818181818182
1959829832,0,388,384,4,0.9896907216494846,0.010309278350515464
3839156967,1,377,87,290,0.23076923076923078,0.7692307692307693
277351832,0,492,469,23,0.9532520325203252,0.046747967479674794
816773192815693824,1,58,7,51,0.1206896551724138,0.8793103448275862
1333641005074100225,0,113,111,2,0.9823008849557522,0.017699115044247787
1450204813128503302,1,23,6,17,0.2608695652173913,0.7391304347826086
391384165,1,663,16,647,0.024132730015082957,0.975867269984917
973475264,0,748,746,2,0.9973262032085561,0.00267379679144385
1307914040916742150,1,1000,57,943,0.057,0.943
1115787822521245702,0,450,428,22,0.9511111111111111,0.04888888888888889
3232214691,1,92,26,66,0.2826086956521739,0.717391304347826
1439326869183086593,0,1000,995,5,0.995,0.005
810951596645482496,1,936,59,877,0.06303418803418803,0.936965811965812
1027684534840709120,0,231,226,5,0.9783549783549783,0.021645021645021644
299254911,1,23,6,17,0.2608695652173913,0.7391304347826086
921271537,0,423,419,4,0.9905437352245863,0.009456264775413711
3074258854,1,337,28,309,0.0830860534124629,0.9169139465875371
1239025514012164097,0,147,147,0,1.0,0.0
267197338,1,1000,75,925,0.075,0.925
4639834826,0,30,29,1,0.9666666666666667,0.03333333333333333
3100968171,1,162,10,152,0.06172839506172839,0.9382716049382716
1524918961460084750,0,8,8,0,1.0,0.0
233196535,1,1000,327,673,0.327,0.673
2939037551,0,474,462,12,0.9746835443037974,0.02531645569620253
1681950456,1,1000,100,900,0.1,0.9
1547302184,0,654,653,1,0.9984709480122325,0.0015290519877675841
1506695492297703424,1,68,24,44,0.35294117647058826,0.6470588235294118
1942330446,0,47,47,0,1.0,0.0
2220693062,1,161,2,159,0.012422360248447204,0.9875776397515528
33574830,0,151,151,0,1.0,0.0
21232655,1,1000,137,863,0.137,0.863
701184137995100165,0,102,91,11,0.8921568627450981,0.10784313725490197
39624405,1,417,14,403,0.03357314148681055,0.9664268585131894
2932636388,0,64,64,0,1.0,0.0
2747175878,1,267,37,230,0.13857677902621723,0.8614232209737828
49012911,0,1000,937,63,0.937,0.063
2397914735,1,509,169,340,0.3320235756385069,0.6679764243614931
1312838823362035712,0,11,11,0,1.0,0.0
449018558,1,341,35,306,0.10263929618768329,0.8973607038123167
466078042,0,1000,969,31,0.969,0.031
3038293930,1,300,31,269,0.10333333333333333,0.8966666666666666
2897741469,0,498,494,4,0.9919678714859438,0.008032128514056224
1101390564086362112,1,737,109,628,0.14789687924016282,0.8521031207598372
15725077,0,1000,995,5,0.995,0.005
1199713638451253248,1,68,9,59,0.1323529411764706,0.8676470588235294
15922713,0,930,896,34,0.9634408602150538,0.03655913978494624
1037234166,1,622,38,584,0.06109324758842444,0.9389067524115756
138881902,0,7,7,0,1.0,0.0
242789811,1,339,86,253,0.2536873156342183,0.7463126843657817
3296788920,0,109,105,4,0.963302752293578,0.03669724770642202
143626138,1,219,7,212,0.0319634703196347,0.9680365296803652
389708985,0,399,394,5,0.9874686716791979,0.012531328320802004
2722537989,1,182,1,181,0.005494505494505495,0.9945054945054945
2922244166,0,194,189,5,0.9742268041237113,0.02577319587628866
123675526,1,426,6,420,0.014084507042253521,0.9859154929577465
3007179512,0,2,2,0,1.0,0.0
432263224,1,113,4,109,0.035398230088495575,0.9646017699115044
2973640710,0,598,597,1,0.9983277591973244,0.0016722408026755853
795835795294789632,1,85,17,68,0.2,0.8
928090747269779457,0,25,25,0,1.0,0.0
1492107540200816642,1,98,1,97,0.01020408163265306,0.9897959183673469
1481302987708547072,0,2,2,0,1.0,0.0
705930294,1,651,23,628,0.03533026113671275,0.9646697388632872
1285266209945026561,0,278,267,11,0.960431654676259,0.039568345323741004
290605449,1,1000,41,959,0.041,0.959
734312159996485632,0,229,229,0,1.0,0.0
1256901427512909825,1,50,5,45,0.1,0.9
1251351485654249481,0,231,229,2,0.9913419913419913,0.008658008658008658
1369934796588130305,1,776,126,650,0.16237113402061856,0.8376288659793815
1213069951,0,967,965,2,0.9979317476732161,0.002068252326783868
1063896433806454784,1,56,8,48,0.14285714285714285,0.8571428571428571
271640664,0,329,307,22,0.9331306990881459,0.0668693009118541
2764663819,1,152,10,142,0.06578947368421052,0.9342105263157895
4724586446,0,1000,996,4,0.996,0.004
47059633,1,374,1,373,0.00267379679144385,0.9973262032085561
1456408178799878145,0,66,66,0,1.0,0.0
236562256,1,433,65,368,0.15011547344110854,0.8498845265588915
2919008448,0,119,118,1,0.9915966386554622,0.008403361344537815
1495179949359067138,1,343,75,268,0.21865889212827988,0.7813411078717201
1514005013923872769,0,58,54,4,0.9310344827586207,0.06896551724137931
1307004727994048513,1,242,71,171,0.29338842975206614,0.7066115702479339
335295766,0,1000,983,17,0.983,0.017
1133899958061547526,1,30,6,24,0.2,0.8
277692406,0,899,897,2,0.9977753058954394,0.002224694104560623
1137980773,1,442,14,428,0.03167420814479638,0.9683257918552036
1172519515072192512,0,78,76,2,0.9743589743589743,0.02564102564102564
2634182149,1,399,50,349,0.12531328320802004,0.87468671679198
525633486,0,49,49,0,1.0,0.0
611316418,1,377,61,316,0.16180371352785147,0.8381962864721485
337925676,0,275,270,5,0.9818181818181818,0.01818181818181818
2879045254,1,265,21,244,0.07924528301886792,0.9207547169811321
2960192864,0,93,93,0,1.0,0.0
30705452,1,556,19,537,0.0341726618705036,0.9658273381294964
3329095477,0,23,23,0,1.0,0.0
30585301,1,1000,177,823,0.177,0.823
1215357040509378560,0,15,15,0,1.0,0.0
41675078,0,337,336,1,0.9970326409495549,0.002967359050445104
18180997,1,76,1,75,0.013157894736842105,0.9868421052631579
525621355,0,1000,999,1,0.999,0.001
9507172,1,1000,227,773,0.227,0.773
153198983,0,574,563,11,0.980836236933798,0.01916376306620209
1681687436,1,452,48,404,0.10619469026548672,0.8938053097345132
1539392331073441792,0,12,12,0,1.0,0.0
1111810485194801159,1,46,16,30,0.34782608695652173,0.6521739130434783
28392004,0,158,157,1,0.9936708860759493,0.006329113924050633
2312218830,1,656,14,642,0.021341463414634148,0.9786585365853658
863585736905310208,0,187,182,5,0.9732620320855615,0.026737967914438502
2342667776,1,161,8,153,0.049689440993788817,0.9503105590062112
967543842,0,979,970,9,0.9908069458631257,0.009193054136874362
1106038513559130112,1,84,6,78,0.07142857142857142,0.9285714285714286
33651423,1,519,22,497,0.04238921001926782,0.9576107899807321
1462602844251385862,0,7,7,0,1.0,0.0
2187483001,0,43,43,0,1.0,0.0
816550155147182080,1,270,57,213,0.2111111111111111,0.7888888888888889
2544585198,0,23,23,0,1.0,0.0
973289660372963330,1,98,16,82,0.16326530612244897,0.8367346938775511
23705867,0,1000,989,11,0.989,0.011
18253503,1,224,8,216,0.03571428571428571,0.9642857142857143
1210303440032694272,0,162,148,14,0.9135802469135802,0.08641975308641975
3709574482,1,666,68,598,0.1021021021021021,0.8978978978978979
1453193980913532928,0,2,2,0,1.0,0.0
1518704792176058368,1,4,0,4,0.0,1.0
6041442,0,122,120,2,0.9836065573770492,0.01639344262295082
1458109852774014976,1,110,15,95,0.13636363636363635,0.8636363636363636
3321263850,0,310,309,1,0.9967741935483871,0.0032258064516129032
33100413,1,1000,135,865,0.135,0.865
1344559364,1,163,4,159,0.024539877300613498,0.9754601226993865
1477463143668322307,0,177,175,2,0.9887005649717514,0.011299435028248588
1151958853984169984,1,58,13,45,0.22413793103448276,0.7758620689655172
86446267,0,208,208,0,1.0,0.0
1237342035935399943,1,73,6,67,0.0821917808219178,0.9178082191780822
1396117163040198658,0,38,38,0,1.0,0.0
1044719214651756550,1,59,2,57,0.03389830508474576,0.9661016949152542
1529520588523544576,0,39,39,0,1.0,0.0
236075300,0,819,817,2,0.9975579975579976,0.002442002442002442
1293243157467938816,1,47,3,44,0.06382978723404255,0.9361702127659575
891676856,0,401,393,8,0.9800498753117207,0.0199501246882793
1525692957302702082,1,22,1,21,0.045454545454545456,0.9545454545454546
454435644,0,22,22,0,1.0,0.0
1059110441954099202,1,381,74,307,0.1942257217847769,0.8057742782152231
329992458,0,1000,840,160,0.84,0.16
32603596,1,1000,142,858,0.142,0.858
1149788036298956801,0,134,134,0,1.0,0.0
913215038,1,1000,174,826,0.174,0.826
764637290614427648,0,138,132,6,0.9565217391304348,0.043478260869565216
1400632087758127108,1,52,11,41,0.21153846153846154,0.7884615384615384
384096406,0,240,235,5,0.9791666666666666,0.020833333333333332
107879659,1,227,4,223,0.01762114537444934,0.9823788546255506
1464136421695004672,0,58,58,0,1.0,0.0
1277706847609380866,1,22,2,20,0.09090909090909091,0.9090909090909091
3122605953,0,19,19,0,1.0,0.0
717908646638825473,1,330,20,310,0.06060606060606061,0.9393939393939394
516033056,0,1000,992,8,0.992,0.008
331867861,1,312,25,287,0.08012820512820513,0.9198717948717948
521555481,0,522,522,0,1.0,0.0
9549942,1,1000,31,969,0.031,0.969
413519441,0,284,284,0,1.0,0.0
22568208,1,905,13,892,0.014364640883977901,0.9856353591160221
146817111,0,20,20,0,1.0,0.0
87559451,1,601,64,537,0.1064891846921797,0.8935108153078203
1130885553417850881,0,715,715,0,1.0,0.0
705232721501511680,1,75,1,74,0.013333333333333334,0.9866666666666667
1505044122817556480,0,7,7,0,1.0,0.0
761227517629960192,1,424,114,310,0.2688679245283019,0.7311320754716981
49368519,0,871,871,0,1.0,0.0
1044362088448237569,1,210,12,198,0.05714285714285714,0.9428571428571428
1238461681958711297,0,35,35,0,1.0,0.0
304440751,1,199,28,171,0.1407035175879397,0.8592964824120602
968314483654430720,0,115,111,4,0.9652173913043478,0.034782608695652174
314859160,1,1000,109,891,0.109,0.891
3188873574,0,72,72,0,1.0,0.0
1120570682,1,44,1,43,0.022727272727272728,0.9772727272727273
963283051852771332,0,1000,982,18,0.982,0.018
94012955,1,1000,197,803,0.197,0.803
2459835964,0,40,38,2,0.95,0.05
2936563329,1,93,12,81,0.12903225806451613,0.8709677419354839
963273850745212928,0,53,51,2,0.9622641509433962,0.03773584905660377
2875605627,1,144,8,136,0.05555555555555555,0.9444444444444444
81636189,0,48,48,0,1.0,0.0
746244269694869504,1,143,5,138,0.03496503496503497,0.965034965034965
879122100849651713,0,61,60,1,0.9836065573770492,0.01639344262295082
1645021687,1,96,10,86,0.10416666666666667,0.8958333333333334
633393933,0,90,86,4,0.9555555555555556,0.044444444444444446
391103508,1,516,35,481,0.06782945736434108,0.9321705426356589
1018439652049674241,0,334,324,10,0.9700598802395209,0.029940119760479042
1009834546529906689,1,217,44,173,0.20276497695852536,0.7972350230414746
1519293566597611520,0,48,48,0,1.0,0.0
1521600095996760064,1,149,8,141,0.053691275167785234,0.9463087248322147
83565167,0,166,165,1,0.9939759036144579,0.006024096385542169
1494194199796731904,1,54,27,27,0.5,0.5
1374825583595679752,0,368,324,44,0.8804347826086957,0.11956521739130435
3321590311,1,159,45,114,0.2830188679245283,0.7169811320754716
177161018,0,981,968,13,0.9867482161060143,0.013251783893985729
1416915187,1,284,16,268,0.056338028169014086,0.9436619718309859
405964124,0,61,61,0,1.0,0.0
355341859,1,803,47,756,0.058530510585305104,0.9414694894146949
1298843181685985280,0,200,126,74,0.63,0.37
1120009175558434817,1,1000,220,780,0.22,0.78
151172655,0,1000,988,12,0.988,0.012
212050676,1,1000,174,826,0.174,0.826
535559702,0,474,468,6,0.9873417721518988,0.012658227848101266
19611204,1,1000,14,986,0.014,0.986
2357418007,0,93,89,4,0.956989247311828,0.043010752688172046
2246467978,1,1000,142,858,0.142,0.858
774548696,0,656,648,8,0.9878048780487805,0.012195121951219513
353047176,1,29,9,20,0.3103448275862069,0.6896551724137931
4840960574,0,523,520,3,0.994263862332696,0.0057361376673040155
31272583,1,342,73,269,0.2134502923976608,0.7865497076023392
331887984,0,690,690,0,1.0,0.0
1216475815,1,458,31,427,0.06768558951965066,0.9323144104803494
435974202,0,88,88,0,1.0,0.0
705143617736810497,1,328,82,246,0.25,0.75
3116043939,0,349,347,2,0.994269340974212,0.0057306590257879654
23262529,1,1000,54,946,0.054,0.946
437755622,0,1000,992,8,0.992,0.008
1544369102,1,1000,211,789,0.211,0.789
1072400028,0,511,511,0,1.0,0.0
1284384108206895104,1,109,28,81,0.25688073394495414,0.7431192660550459
917774820703657985,0,360,358,2,0.9944444444444445,0.005555555555555556
15934069,1,587,33,554,0.056218057921635436,0.9437819420783645
2722922750,0,2,2,0,1.0,0.0
1422702142457061380,0,10,10,0,1.0,0.0
198505743,1,763,82,681,0.10747051114023591,0.8925294888597641
1133387941739454468,0,73,69,4,0.9452054794520548,0.0547945205479452
1631602566,1,67,8,59,0.11940298507462686,0.8805970149253731
1213763696087822337,0,16,16,0,1.0,0.0
2571366641,1,294,36,258,0.12244897959183673,0.8775510204081632
559024551,0,210,205,5,0.9761904761904762,0.023809523809523808
313998734,0,955,949,6,0.993717277486911,0.0062827225130890054
47060005,1,1000,18,982,0.018,0.982
1061744427943845888,0,28,28,0,1.0,0.0
1062449502190268416,1,366,45,321,0.12295081967213115,0.8770491803278688
1492787806749532170,0,112,112,0,1.0,0.0
787694684344811520,1,178,42,136,0.23595505617977527,0.7640449438202247
1465556600358260744,0,50,49,1,0.98,0.02
1024072637130190848,1,70,29,41,0.4142857142857143,0.5857142857142857
2457399265,0,192,189,3,0.984375,0.015625
766693903693148165,1,83,10,73,0.12048192771084337,0.8795180722891566
1004848753814265861,0,124,123,1,0.9919354838709677,0.008064516129032258
1714300352,1,291,36,255,0.12371134020618557,0.8762886597938144
720685813,0,112,111,1,0.9910714285714286,0.008928571428571428
1490130803841503232,1,31,4,27,0.12903225806451613,0.8709677419354839
1273452043,0,196,196,0,1.0,0.0
171657516,1,976,28,948,0.028688524590163935,0.9713114754098361
2243323616,0,712,708,4,0.9943820224719101,0.0056179775280898875
337467369,1,799,12,787,0.015018773466833541,0.9849812265331664
426015658,0,963,928,35,0.9636552440290758,0.036344755970924195
1370409565208989696,1,56,1,55,0.017857142857142856,0.9821428571428571
1268640781289521153,0,30,20,10,0.6666666666666666,0.3333333333333333
1004725722831728642,1,1000,212,788,0.212,0.788
538311537,0,361,361,0,1.0,0.0
1204587323196952576,1,24,5,19,0.20833333333333334,0.7916666666666666
153100707,0,430,426,4,0.9906976744186047,0.009302325581395349
1959683204,1,1000,176,824,0.176,0.824
844698897876484096,0,84,67,17,0.7976190476190477,0.20238095238095238
224464606,1,1000,90,910,0.09,0.91
778628950721376257,0,19,17,2,0.8947368421052632,0.10526315789473684
581269733,1,1000,55,945,0.055,0.945
1266498049880317953,0,310,307,3,0.9903225806451613,0.00967741935483871
258531012,1,70,2,68,0.02857142857142857,0.9714285714285714
618246752,0,1000,846,154,0.846,0.154
38189005,1,367,13,354,0.035422343324250684,0.9645776566757494
20709804,0,338,333,5,0.985207100591716,0.014792899408284023
2707057669,1,1000,194,806,0.194,0.806
48751066,0,294,265,29,0.9013605442176871,0.09863945578231292
1335117583746523139,1,20,4,16,0.2,0.8
3116085269,0,33,32,1,0.9696969696969697,0.030303030303030304
152441607,1,55,5,50,0.09090909090909091,0.9090909090909091
713395883056824320,0,104,102,2,0.9807692307692307,0.019230769230769232
1158121124225527810,1,328,61,267,0.18597560975609756,0.8140243902439024
1508215502090371076,0,62,50,12,0.8064516129032258,0.1935483870967742
915230406,1,713,76,637,0.10659186535764376,0.8934081346423562
1448829917752438796,0,59,59,0,1.0,0.0
1106441388902612993,1,108,14,94,0.12962962962962962,0.8703703703703703
331403342,0,1000,999,1,0.999,0.001
338090924,1,258,16,242,0.06201550387596899,0.937984496124031
1098922345,0,60,60,0,1.0,0.0
1118276001841025025,1,231,17,214,0.0735930735930736,0.9264069264069265
1415550490302111747,0,1,1,0,1.0,0.0
33099924,0,28,28,0,1.0,0.0
3254924162,1,1000,95,905,0.095,0.905
1007869094287331328,0,203,179,24,0.8817733990147784,0.11822660098522167
763853657532010496,1,87,4,83,0.04597701149425287,0.9540229885057471
885585964592246784,0,4,4,0,1.0,0.0
3438247900,1,1000,105,895,0.105,0.895
1235800641613770753,0,17,17,0,1.0,0.0
21551286,1,301,37,264,0.12292358803986711,0.8770764119601329
979113368048029697,0,1000,997,3,0.997,0.003
147986321,1,371,5,366,0.013477088948787063,0.9865229110512129
1439354003972780032,0,260,245,15,0.9423076923076923,0.057692307692307696
1335792424724074499,1,1000,118,882,0.118,0.882
383528563,0,1000,807,193,0.807,0.193
16521080,1,1000,107,893,0.107,0.893
43477141,0,158,157,1,0.9936708860759493,0.006329113924050633
1191460597776494594,1,443,87,356,0.1963882618510158,0.8036117381489842
1466557856820482052,0,1000,999,1,0.999,0.001
336328303,1,222,15,207,0.06756756756756757,0.9324324324324325
402932308,0,80,77,3,0.9625,0.0375
2254381730,1,750,253,497,0.3373333333333333,0.6626666666666666
218373284,0,5,5,0,1.0,0.0
1470795895809753089,1,12,2,10,0.16666666666666666,0.8333333333333334
760510725987020800,0,203,203,0,1.0,0.0
790546436777803776,1,966,115,851,0.11904761904761904,0.8809523809523809
732177674,0,312,312,0,1.0,0.0
1147647994499686402,1,156,3,153,0.019230769230769232,0.9807692307692307
832385195890184192,0,2,2,0,1.0,0.0
1049164759130492929,1,1000,120,880,0.12,0.88
1413834286621470723,0,112,110,2,0.9821428571428571,0.017857142857142856
882819891123900416,1,231,20,211,0.08658008658008658,0.9134199134199135
717432691390554113,0,501,497,4,0.9920159680638723,0.007984031936127744
1361080760908861440,1,47,5,42,0.10638297872340426,0.8936170212765957
57223128,0,1000,999,1,0.999,0.001
48882852,1,120,5,115,0.041666666666666664,0.9583333333333334
2244759081,0,1000,1000,0,1.0,0.0
1354758323896283139,1,1000,208,792,0.208,0.792
1250099461,0,1000,991,9,0.991,0.009
15456294,1,473,36,437,0.07610993657505286,0.9238900634249472
1467516928969392135,0,24,24,0,1.0,0.0
169540133,1,85,2,83,0.023529411764705882,0.9764705882352941
1538651813762719745,0,185,185,0,1.0,0.0
290693757,1,315,42,273,0.13333333333333333,0.8666666666666667
1324184796625600512,0,22,22,0,1.0,0.0
719625057270689794,1,483,58,425,0.12008281573498965,0.8799171842650103
710672634078498818,0,174,174,0,1.0,0.0
1349186506401918979,1,15,2,13,0.13333333333333333,0.8666666666666667
298354464,0,1000,988,12,0.988,0.012
3766156273,1,613,14,599,0.022838499184339316,0.9771615008156607
1168382676,0,13,13,0,1.0,0.0
913543635202748416,1,105,3,102,0.02857142857142857,0.9714285714285714
1084822052,1,1000,139,861,0.139,0.861
729911904244740096,0,63,63,0,1.0,0.0
2699348077,1,742,57,685,0.07681940700808626,0.9231805929919138
1003806486928257025,0,1000,992,8,0.992,0.008
884227505967837185,1,36,6,30,0.16666666666666666,0.8333333333333334
1345029204707074048,0,84,84,0,1.0,0.0
379352220,1,699,182,517,0.2603719599427754,0.7396280400572246
4484070742,0,26,26,0,1.0,0.0
1225901426955689984,1,41,20,21,0.4878048780487805,0.5121951219512195
1358559027463131136,0,40,40,0,1.0,0.0
17177346,1,1000,70,930,0.07,0.93
83268182,0,121,119,2,0.9834710743801653,0.01652892561983471
178084974,1,1000,44,956,0.044,0.956
1072328875840016384,0,49,48,1,0.9795918367346939,0.02040816326530612
761745034240679936,1,125,10,115,0.08,0.92
226763746,0,1000,999,1,0.999,0.001
872755050187292672,1,991,305,686,0.3077699293642785,0.6922300706357215
825670811977670656,0,22,22,0,1.0,0.0
1395890224417308675,1,142,36,106,0.2535211267605634,0.7464788732394366
230011669,0,10,10,0,1.0,0.0
1151423952495005696,1,40,10,30,0.25,0.75
431031582,0,30,30,0,1.0,0.0
1323249435174932480,1,438,28,410,0.0639269406392694,0.9360730593607306
2603499037,0,309,301,8,0.9741100323624595,0.025889967637540454
457522529,1,419,7,412,0.016706443914081145,0.9832935560859188
259847532,0,1000,937,63,0.937,0.063
22277496,1,1000,176,824,0.176,0.824
901116841782849536,0,1,1,0,1.0,0.0
35838366,1,592,15,577,0.02533783783783784,0.9746621621621622
1195735648860286976,0,1000,972,28,0.972,0.028
1325739852,1,278,7,271,0.025179856115107913,0.9748201438848921
968027286065721344,0,1000,1000,0,1.0,0.0
583388476,1,205,12,193,0.05853658536585366,0.9414634146341463
174812599,1,173,32,141,0.18497109826589594,0.815028901734104
1051247715538092035,0,24,23,1,0.9583333333333334,0.041666666666666664
1129900633,1,100,1,99,0.01,0.99
178979990,0,241,240,1,0.995850622406639,0.004149377593360996
14463265,1,593,14,579,0.023608768971332208,0.9763912310286678
796352246891982849,0,368,328,40,0.8913043478260869,0.10869565217391304
3245024712,1,125,29,96,0.232,0.768
882687637861085186,0,109,109,0,1.0,0.0
953150173,1,22,3,19,0.13636363636363635,0.8636363636363636
284900123,0,872,870,2,0.9977064220183486,0.0022935779816513763
854407740843839489,1,176,15,161,0.08522727272727272,0.9147727272727273
1327821950,0,25,25,0,1.0,0.0
2743259549,1,344,66,278,0.19186046511627908,0.8081395348837209
2528708413,0,88,86,2,0.9772727272727273,0.022727272727272728
474223003,1,284,13,271,0.045774647887323945,0.954225352112676
1267979293818335232,0,7,7,0,1.0,0.0
8891142,1,97,8,89,0.08247422680412371,0.9175257731958762
799976305802510336,0,8,8,0,1.0,0.0
1398497413116092423,1,187,17,170,0.09090909090909091,0.9090909090909091
1278088483555418114,0,33,33,0,1.0,0.0
881015370,1,91,12,79,0.13186813186813187,0.8681318681318682
2446863551,0,300,299,1,0.9966666666666667,0.0033333333333333335
977242068,1,323,27,296,0.08359133126934984,0.9164086687306502
1341312135293448193,0,80,80,0,1.0,0.0
481535880,1,596,33,563,0.05536912751677853,0.9446308724832215
1390159666907205632,0,394,394,0,1.0,0.0
290143004,1,1000,134,866,0.134,0.866
789875655261290496,0,90,90,0,1.0,0.0
1320566745468461057,1,115,36,79,0.3130434782608696,0.6869565217391305
1055196143645327360,0,19,19,0,1.0,0.0
4040866152,1,90,20,70,0.2222222222222222,0.7777777777777778
960813146,0,311,311,0,1.0,0.0
1153008896,1,180,20,160,0.1111111111111111,0.8888888888888888
854706360524701698,0,1000,974,26,0.974,0.026
2163648566,1,337,24,313,0.0712166172106825,0.9287833827893175
2280517559,0,317,317,0,1.0,0.0
1020389356631097344,1,19,5,14,0.2631578947368421,0.7368421052631579
999886684870270976,0,261,261,0,1.0,0.0
1121459578921787393,1,172,21,151,0.12209302325581395,0.877906976744186
1462779922653618179,1,43,15,28,0.3488372093023256,0.6511627906976745
455744824,0,46,46,0,1.0,0.0
3213619622,1,46,8,38,0.17391304347826086,0.8260869565217391
542577518,0,784,775,9,0.9885204081632653,0.011479591836734694
30395052,1,151,11,140,0.0728476821192053,0.9271523178807947
701596259048673280,0,1000,1000,0,1.0,0.0
1558922516,1,331,43,288,0.1299093655589124,0.8700906344410876
2266389122,0,362,353,9,0.9751381215469613,0.024861878453038673
4715793317,1,1000,352,648,0.352,0.648
1482989323737776130,0,13,13,0,1.0,0.0
1205250235,1,184,12,172,0.06521739130434782,0.9347826086956522
1520324449,0,278,276,2,0.9928057553956835,0.007194244604316547
722198729227419648,1,1000,59,941,0.059,0.941
1190282165373800450,0,405,405,0,1.0,0.0
3256864160,1,1000,208,792,0.208,0.792
1478094594,0,1000,999,1,0.999,0.001
1329307618720980992,1,49,12,37,0.24489795918367346,0.7551020408163265
4553775134,0,200,198,2,0.99,0.01
2843939932,1,61,16,45,0.26229508196721313,0.7377049180327869
3293040365,0,15,15,0,1.0,0.0
524893985,1,196,14,182,0.07142857142857142,0.9285714285714286
510895354,0,152,148,4,0.9736842105263158,0.02631578947368421
296876063,1,431,17,414,0.03944315545243619,0.9605568445475638
730709990202322944,0,269,267,2,0.9925650557620818,0.007434944237918215
19384205,1,286,34,252,0.11888111888111888,0.8811188811188811
1239566411652952066,0,8,8,0,1.0,0.0
1043958186196324352,1,32,8,24,0.25,0.75
1481811826664898563,0,249,249,0,1.0,0.0
878722410,1,790,198,592,0.25063291139240507,0.7493670886075949
551299840,0,998,957,41,0.9589178356713427,0.041082164328657314
1195148863,1,649,67,582,0.10323574730354391,0.8967642526964561
4395520816,0,215,206,9,0.958139534883721,0.04186046511627907
63604937,0,518,516,2,0.9961389961389961,0.003861003861003861
313013633,1,103,40,63,0.3883495145631068,0.6116504854368932
964896297214881792,0,59,59,0,1.0,0.0
268571532,1,228,18,210,0.07894736842105263,0.9210526315789473
1917861193,0,769,769,0,1.0,0.0
1381562767254159364,0,58,58,0,1.0,0.0
1368368266331123713,0,10,9,1,0.9,0.1
1209643560686874624,1,87,5,82,0.05747126436781609,0.9425287356321839
3065542602,0,65,65,0,1.0,0.0
43217183,1,1000,271,729,0.271,0.729
221981446,0,551,544,7,0.9872958257713249,0.012704174228675136
250740723,1,57,0,57,0.0,1.0
1436167981050916874,0,65,65,0,1.0,0.0
798947338421207042,1,82,4,78,0.04878048780487805,0.9512195121951219
710407046,0,58,58,0,1.0,0.0
15345593,1,1000,67,933,0.067,0.933
993984937219928065,0,64,64,0,1.0,0.0
535021279,1,48,1,47,0.020833333333333332,0.9791666666666666
2883512854,0,11,11,0,1.0,0.0
891512122089259008,1,995,122,873,0.12261306532663317,0.8773869346733668
1518631970174947329,0,13,13,0,1.0,0.0
406340450,1,983,165,818,0.167853509664293,0.832146490335707
1288143075521581056,0,42,42,0,1.0,0.0
20440473,1,722,88,634,0.12188365650969529,0.8781163434903048
1098081784963698688,0,124,124,0,1.0,0.0
1020306754729594880,1,617,79,538,0.1280388978930308,0.8719611021069692
1213538493504221185,0,1000,923,77,0.923,0.077
1193331896622534656,1,605,95,510,0.15702479338842976,0.8429752066115702
30135443,0,576,563,13,0.9774305555555556,0.022569444444444444
89812426,1,283,16,267,0.05653710247349823,0.9434628975265018
1370566894990680065,0,1000,999,1,0.999,0.001
443231714,1,428,1,427,0.002336448598130841,0.9976635514018691
3021466285,0,117,117,0,1.0,0.0
728679410551885824,1,498,96,402,0.1927710843373494,0.8072289156626506
1179708676367699969,0,164,142,22,0.8658536585365854,0.13414634146341464
1237948453574987776,1,26,0,26,0.0,1.0
967476931,0,578,577,1,0.9982698961937716,0.0017301038062283738
24036128,1,717,22,695,0.030683403068340307,0.9693165969316597
369835967,0,62,62,0,1.0,0.0
1518373867,1,577,5,572,0.008665511265164644,0.9913344887348353
1184660400689700864,0,7,7,0,1.0,0.0
158189078,1,1000,107,893,0.107,0.893
1192867734607937536,0,10,10,0,1.0,0.0
1404534858265731073,1,123,20,103,0.16260162601626016,0.8373983739837398
1149019109205696513,0,332,324,8,0.9759036144578314,0.024096385542168676
1170014860530343936,1,28,6,22,0.21428571428571427,0.7857142857142857
723016230483857409,0,58,52,6,0.896551724137931,0.10344827586206896
2744011072,1,27,1,26,0.037037037037037035,0.9629629629629629
2933666055,0,312,309,3,0.9903846153846154,0.009615384615384616
3240452828,1,363,68,295,0.18732782369146006,0.8126721763085399
255704766,0,76,76,0,1.0,0.0
2394996979,1,1000,29,971,0.029,0.971
1486526196,0,188,187,1,0.9946808510638298,0.005319148936170213
2159807059,1,106,22,84,0.20754716981132076,0.7924528301886793
1851920137,0,903,903,0,1.0,0.0
52674596,1,430,18,412,0.04186046511627907,0.958139534883721
61194554,0,273,273,0,1.0,0.0
1191783069126144000,1,46,3,43,0.06521739130434782,0.9347826086956522
152420430,0,54,54,0,1.0,0.0
1277718771793346561,1,37,4,33,0.10810810810810811,0.8918918918918919
512777314,0,1000,1000,0,1.0,0.0
1204175558067834880,0,191,190,1,0.9947643979057592,0.005235602094240838
1290475821950435328,1,5,2,3,0.4,0.6
65661935,0,1000,987,13,0.987,0.013
1389584478125887492,1,369,92,277,0.24932249322493225,0.7506775067750677
1525494009166282755,0,54,54,0,1.0,0.0
153273235,1,403,1,402,0.0024813895781637717,0.9975186104218362
70436560,0,1000,1000,0,1.0,0.0
1016118811471286279,1,214,22,192,0.102803738317757,0.897196261682243
577014872,0,26,26,0,1.0,0.0
1287006793483206656,1,70,28,42,0.4,0.6
796331915674521601,0,46,46,0,1.0,0.0
3235571258,1,257,63,194,0.245136186770428,0.754863813229572
1484118695563735042,0,1000,1000,0,1.0,0.0
35606176,1,208,16,192,0.07692307692307693,0.9230769230769231
882837969673039872,0,1000,999,1,0.999,0.001
14336906,1,1000,65,935,0.065,0.935
1213718964,0,34,34,0,1.0,0.0
171099924,1,363,13,350,0.03581267217630854,0.9641873278236914
1511479436809543685,0,26,26,0,1.0,0.0
1367974512,1,131,2,129,0.015267175572519083,0.9847328244274809
1042384307925475328,0,63,61,2,0.9682539682539683,0.031746031746031744
2865250312,1,310,62,248,0.2,0.8
3255275558,0,145,135,10,0.9310344827586207,0.06896551724137931
30519669,1,215,3,212,0.013953488372093023,0.986046511627907
1510868553863471107,0,1000,990,10,0.99,0.01
22886519,1,193,4,189,0.02072538860103627,0.9792746113989638
1473533769047056387,0,117,117,0,1.0,0.0
770044804063428608,1,190,22,168,0.11578947368421053,0.8842105263157894
919584956225150978,0,200,194,6,0.97,0.03
19618453,1,550,20,530,0.03636363636363636,0.9636363636363636
758205957444894720,0,51,49,2,0.9607843137254902,0.0392156862745098
151678998,1,143,11,132,0.07692307692307693,0.9230769230769231
58372558,1,1000,80,920,0.08,0.92
1262220365956251648,0,18,18,0,1.0,0.0
1003489846445400064,1,456,38,418,0.08333333333333333,0.9166666666666666
1449119820503466076,0,249,249,0,1.0,0.0
729241415478173697,1,17,3,14,0.17647058823529413,0.8235294117647058
65822355,0,25,25,0,1.0,0.0
1571350670,1,578,63,515,0.10899653979238755,0.8910034602076125
1476843956625281027,0,14,11,3,0.7857142857142857,0.21428571428571427
1613785028,1,238,26,212,0.1092436974789916,0.8907563025210085
891679657996808192,0,24,24,0,1.0,0.0
1052979420820987904,1,157,16,141,0.10191082802547771,0.8980891719745223
1019350403496980480,0,54,54,0,1.0,0.0
1254940247911280642,1,40,11,29,0.275,0.725
54262901,0,316,286,30,0.9050632911392406,0.0949367088607595
819756675070468096,1,102,14,88,0.13725490196078433,0.8627450980392157
1274066358003736579,0,172,169,3,0.9825581395348837,0.01744186046511628
90732481,1,126,23,103,0.18253968253968253,0.8174603174603174
15883,0,358,348,10,0.9720670391061452,0.027932960893854747
1541947898,1,1000,83,917,0.083,0.917
4912833314,0,17,17,0,1.0,0.0
2559351940,1,384,6,378,0.015625,0.984375
1437493161899618306,0,114,110,4,0.9649122807017544,0.03508771929824561
2202222643,1,1000,83,917,0.083,0.917
266386771,0,39,36,3,0.9230769230769231,0.07692307692307693
1298989639450021894,1,72,15,57,0.20833333333333334,0.7916666666666666
3286533660,0,359,359,0,1.0,0.0
878651709312180227,1,704,128,576,0.18181818181818182,0.8181818181818182
4839912429,0,51,51,0,1.0,0.0
1325639348,1,483,47,436,0.09730848861283643,0.9026915113871635
1489021305697542148,0,3,3,0,1.0,0.0
4017694671,1,553,62,491,0.11211573236889692,0.8878842676311031
1267586139487186945,0,22,22,0,1.0,0.0
147048800,1,51,2,49,0.0392156862745098,0.9607843137254902
753503067123752960,0,263,249,14,0.9467680608365019,0.053231939163498096
14312426,1,152,14,138,0.09210526315789473,0.9078947368421053
3300677751,0,1000,1000,0,1.0,0.0
22440976,1,484,16,468,0.03305785123966942,0.9669421487603306
454064440,0,505,504,1,0.998019801980198,0.0019801980198019802
2292490900,1,89,16,73,0.1797752808988764,0.8202247191011236
16264003,0,1000,989,11,0.989,0.011
1967987438,1,319,12,307,0.03761755485893417,0.9623824451410659
493178899,0,1000,987,13,0.987,0.013
731706766103183360,0,229,225,4,0.982532751091703,0.017467248908296942
1275901518,1,1000,60,940,0.06,0.94
149730682,0,159,157,2,0.9874213836477987,0.012578616352201259
937431143783137280,1,43,8,35,0.18604651162790697,0.813953488372093
3248383566,0,936,928,8,0.9914529914529915,0.008547008547008548
3011301387,0,147,146,1,0.9931972789115646,0.006802721088435374
2393575453,1,689,89,600,0.12917271407837447,0.8708272859216255
1175786273547706369,0,156,156,0,1.0,0.0
1304447724075483136,1,168,45,123,0.26785714285714285,0.7321428571428571
366258895,0,604,603,1,0.9983443708609272,0.0016556291390728477
1262824047378907142,1,79,10,69,0.12658227848101267,0.8734177215189873
891484309013639169,0,120,110,10,0.9166666666666666,0.08333333333333333
1591870320,1,392,88,304,0.22448979591836735,0.7755102040816326
780518611282604032,0,273,251,22,0.9194139194139194,0.08058608058608059
764097834,1,1000,139,861,0.139,0.861
1326063255366766594,0,10,10,0,1.0,0.0
15378205,1,164,22,142,0.13414634146341464,0.8658536585365854
145771751,0,232,230,2,0.9913793103448276,0.008620689655172414
1380190809518075905,0,22,16,6,0.7272727272727273,0.2727272727272727
1157715724053426176,1,75,5,70,0.06666666666666667,0.9333333333333333
783202692,0,564,554,10,0.9822695035460993,0.01773049645390071
790696760427544576,1,197,28,169,0.14213197969543148,0.8578680203045685
1315564302292660226,0,580,580,0,1.0,0.0
75727206,1,38,0,38,0.0,1.0
1162220798268116992,0,9,9,0,1.0,0.0
1336023839151697924,1,30,1,29,0.03333333333333333,0.9666666666666667
1418691109954392064,0,521,385,136,0.7389635316698656,0.26103646833013433
883015255315685377,1,501,73,428,0.14570858283433133,0.8542914171656687
309258048,0,188,188,0,1.0,0.0
1089955918383595520,1,1000,32,968,0.032,0.968
1386500941692735488,0,24,24,0,1.0,0.0
502169924,1,1000,114,886,0.114,0.886
2498893627,0,1000,995,5,0.995,0.005
1090570214125854720,1,55,10,45,0.18181818181818182,0.8181818181818182
250690720,0,1000,968,32,0.968,0.032
1253425785043513345,1,293,57,236,0.1945392491467577,0.8054607508532423
3315465113,0,1000,976,24,0.976,0.024
1470459751972712454,1,62,8,54,0.12903225806451613,0.8709677419354839
1009826686622490624,0,68,63,5,0.9264705882352942,0.07352941176470588
196071010,1,208,61,147,0.2932692307692308,0.7067307692307693
3689409083,0,7,7,0,1.0,0.0
32177640,1,81,23,58,0.2839506172839506,0.7160493827160493
2801978393,0,172,163,9,0.9476744186046512,0.05232558139534884
22596900,1,72,2,70,0.027777777777777776,0.9722222222222222
16400388,0,1000,869,131,0.869,0.131
704556928974729216,1,919,75,844,0.08161044613710555,0.9183895538628944
166821728,0,63,63,0,1.0,0.0
873426927020908544,1,623,23,600,0.03691813804173355,0.9630818619582665
3515275889,0,135,120,15,0.8888888888888888,0.1111111111111111
6488652,1,586,73,513,0.12457337883959044,0.8754266211604096
18098842,0,109,109,0,1.0,0.0
563761522,0,968,966,2,0.9979338842975206,0.002066115702479339
427209840,1,41,17,24,0.4146341463414634,0.5853658536585366
145036955,0,1000,964,36,0.964,0.036
280239318,1,979,243,736,0.24821246169560776,0.7517875383043923
1166903425205985280,0,228,223,5,0.9780701754385965,0.021929824561403508
288260844,1,1000,150,850,0.15,0.85
963189636,0,63,54,9,0.8571428571428571,0.14285714285714285
1281014489538801664,1,87,11,76,0.12643678160919541,0.8735632183908046
1266192742704693250,0,249,249,0,1.0,0.0
4835230713,1,388,14,374,0.03608247422680412,0.9639175257731959
1669085592,0,11,11,0,1.0,0.0
55743392,1,215,13,202,0.06046511627906977,0.9395348837209302
1501967048938770437,0,4,4,0,1.0,0.0
1503620016138194951,1,19,7,12,0.3684210526315789,0.631578947368421
3077564836,0,135,135,0,1.0,0.0
1447245336976637952,1,1000,59,941,0.059,0.941
3040273426,0,562,556,6,0.9893238434163701,0.010676156583629894
894077528414892032,1,70,21,49,0.3,0.7
2805072513,0,357,304,53,0.8515406162464986,0.1484593837535014
1518779298190020609,1,74,19,55,0.25675675675675674,0.7432432432432432
25846504,0,1000,901,99,0.901,0.099
769376991631908864,1,1000,249,751,0.249,0.751
1123711349396316163,0,1000,998,2,0.998,0.002
351671109,0,232,228,4,0.9827586206896551,0.017241379310344827
1218308893635481608,1,76,5,71,0.06578947368421052,0.9342105263157895
1266945778234396678,0,22,19,3,0.8636363636363636,0.13636363636363635
14139671,1,1000,68,932,0.068,0.932
42725889,0,42,42,0,1.0,0.0
602841121,1,13,1,12,0.07692307692307693,0.9230769230769231
22286059,0,296,296,0,1.0,0.0
454851514,1,443,27,416,0.060948081264108354,0.9390519187358917
780315880886562816,0,19,19,0,1.0,0.0
1378723657099456522,1,39,10,29,0.2564102564102564,0.7435897435897436
895711858925092864,0,442,442,0,1.0,0.0
1118664445306097665,1,177,10,167,0.05649717514124294,0.943502824858757
2913073285,0,293,293,0,1.0,0.0
14223057,1,738,85,653,0.11517615176151762,0.8848238482384824
280782020,0,1000,995,5,0.995,0.005
4553736734,1,132,7,125,0.05303030303030303,0.946969696969697
1421252408819294213,0,12,12,0,1.0,0.0
14655776,1,901,38,863,0.042175360710321866,0.9578246392896781
1148653966818861056,0,217,192,25,0.8847926267281107,0.1152073732718894
36021947,0,1000,992,8,0.992,0.008
1383838426802266124,0,6,6,0,1.0,0.0
50543729,1,815,13,802,0.015950920245398775,0.9840490797546012
790399954472755200,0,663,662,1,0.9984917043740573,0.0015082956259426848
2674493077,1,1000,351,649,0.351,0.649
560650220,0,130,130,0,1.0,0.0
1165742891068620800,1,81,19,62,0.2345679012345679,0.7654320987654321
1245493944,0,4,4,0,1.0,0.0
998314828904124416,1,196,25,171,0.12755102040816327,0.8724489795918368
743113831744962562,0,91,89,2,0.978021978021978,0.02197802197802198
1147683961084112897,1,595,49,546,0.08235294117647059,0.9176470588235294
27423658,0,22,22,0,1.0,0.0
2891763990,1,646,18,628,0.02786377708978328,0.9721362229102167
26591559,0,533,520,13,0.975609756097561,0.024390243902439025
273649970,1,243,11,232,0.04526748971193416,0.9547325102880658
43616915,0,362,362,0,1.0,0.0
420126989,1,1000,72,928,0.072,0.928
1081050731694706688,0,1000,980,20,0.98,0.02
29866870,1,636,15,621,0.02358490566037736,0.9764150943396226
1505675078327050244,0,199,159,40,0.7989949748743719,0.20100502512562815
270077675,1,590,21,569,0.03559322033898305,0.964406779661017
409018890,0,891,884,7,0.9921436588103255,0.007856341189674524
1206080636093685760,1,419,118,301,0.28162291169451076,0.7183770883054893
97023262,0,366,365,1,0.9972677595628415,0.00273224043715847
147391484,0,1000,994,6,0.994,0.006
717029215946715136,1,180,48,132,0.26666666666666666,0.7333333333333333
16136273,0,1000,981,19,0.981,0.019
24866015,1,357,3,354,0.008403361344537815,0.9915966386554622
1724075418,0,1000,975,25,0.975,0.025
368013519,1,337,36,301,0.10682492581602374,0.8931750741839762
186863396,0,1000,963,37,0.963,0.037
1151897497,1,205,15,190,0.07317073170731707,0.926829268292683
3196766154,0,159,157,2,0.9874213836477987,0.012578616352201259
799226618292109312,1,801,261,540,0.3258426966292135,0.6741573033707865
1147194732,1,12,3,9,0.25,0.75
825153313746231297,0,971,970,1,0.9989701338825953,0.0010298661174047373
3182268397,1,213,91,122,0.4272300469483568,0.5727699530516432
1179835022380953600,0,30,18,12,0.6,0.4
1545724988,1,511,25,486,0.04892367906066536,0.9510763209393346
1723235412,0,102,102,0,1.0,0.0
105965228,1,1000,172,828,0.172,0.828
1250356820960350214,0,283,283,0,1.0,0.0
1443149412805459968,1,103,8,95,0.07766990291262135,0.9223300970873787
868955443510562817,0,202,185,17,0.9158415841584159,0.08415841584158416
3302518024,0,75,74,1,0.9866666666666667,0.013333333333333334
854762893,1,1000,140,860,0.14,0.86
1528689758888677378,0,139,128,11,0.920863309352518,0.07913669064748201
17690323,1,164,8,156,0.04878048780487805,0.9512195121951219
781472774334341120,0,298,296,2,0.9932885906040269,0.006711409395973154
33014957,1,748,11,737,0.014705882352941176,0.9852941176470589
1925451134,0,1000,985,15,0.985,0.015
20152038,0,1000,970,30,0.97,0.03
3012744828,1,73,28,45,0.3835616438356164,0.6164383561643836
2269457246,0,50,50,0,1.0,0.0
1408456971360014346,1,68,14,54,0.20588235294117646,0.7941176470588235
1317395965,0,162,162,0,1.0,0.0
196452940,1,1000,35,965,0.035,0.965
104634898,0,541,541,0,1.0,0.0
715999695563264000,1,631,244,387,0.3866877971473851,0.6133122028526149
1346252363460390913,0,5,5,0,1.0,0.0
1455601371588272139,1,29,7,22,0.2413793103448276,0.7586206896551724
616835376,0,1000,998,2,0.998,0.002
3311001543,1,204,3,201,0.014705882352941176,0.9852941176470589
1269114974573477888,0,145,136,9,0.9379310344827586,0.06206896551724138
1360240813117083657,1,857,62,795,0.07234539089848308,0.9276546091015169
820336029710295040,0,193,192,1,0.9948186528497409,0.0051813471502590676
865259534931025920,1,494,104,390,0.21052631578947367,0.7894736842105263
746396851,0,505,500,5,0.9900990099009901,0.009900990099009901
63757504,1,505,60,445,0.1188118811881188,0.8811881188118812
346146344,0,611,593,18,0.9705400981996727,0.029459901800327332
1278412961464320002,0,28,28,0,1.0,0.0
2196601357,1,279,32,247,0.11469534050179211,0.8853046594982079
1170928894209216513,0,6,6,0,1.0,0.0
960657815349153792,1,1000,61,939,0.061,0.939
120165107,0,825,825,0,1.0,0.0
14668539,1,480,93,387,0.19375,0.80625
1450268111207272450,0,907,861,46,0.9492833517089305,0.050716648291069456
1111967147343921152,1,109,14,95,0.12844036697247707,0.8715596330275229
619716716,0,403,398,5,0.9875930521091811,0.01240694789081886
2572832903,1,156,15,141,0.09615384615384616,0.9038461538461539
24688387,0,152,152,0,1.0,0.0
433664348,1,1000,187,813,0.187,0.813
164545652,0,133,132,1,0.9924812030075187,0.007518796992481203
971894359904800769,1,19,2,17,0.10526315789473684,0.8947368421052632
634274273,0,589,588,1,0.99830220713073,0.001697792869269949
1567003687,1,968,14,954,0.014462809917355372,0.9855371900826446
2919502250,0,237,237,0,1.0,0.0
2432805613,1,1000,139,861,0.139,0.861
1730219407,0,167,167,0,1.0,0.0
2611157977,1,655,47,608,0.0717557251908397,0.9282442748091603
1190759832833449984,0,33,33,0,1.0,0.0
1155825009753042945,1,84,12,72,0.14285714285714285,0.8571428571428571
2397366572,0,319,302,17,0.9467084639498433,0.05329153605015674
1433151974338334729,1,137,29,108,0.2116788321167883,0.7883211678832117
1462718469112307713,0,1000,1000,0,1.0,0.0
1287505427077517312,1,1000,124,876,0.124,0.876
22643168,0,64,63,1,0.984375,0.015625
905972568917557248,1,12,0,12,0.0,1.0
948634516540637185,0,22,22,0,1.0,0.0
1523678068476317697,1,1000,12,988,0.012,0.988
1448472822129430531,0,254,241,13,0.9488188976377953,0.051181102362204724
49522413,0,1000,996,4,0.996,0.004
784234627699466240,1,211,34,177,0.16113744075829384,0.8388625592417062
897159062709821440,0,994,993,1,0.9989939637826962,0.001006036217303823
3302690568,1,239,68,171,0.28451882845188287,0.7154811715481172
769935436575870977,0,47,45,2,0.9574468085106383,0.0425531914893617
705469455246032896,1,104,4,100,0.038461538461538464,0.9615384615384616
1149741537208627201,0,141,140,1,0.9929078014184397,0.0070921985815602835
212689480,1,1000,163,837,0.163,0.837
879156050804461568,1,122,42,80,0.3442622950819672,0.6557377049180327
1216938068827168772,0,431,428,3,0.9930394431554525,0.0069605568445475635
2187212982,1,648,5,643,0.007716049382716049,0.9922839506172839
1478698921,0,1000,991,9,0.991,0.009
19070077,1,79,8,71,0.10126582278481013,0.8987341772151899
1414225182462410755,0,263,254,9,0.9657794676806084,0.034220532319391636
41441903,1,204,72,132,0.35294117647058826,0.6470588235294118
2272565912,0,404,399,5,0.9876237623762376,0.012376237623762377
2946947340,1,277,26,251,0.09386281588447654,0.9061371841155235
1047625326925418625,1,83,12,71,0.14457831325301204,0.8554216867469879
27651104,0,386,382,4,0.9896373056994818,0.010362694300518135
4800841523,1,414,125,289,0.30193236714975846,0.6980676328502415
4671153414,0,1000,1000,0,1.0,0.0
213563361,1,273,12,261,0.04395604395604396,0.9560439560439561
555609932,0,279,278,1,0.996415770609319,0.0035842293906810036
946164992,1,1000,258,742,0.258,0.742
1100657587064897537,0,138,134,4,0.9710144927536232,0.028985507246376812
101026279,1,266,105,161,0.39473684210526316,0.6052631578947368
1022423883935358976,0,113,113,0,1.0,0.0
2389522089,1,66,6,60,0.09090909090909091,0.9090909090909091
1040322216498483200,0,11,9,2,0.8181818181818182,0.18181818181818182
1176634198641168384,1,84,3,81,0.03571428571428571,0.9642857142857143
1516258628940046337,0,1000,999,1,0.999,0.001
90298112,1,54,11,43,0.2037037037037037,0.7962962962962963
87719608,0,463,458,5,0.9892008639308856,0.01079913606911447
1483706893801566209,1,57,2,55,0.03508771929824561,0.9649122807017544
2326433232,0,260,236,24,0.9076923076923077,0.09230769230769231
1030077917945053184,0,78,77,1,0.9871794871794872,0.01282051282051282
1674117320,1,26,8,18,0.3076923076923077,0.6923076923076923
23403675,0,1000,992,8,0.992,0.008
890663628793413633,0,255,252,3,0.9882352941176471,0.011764705882352941
49850871,1,1000,86,914,0.086,0.914
1471585574700081156,0,1000,974,26,0.974,0.026
1310234119,1,41,6,35,0.14634146341463414,0.8536585365853658
4115410996,0,67,66,1,0.9850746268656716,0.014925373134328358
15801821,1,428,26,402,0.06074766355140187,0.9392523364485982
2437744764,0,1000,999,1,0.999,0.001
38534555,0,334,333,1,0.9970059880239521,0.0029940119760479044
85742010,1,316,54,262,0.17088607594936708,0.8291139240506329
812501750091386880,0,925,924,1,0.9989189189189189,0.001081081081081081
3590013735,1,81,2,79,0.024691358024691357,0.9753086419753086
1912334108,1,238,21,217,0.08823529411764706,0.9117647058823529
1261024650760503296,0,3,3,0,1.0,0.0
502339678,1,928,4,924,0.004310344827586207,0.9956896551724138
887007380881502210,0,20,20,0,1.0,0.0
1380681203385315329,1,15,2,13,0.13333333333333333,0.8666666666666667
1317504626527150080,0,1000,993,7,0.993,0.007
14880092,1,357,27,330,0.07563025210084033,0.9243697478991597
2293657020,0,515,427,88,0.829126213592233,0.170873786407767
557249887,1,265,6,259,0.022641509433962263,0.9773584905660377
45891844,0,246,243,3,0.9878048780487805,0.012195121951219513
66776059,1,1000,161,839,0.161,0.839
1331377811920138241,0,2,2,0,1.0,0.0
1303075988,1,34,8,26,0.23529411764705882,0.7647058823529411
187667902,0,418,413,5,0.9880382775119617,0.011961722488038277
1890641318,1,975,203,772,0.2082051282051282,0.7917948717948718
78696972,0,1000,1000,0,1.0,0.0
1111413666254123008,1,212,46,166,0.2169811320754717,0.7830188679245284
577140055,0,263,259,4,0.9847908745247148,0.015209125475285171
759430828329955328,1,89,18,71,0.20224719101123595,0.797752808988764
953699863933448197,0,513,506,7,0.98635477582846,0.01364522417153996
1679975226,1,698,223,475,0.3194842406876791,0.6805157593123209
404296626,0,1000,977,23,0.977,0.023
51975372,1,562,80,482,0.1423487544483986,0.8576512455516014
3350439143,0,173,173,0,1.0,0.0
3307683641,1,21,1,20,0.047619047619047616,0.9523809523809523
1097594882,0,360,358,2,0.9944444444444445,0.005555555555555556
1510667835844046855,1,16,6,10,0.375,0.625
14941140,0,1000,987,13,0.987,0.013
1360094540477190145,1,243,16,227,0.06584362139917696,0.934156378600823
588314300,0,508,506,2,0.9960629921259843,0.003937007874015748
1934469799,0,881,842,39,0.9557321225879682,0.04426787741203178
821579689332510722,1,1000,36,964,0.036,0.964
114526039,0,57,55,2,0.9649122807017544,0.03508771929824561
2838549517,1,95,11,84,0.11578947368421053,0.8842105263157894
1245933735830269952,0,1000,909,91,0.909,0.091
924124075580100608,1,75,7,68,0.09333333333333334,0.9066666666666666
1468455209345105926,0,92,90,2,0.9782608695652174,0.021739130434782608
3031129295,1,8,0,8,0.0,1.0
2725804077,0,734,696,38,0.9482288828337875,0.051771117166212535
548805376,1,1000,55,945,0.055,0.945
145770376,0,1000,926,74,0.926,0.074
21594719,1,55,1,54,0.01818181818181818,0.9818181818181818
394411073,0,557,556,1,0.9982046678635548,0.0017953321364452424
836966860155469824,1,51,8,43,0.1568627450980392,0.8431372549019608
2784316898,0,149,132,17,0.8859060402684564,0.11409395973154363
432943643,1,1000,8,992,0.008,0.992
18236789,0,131,129,2,0.9847328244274809,0.015267175572519083
891381664336805889,1,9,1,8,0.1111111111111111,0.8888888888888888
1337484440050790400,0,50,49,1,0.98,0.02
1192610493665619978,1,294,55,239,0.1870748299319728,0.8129251700680272
1407990065796718593,0,1000,1000,0,1.0,0.0
1245281160,1,895,44,851,0.049162011173184354,0.9508379888268157
408025045,0,99,98,1,0.98989898989899,0.010101010101010102
2454149816,1,293,39,254,0.13310580204778158,0.8668941979522184
1121828417413025794,0,723,722,1,0.9986168741355463,0.0013831258644536654
819022534536470528,1,174,36,138,0.20689655172413793,0.7931034482758621
18157633,0,50,49,1,0.98,0.02
1021516559150403584,1,101,13,88,0.12871287128712872,0.8712871287128713
1008596599709188096,0,126,123,3,0.9761904761904762,0.023809523809523808
2646570949,1,348,19,329,0.05459770114942529,0.9454022988505747
1503234526977351682,0,645,630,15,0.9767441860465116,0.023255813953488372
1313893041317478407,1,295,13,282,0.04406779661016949,0.9559322033898305
1400308300114059267,0,123,121,2,0.983739837398374,0.016260162601626018
979547916271435777,1,1000,125,875,0.125,0.875
48898916,0,63,63,0,1.0,0.0
191641919,0,152,143,9,0.9407894736842105,0.05921052631578947
1169695813452349440,1,1000,232,768,0.232,0.768
393167567,0,38,38,0,1.0,0.0
1113971568210841605,1,8,1,7,0.125,0.875
936044052860063744,0,57,57,0,1.0,0.0
400415708,1,99,10,89,0.10101010101010101,0.898989898989899
365859829,0,233,233,0,1.0,0.0
4099043687,1,117,27,90,0.23076923076923078,0.7692307692307693
328469754,0,1000,989,11,0.989,0.011
749472260797456384,1,310,18,292,0.05806451612903226,0.9419354838709677
776849976378875905,0,22,22,0,1.0,0.0
1085280454905757696,1,703,63,640,0.08961593172119488,0.9103840682788051
2725719369,1,624,35,589,0.05608974358974359,0.9439102564102564
2330610001,0,436,436,0,1.0,0.0
454478194,1,382,14,368,0.03664921465968586,0.9633507853403142
961117839980728325,0,85,47,38,0.5529411764705883,0.4470588235294118
64595517,1,21,5,16,0.23809523809523808,0.7619047619047619
3947939714,0,84,71,13,0.8452380952380952,0.15476190476190477
56784509,1,790,59,731,0.07468354430379746,0.9253164556962026
709813483466960896,0,1000,997,3,0.997,0.003
279321437,1,83,10,73,0.12048192771084337,0.8795180722891566
1202497499665055744,1,4,0,4,0.0,1.0
858474002364325888,0,29,29,0,1.0,0.0
417307694,1,610,9,601,0.014754098360655738,0.9852459016393442
881637161686183936,0,64,61,3,0.953125,0.046875
1462240940286889993,0,322,321,1,0.9968944099378882,0.003105590062111801
32903657,1,148,9,139,0.060810810810810814,0.9391891891891891
89166541,0,1000,837,163,0.837,0.163
939227160459534336,1,172,12,160,0.06976744186046512,0.9302325581395349
3242377920,0,539,531,8,0.9851576994434137,0.014842300556586271
65130328,1,248,29,219,0.11693548387096774,0.8830645161290323
3094630473,1,729,44,685,0.06035665294924554,0.9396433470507545
4145412435,0,143,139,4,0.972027972027972,0.027972027972027972
1954675898,1,372,62,310,0.16666666666666666,0.8333333333333334
20996811,0,107,105,2,0.9813084112149533,0.018691588785046728
1620708252,1,118,12,106,0.1016949152542373,0.8983050847457628
1204953390847025152,0,67,67,0,1.0,0.0
323357414,1,1000,164,836,0.164,0.836
1408858363320995844,0,48,48,0,1.0,0.0
1072242634826096641,1,27,3,24,0.1111111111111111,0.8888888888888888
440166678,0,23,23,0,1.0,0.0
149353150,1,466,36,430,0.07725321888412018,0.9227467811158798
4692555494,0,545,544,1,0.998165137614679,0.001834862385321101
1315041895,1,616,18,598,0.02922077922077922,0.9707792207792207
444158156,0,43,43,0,1.0,0.0
823693221578637312,0,48,48,0,1.0,0.0
597786278,1,137,17,120,0.12408759124087591,0.8759124087591241
3608517618,0,68,58,10,0.8529411764705882,0.14705882352941177
2455219962,1,132,5,127,0.03787878787878788,0.9621212121212122
20354213,0,87,85,2,0.9770114942528736,0.022988505747126436
1267208891835846656,1,68,8,60,0.11764705882352941,0.8823529411764706
3368995617,0,1000,997,3,0.997,0.003
18318793,1,52,2,50,0.038461538461538464,0.9615384615384616
169810558,0,37,37,0,1.0,0.0
2398406498,1,425,24,401,0.05647058823529412,0.9435294117647058
843162593955123200,0,1000,1000,0,1.0,0.0
472518594,1,48,1,47,0.020833333333333332,0.9791666666666666
1236385429550592000,0,102,97,5,0.9509803921568627,0.049019607843137254
433114726,1,561,26,535,0.04634581105169341,0.9536541889483066
61935772,1,392,144,248,0.3673469387755102,0.6326530612244898
1298943198300053506,0,84,63,21,0.75,0.25
732347520,1,1000,132,868,0.132,0.868
230845839,0,22,22,0,1.0,0.0
803274223,1,1000,24,976,0.024,0.976
17063741,0,252,244,8,0.9682539682539683,0.031746031746031744
2358471234,1,95,18,77,0.18947368421052632,0.8105263157894737
57054498,0,1000,970,30,0.97,0.03
1491593060823752707,1,122,11,111,0.09016393442622951,0.9098360655737705
702358424797974528,1,166,8,158,0.04819277108433735,0.9518072289156626
1306432358195789829,0,358,342,16,0.9553072625698324,0.0446927374301676
1288195529013448708,1,362,95,267,0.26243093922651933,0.7375690607734806
1357819565804310528,1,568,146,422,0.25704225352112675,0.7429577464788732
1395675363234050048,1,11,3,8,0.2727272727272727,0.7272727272727273
167002881,0,1000,1000,0,1.0,0.0
20176900,1,136,12,124,0.08823529411764706,0.9117647058823529
21791250,0,733,686,47,0.9358799454297408,0.06412005457025921
1192307685515055104,1,238,56,182,0.23529411764705882,0.7647058823529411
288606504,0,1000,990,10,0.99,0.01
956639042438909952,1,290,24,266,0.08275862068965517,0.9172413793103448
1055237713278861312,0,10,6,4,0.6,0.4
18728200,1,1000,125,875,0.125,0.875
3366448214,0,386,383,3,0.9922279792746114,0.007772020725388601
1057284264440487936,1,458,54,404,0.11790393013100436,0.8820960698689956
34283249,0,1000,995,5,0.995,0.005
717906721595793408,1,741,98,643,0.13225371120107962,0.8677462887989204
498147563,0,126,115,11,0.9126984126984127,0.0873015873015873
1072942527534239754,1,980,189,791,0.19285714285714287,0.8071428571428572
730135882699821056,0,38,38,0,1.0,0.0
1263151910,1,1000,62,938,0.062,0.938
1175158111331651584,0,50,42,8,0.84,0.16
3293608784,0,34,34,0,1.0,0.0
1427350038259413004,1,6,2,4,0.3333333333333333,0.6666666666666666
280162371,0,1000,997,3,0.997,0.003
2579530670,1,494,15,479,0.030364372469635626,0.9696356275303644
10460262,0,1000,979,21,0.979,0.021
2942603251,1,355,7,348,0.01971830985915493,0.9802816901408451
944998137009229824,0,1000,983,17,0.983,0.017
710992762489802752,1,202,29,173,0.14356435643564355,0.8564356435643564
3180901225,0,17,12,5,0.7058823529411765,0.29411764705882354
1013578454,1,1000,162,838,0.162,0.838
331715626,0,1000,996,4,0.996,0.004
1406288382443999238,1,37,1,36,0.02702702702702703,0.972972972972973
23892768,0,42,42,0,1.0,0.0
2943195980,1,1000,115,885,0.115,0.885
985251803586551808,0,91,90,1,0.989010989010989,0.01098901098901099
1009948615597408258,1,210,21,189,0.1,0.9
46498559,0,50,50,0,1.0,0.0
759988528667365376,1,494,54,440,0.10931174089068826,0.8906882591093117
614425492,0,965,947,18,0.9813471502590674,0.01865284974093264
1523315443628453895,1,44,10,34,0.22727272727272727,0.7727272727272727
10788032,0,81,76,5,0.9382716049382716,0.06172839506172839
22846214,1,99,4,95,0.04040404040404041,0.9595959595959596
227892241,0,434,434,0,1.0,0.0
1512925408890662913,1,21,1,20,0.047619047619047616,0.9523809523809523
4910976497,0,21,20,1,0.9523809523809523,0.047619047619047616
860807461,1,1000,162,838,0.162,0.838
1210577048596631552,0,95,94,1,0.9894736842105263,0.010526315789473684
1681086073,1,340,7,333,0.020588235294117647,0.9794117647058823
731881700,0,384,379,5,0.9869791666666666,0.013020833333333334
24475381,1,1000,182,818,0.182,0.818
911979228597559297,0,89,88,1,0.9887640449438202,0.011235955056179775
713483468886384640,1,35,6,29,0.17142857142857143,0.8285714285714286
1379755787870822400,0,585,574,11,0.9811965811965812,0.018803418803418803
20833159,1,114,4,110,0.03508771929824561,0.9649122807017544
822893041312731136,0,194,194,0,1.0,0.0
42637231,1,253,8,245,0.03162055335968379,0.9683794466403162
34441572,0,1000,958,42,0.958,0.042
232959884,1,942,26,916,0.027600849256900213,0.9723991507430998
2980484082,0,526,523,3,0.9942965779467681,0.005703422053231939
731484442292715520,1,177,19,158,0.10734463276836158,0.8926553672316384
306553284,0,406,374,32,0.9211822660098522,0.07881773399014778
1109532477129818113,1,386,95,291,0.24611398963730569,0.7538860103626943
1135730766,0,1000,973,27,0.973,0.027
3428856412,1,185,8,177,0.043243243243243246,0.9567567567567568
937351057314893824,0,87,86,1,0.9885057471264368,0.011494252873563218
1325280700753440768,1,99,32,67,0.32323232323232326,0.6767676767676768
4665380969,0,686,686,0,1.0,0.0
48552863,1,82,15,67,0.18292682926829268,0.8170731707317073
759893691934703617,0,120,119,1,0.9916666666666667,0.008333333333333333
832005840949305344,1,363,69,294,0.19008264462809918,0.8099173553719008
1429628054217711617,0,1000,1000,0,1.0,0.0
477869253,1,306,11,295,0.03594771241830065,0.9640522875816994
1077012966879514625,0,26,26,0,1.0,0.0
739070751773450241,1,212,26,186,0.12264150943396226,0.8773584905660378
22984844,0,72,72,0,1.0,0.0
903045999714807808,1,35,2,33,0.05714285714285714,0.9428571428571428
828159734,0,1000,999,1,0.999,0.001
34333289,1,834,27,807,0.03237410071942446,0.9676258992805755
1225864894055976960,0,45,45,0,1.0,0.0
1297349942776705025,1,323,12,311,0.03715170278637771,0.9628482972136223
17791411,0,26,26,0,1.0,0.0
1074031464193409024,1,869,160,709,0.18411967779056387,0.8158803222094362
283866413,0,139,134,5,0.9640287769784173,0.03597122302158273
32578479,1,493,18,475,0.036511156186612576,0.9634888438133874
1071612882129993733,0,54,54,0,1.0,0.0
769729517602562048,1,238,42,196,0.17647058823529413,0.8235294117647058
2325804704,0,1000,985,15,0.985,0.015
1358875580565889024,1,424,57,367,0.13443396226415094,0.8655660377358491
861360702283538433,0,60,58,2,0.9666666666666667,0.03333333333333333
1131173369280385024,1,285,69,216,0.24210526315789474,0.7578947368421053
1544587740,0,1000,992,8,0.992,0.008
984431982556864513,1,261,34,227,0.13026819923371646,0.8697318007662835
874518828171968512,0,91,90,1,0.989010989010989,0.01098901098901099
1209337978780188672,1,10,2,8,0.2,0.8
3754699633,0,150,128,22,0.8533333333333334,0.14666666666666667
108724096,1,266,39,227,0.14661654135338345,0.8533834586466166
2243773799,0,311,310,1,0.9967845659163987,0.003215434083601286
1052251555850846208,1,89,11,78,0.12359550561797752,0.8764044943820225
4693306939,0,51,32,19,0.6274509803921569,0.37254901960784315
831262159,1,1000,36,964,0.036,0.964
982088160644681728,0,499,486,13,0.9739478957915831,0.026052104208416832
1064634429077782528,1,1000,267,733,0.267,0.733
1202234034300096513,0,283,280,3,0.9893992932862191,0.01060070671378092
884493670048813056,1,395,111,284,0.2810126582278481,0.7189873417721518
1538033370,0,1000,985,15,0.985,0.015
750560253343834112,1,480,59,421,0.12291666666666666,0.8770833333333333
1375362622833491970,0,12,12,0,1.0,0.0
1151985986290823168,1,1000,220,780,0.22,0.78
1096565784300654598,0,408,401,7,0.9828431372549019,0.01715686274509804
19012891,1,1000,96,904,0.096,0.904
950174372966395904,0,310,310,0,1.0,0.0
940451863,1,87,5,82,0.05747126436781609,0.9425287356321839
921527212494422017,0,1000,788,212,0.788,0.212
48771836,1,1000,175,825,0.175,0.825
3246400537,0,1000,1000,0,1.0,0.0
283510997,1,1000,149,851,0.149,0.851
129965089,0,536,524,12,0.9776119402985075,0.022388059701492536
1506022269713371141,0,1,1,0,1.0,0.0
51386388,1,944,26,918,0.02754237288135593,0.972457627118644
1523841317301850115,0,19,19,0,1.0,0.0
1320159878367776768,1,1000,116,884,0.116,0.884
707729904109035520,0,44,44,0,1.0,0.0
1102043565482496000,1,227,12,215,0.05286343612334802,0.947136563876652
888562256459571201,0,83,83,0,1.0,0.0
1356821102295670784,1,39,7,32,0.1794871794871795,0.8205128205128205
240352121,1,1000,76,924,0.076,0.924
139977506,0,102,101,1,0.9901960784313726,0.00980392156862745
327751290,1,867,71,796,0.08189158016147635,0.9181084198385236
72945095,0,1000,884,116,0.884,0.116
1144731590003744768,1,171,22,149,0.1286549707602339,0.8713450292397661
333106605,0,190,187,3,0.9842105263157894,0.015789473684210527
2834256968,1,1000,102,898,0.102,0.898
1464830082871136258,0,140,139,1,0.9928571428571429,0.007142857142857143
3301168667,1,1000,91,909,0.091,0.909
67954115,1,444,28,416,0.06306306306306306,0.9369369369369369
167069918,0,529,525,4,0.9924385633270322,0.007561436672967864
1312431026610802690,1,180,30,150,0.16666666666666666,0.8333333333333334
1085373397041725440,0,161,144,17,0.8944099378881988,0.10559006211180125
66579301,1,506,5,501,0.009881422924901186,0.9901185770750988
921282096,0,357,356,1,0.9971988795518207,0.0028011204481792717
1299801768214368257,1,246,51,195,0.2073170731707317,0.7926829268292683
445983439,0,890,854,36,0.9595505617977528,0.04044943820224719
124852546,1,284,65,219,0.22887323943661972,0.7711267605633803
150110422,0,376,373,3,0.9920212765957447,0.007978723404255319
16377908,1,194,12,182,0.061855670103092786,0.9381443298969072
3248162238,0,276,272,4,0.9855072463768116,0.014492753623188406
35964253,1,201,43,158,0.21393034825870647,0.7860696517412935
1443851375897681923,0,7,7,0,1.0,0.0
1677214454,1,196,30,166,0.15306122448979592,0.8469387755102041
819936053662535681,0,116,115,1,0.9913793103448276,0.008620689655172414
939897513468981249,1,58,3,55,0.05172413793103448,0.9482758620689655
1023265086763425792,0,19,18,1,0.9473684210526315,0.05263157894736842
1248797921560203265,1,450,16,434,0.035555555555555556,0.9644444444444444
725248090827952128,0,1000,967,33,0.967,0.033
3107940210,1,105,19,86,0.18095238095238095,0.819047619047619
1438628392962715649,0,2,1,1,0.5,0.5
198830272,1,215,26,189,0.12093023255813953,0.8790697674418605
1501393503699546118,0,43,43,0,1.0,0.0
1037161483652800513,1,114,7,107,0.06140350877192982,0.9385964912280702
16851207,0,1000,1000,0,1.0,0.0
816852167361499140,1,35,8,27,0.22857142857142856,0.7714285714285715
154387961,0,811,809,2,0.9975339087546239,0.002466091245376079
1445932566851244039,1,26,5,21,0.19230769230769232,0.8076923076923077
1505914112848633862,0,101,101,0,1.0,0.0
4070971032,1,557,203,354,0.3644524236983842,0.6355475763016158
1532196485076762624,0,148,148,0,1.0,0.0
578528682,1,492,63,429,0.12804878048780488,0.8719512195121951
1073043243384913920,0,278,277,1,0.9964028776978417,0.0035971223021582736
1025123108347412486,1,292,54,238,0.18493150684931506,0.815068493150685
94606643,0,22,22,0,1.0,0.0
1372237927313457155,1,1000,156,844,0.156,0.844
1268322377043238915,0,34,34,0,1.0,0.0
2562745296,1,544,36,508,0.0661764705882353,0.9338235294117647
19329792,0,738,714,24,0.967479674796748,0.032520325203252036
1181025824285134848,1,276,42,234,0.15217391304347827,0.8478260869565217
878296279670857729,0,395,394,1,0.9974683544303797,0.002531645569620253
980494691316592640,1,1000,82,918,0.082,0.918
271554339,0,64,57,7,0.890625,0.109375
378229707,1,387,91,296,0.2351421188630491,0.7648578811369509
260504642,0,1000,995,5,0.995,0.005
2657992243,1,544,22,522,0.04044117647058824,0.9595588235294118
2391556782,0,450,441,9,0.98,0.02
1423377400558145537,0,33,29,4,0.8787878787878788,0.12121212121212122
43588967,1,1000,96,904,0.096,0.904
1521551863593816064,0,287,287,0,1.0,0.0
142336259,1,1000,165,835,0.165,0.835
76076487,1,187,26,161,0.13903743315508021,0.8609625668449198
2282673626,0,103,103,0,1.0,0.0
2332261590,1,817,58,759,0.07099143206854346,0.9290085679314566
1481543206500282368,0,34,34,0,1.0,0.0
989565690771361792,1,131,8,123,0.061068702290076333,0.9389312977099237
822238044,0,405,400,5,0.9876543209876543,0.012345679012345678
1439530462439874567,1,76,16,60,0.21052631578947367,0.7894736842105263
2237375736,0,827,827,0,1.0,0.0
480782053,1,78,3,75,0.038461538461538464,0.9615384615384616
42092978,0,383,376,7,0.9817232375979112,0.018276762402088774
334312303,1,276,74,202,0.26811594202898553,0.7318840579710145
3407336117,0,413,413,0,1.0,0.0
1977261344,0,1000,986,14,0.986,0.014
3070505002,0,391,388,3,0.9923273657289002,0.0076726342710997444
3035834173,1,1000,137,863,0.137,0.863
2598696841,0,580,558,22,0.9620689655172414,0.03793103448275862
967890537859698689,1,274,70,204,0.25547445255474455,0.7445255474452555
1398434097207386112,0,166,163,3,0.9819277108433735,0.018072289156626505
752990131326423040,1,191,45,146,0.2356020942408377,0.7643979057591623
155963804,0,1000,990,10,0.99,0.01
935865616589840385,1,1000,454,546,0.454,0.546
2631619359,0,549,538,11,0.9799635701275046,0.020036429872495445
39624086,1,517,111,406,0.21470019342359767,0.7852998065764023
797073271275536384,0,20,20,0,1.0,0.0
114528969,1,389,5,384,0.012853470437017995,0.987146529562982
1214500639469948928,0,118,117,1,0.9915254237288136,0.00847457627118644
31064517,1,1000,49,951,0.049,0.951
4071588471,0,185,177,8,0.9567567567567568,0.043243243243243246
1144808030728589312,1,1000,61,939,0.061,0.939
1417723556,0,9,9,0,1.0,0.0
2163304206,1,263,80,183,0.3041825095057034,0.6958174904942965
984904869545938945,0,127,126,1,0.9921259842519685,0.007874015748031496
3386795213,1,158,17,141,0.10759493670886076,0.8924050632911392
3000497573,0,1000,997,3,0.997,0.003
1425845522036891659,1,30,3,27,0.1,0.9
1151923296251916289,0,907,907,0,1.0,0.0
737846540937494529,1,572,143,429,0.25,0.75
546293672,0,44,44,0,1.0,0.0
1195185744094121995,1,176,33,143,0.1875,0.8125
4728536374,0,113,113,0,1.0,0.0
1055636816374759426,1,220,47,173,0.21363636363636362,0.7863636363636364
1020742527253540864,0,20,18,2,0.9,0.1
891478101040877570,1,161,36,125,0.2236024844720497,0.7763975155279503
1033868596152356864,1,219,44,175,0.2009132420091324,0.7990867579908676
719118036,0,2,2,0,1.0,0.0
27810346,1,725,38,687,0.05241379310344828,0.9475862068965517
379231541,0,186,186,0,1.0,0.0
57411841,1,37,5,32,0.13513513513513514,0.8648648648648649
1512769286301007883,0,27,27,0,1.0,0.0
827920476,1,268,7,261,0.026119402985074626,0.9738805970149254
1458769570223693836,0,333,332,1,0.996996996996997,0.003003003003003003
73015576,1,198,27,171,0.13636363636363635,0.8636363636363636
1406809333841731586,0,63,61,2,0.9682539682539683,0.031746031746031744
1366165992343298050,1,148,51,97,0.34459459459459457,0.6554054054054054
482338076,0,86,86,0,1.0,0.0
1464816435482476546,1,205,83,122,0.40487804878048783,0.5951219512195122
2902331327,0,81,80,1,0.9876543209876543,0.012345679012345678
708130767277195264,1,91,8,83,0.08791208791208792,0.9120879120879121
1074747149458518016,0,250,245,5,0.98,0.02
1240086948217147392,1,44,2,42,0.045454545454545456,0.9545454545454546
1315835521155899392,0,361,360,1,0.997229916897507,0.002770083102493075
3418894039,1,71,20,51,0.28169014084507044,0.7183098591549296
44961569,0,1000,982,18,0.982,0.018
1270268425609207809,1,37,2,35,0.05405405405405406,0.9459459459459459
1397924164145598465,0,31,28,3,0.9032258064516129,0.0967741935483871
18282372,1,71,4,67,0.056338028169014086,0.9436619718309859
1877235522,1,330,26,304,0.07878787878787878,0.9212121212121213
1519307744414740480,0,22,22,0,1.0,0.0
494087295,1,464,96,368,0.20689655172413793,0.7931034482758621
1174666558108557312,0,641,552,89,0.8611544461778471,0.13884555382215288
1469418949100113926,1,332,38,294,0.1144578313253012,0.8855421686746988
117746029,0,257,257,0,1.0,0.0
837483684064284676,1,13,4,9,0.3076923076923077,0.6923076923076923
90886859,0,317,316,1,0.9968454258675079,0.0031545741324921135
1294400137721257988,1,197,5,192,0.025380710659898477,0.9746192893401016
1849695638,0,85,81,4,0.9529411764705882,0.047058823529411764
2730389410,1,157,50,107,0.3184713375796178,0.6815286624203821
199916717,0,90,90,0,1.0,0.0
722853550842208257,1,72,2,70,0.027777777777777776,0.9722222222222222
1342602253941821446,0,1000,959,41,0.959,0.041
796222517673332736,1,123,20,103,0.16260162601626016,0.8373983739837398
625690529,0,393,385,8,0.9796437659033079,0.020356234096692113
1007563102781693952,1,1000,271,729,0.271,0.729
180239753,0,57,57,0,1.0,0.0
1107770391383212033,1,122,13,109,0.10655737704918032,0.8934426229508197
1435693468618268677,0,40,40,0,1.0,0.0
1453700803403866113,0,854,850,4,0.9953161592505855,0.00468384074941452
1306723814768812032,1,48,2,46,0.041666666666666664,0.9583333333333334
1513697815817465856,0,471,420,51,0.89171974522293,0.10828025477707007
1250580824996511746,1,1000,194,806,0.194,0.806
1328693998140215302,0,7,7,0,1.0,0.0
2153317555,1,194,31,163,0.15979381443298968,0.8402061855670103
999255188459401216,0,59,59,0,1.0,0.0
1435003313691504643,1,364,57,307,0.1565934065934066,0.8434065934065934
3009104578,1,82,12,70,0.14634146341463414,0.8536585365853658
1349121587585425409,0,211,211,0,1.0,0.0
1176705709943283712,1,102,19,83,0.18627450980392157,0.8137254901960784
209959335,0,113,113,0,1.0,0.0
201672832,1,804,233,571,0.2898009950248756,0.7101990049751243
746307632458240000,0,70,69,1,0.9857142857142858,0.014285714285714285
1414285712342593537,1,82,5,77,0.06097560975609756,0.9390243902439024
4320872723,0,226,225,1,0.995575221238938,0.004424778761061947
455438464,1,621,39,582,0.06280193236714976,0.9371980676328503
948236765541928960,0,300,233,67,0.7766666666666666,0.22333333333333333
1278520653063294977,1,167,48,119,0.2874251497005988,0.7125748502994012
750230946,0,374,374,0,1.0,0.0
260412324,0,67,67,0,1.0,0.0
14062563,1,1000,182,818,0.182,0.818
40545635,0,158,158,0,1.0,0.0
3219960564,0,561,556,5,0.9910873440285205,0.008912655971479501
2565413500,1,407,16,391,0.03931203931203931,0.9606879606879607
1045769363205361665,0,1000,939,61,0.939,0.061
918260818147467264,1,39,2,37,0.05128205128205128,0.9487179487179487
1460729101283520520,0,2,2,0,1.0,0.0
942657270,1,303,8,295,0.026402640264026403,0.9735973597359736
242359437,0,1000,971,29,0.971,0.029
3198429782,1,725,28,697,0.038620689655172416,0.9613793103448276
29807113,0,77,76,1,0.987012987012987,0.012987012987012988
1290531588904824833,1,1000,152,848,0.152,0.848
846365549022064640,0,82,82,0,1.0,0.0
1248842333237448704,1,1000,113,887,0.113,0.887
1438668450851872771,0,60,56,4,0.9333333333333333,0.06666666666666667
28128854,1,108,40,68,0.37037037037037035,0.6296296296296297
20213065,0,1000,975,25,0.975,0.025
874878427,1,328,5,323,0.01524390243902439,0.9847560975609756
634185662,0,1000,999,1,0.999,0.001
2941024049,1,234,7,227,0.029914529914529916,0.9700854700854701
1432513173987409925,0,6,6,0,1.0,0.0
147791271,1,127,3,124,0.023622047244094488,0.9763779527559056
1494105091,0,1000,965,35,0.965,0.035
2913244848,1,452,5,447,0.011061946902654867,0.9889380530973452
1885615854,0,337,331,6,0.9821958456973294,0.017804154302670624
1347713233185107968,1,30,0,30,0.0,1.0
20714200,0,229,229,0,1.0,0.0
746436328582057985,0,1000,995,5,0.995,0.005
1226300681172197376,1,79,15,64,0.189873417721519,0.810126582278481
137969388,0,398,356,42,0.8944723618090452,0.10552763819095477
1205968607974510592,1,1000,123,877,0.123,0.877
807791293,0,309,308,1,0.9967637540453075,0.003236245954692557
48597181,1,1000,176,824,0.176,0.824
1489868377069961216,0,514,492,22,0.9571984435797666,0.042801556420233464
767080131617693696,1,90,11,79,0.12222222222222222,0.8777777777777778
28695381,0,209,208,1,0.9952153110047847,0.004784688995215311
17770473,1,112,5,107,0.044642857142857144,0.9553571428571429
453643920,0,235,229,6,0.9744680851063829,0.02553191489361702
3195126427,1,1000,73,927,0.073,0.927
919939341165780993,0,136,135,1,0.9926470588235294,0.007352941176470588
823966580744867840,1,437,128,309,0.2929061784897025,0.7070938215102975
1913024906,0,776,775,1,0.9987113402061856,0.001288659793814433
1077018791542874112,1,134,16,118,0.11940298507462686,0.8805970149253731
3716575994,0,719,719,0,1.0,0.0
2418329846,1,98,9,89,0.09183673469387756,0.9081632653061225
4833133334,0,1000,882,118,0.882,0.118
1163737662,0,923,916,7,0.9924160346695557,0.007583965330444204
849032859218268162,1,184,46,138,0.25,0.75
1509438451737051136,0,398,395,3,0.992462311557789,0.007537688442211055
737469600065978368,1,159,7,152,0.0440251572327044,0.9559748427672956
47681130,0,37,37,0,1.0,0.0
30306968,0,968,966,2,0.9979338842975206,0.002066115702479339
1177894534967173120,1,134,0,134,0.0,1.0
16508495,0,1000,1000,0,1.0,0.0
1372151220043923458,1,912,232,680,0.2543859649122807,0.7456140350877193
302602644,0,120,120,0,1.0,0.0
369797546,1,1000,12,988,0.012,0.988
1235986086398173184,0,73,71,2,0.9726027397260274,0.0273972602739726
869383106,1,786,18,768,0.022900763358778626,0.9770992366412213
246219052,0,129,118,11,0.9147286821705426,0.08527131782945736
1024328748,1,103,15,88,0.14563106796116504,0.8543689320388349
1328507185278709760,0,408,408,0,1.0,0.0
91623259,1,1000,38,962,0.038,0.962
408180531,0,375,375,0,1.0,0.0
2730171241,1,230,28,202,0.12173913043478261,0.8782608695652174
948680824748048384,0,441,426,15,0.9659863945578231,0.034013605442176874
718981087255396352,1,306,108,198,0.35294117647058826,0.6470588235294118
1430626786644307972,0,953,952,1,0.9989506820566632,0.001049317943336831
791756069525651456,1,72,8,64,0.1111111111111111,0.8888888888888888
1799131752,0,35,35,0,1.0,0.0
246548264,1,263,26,237,0.09885931558935361,0.9011406844106464
167945234,0,133,133,0,1.0,0.0
875008292593991681,1,1000,60,940,0.06,0.94
391136736,0,85,84,1,0.9882352941176471,0.011764705882352941
807203917239087104,1,1000,28,972,0.028,0.972
1240530202351947776,0,125,125,0,1.0,0.0
870302231165382656,1,305,48,257,0.15737704918032788,0.8426229508196721
1462634331906580483,0,355,351,4,0.9887323943661972,0.011267605633802818
463388274,1,311,21,290,0.06752411575562701,0.932475884244373
884842475067670528,0,165,165,0,1.0,0.0
1510705841858662404,1,3,0,3,0.0,1.0
1349160564572844032,0,1000,999,1,0.999,0.001
3874360677,1,144,18,126,0.125,0.875
30808449,0,249,248,1,0.9959839357429718,0.004016064257028112
756676596942139392,1,118,24,94,0.2033898305084746,0.7966101694915254
1487413519826006020,0,47,47,0,1.0,0.0
267203493,1,475,117,358,0.2463157894736842,0.7536842105263157
18173737,0,1000,994,6,0.994,0.006
1085669190399254529,1,69,6,63,0.08695652173913043,0.9130434782608695
779147071614029824,0,100,100,0,1.0,0.0
3285200630,1,187,11,176,0.058823529411764705,0.9411764705882353
2262013091,0,1000,982,18,0.982,0.018
1036727814056226817,1,93,13,80,0.13978494623655913,0.8602150537634409
15254924,0,286,286,0,1.0,0.0
2810739692,1,581,34,547,0.058519793459552494,0.9414802065404475
24577698,0,1000,992,8,0.992,0.008
2227463106,1,305,44,261,0.14426229508196722,0.8557377049180328
715279471679565824,0,1,1,0,1.0,0.0
1348710202342780935,1,53,0,53,0.0,1.0
15370977,0,219,215,4,0.9817351598173516,0.0182648401826484
430314135,1,269,32,237,0.11895910780669144,0.8810408921933085
767445173248942084,0,194,193,1,0.9948453608247423,0.005154639175257732
852656544323862528,1,105,10,95,0.09523809523809523,0.9047619047619048
1347395886754779148,1,36,10,26,0.2777777777777778,0.7222222222222222
3184400911,0,76,76,0,1.0,0.0
22980373,1,666,48,618,0.07207207207207207,0.9279279279279279
736021346514259969,0,183,180,3,0.9836065573770492,0.01639344262295082
1234919175744868352,1,592,126,466,0.21283783783783783,0.7871621621621622
1375122607419219970,0,480,473,7,0.9854166666666667,0.014583333333333334
1468287416465518592,1,761,49,712,0.06438896189224705,0.9356110381077529
2781660820,0,1000,989,11,0.989,0.011
4833903077,1,139,16,123,0.11510791366906475,0.8848920863309353
717819485072175104,0,198,194,4,0.9797979797979798,0.020202020202020204
19096214,1,109,13,96,0.11926605504587157,0.8807339449541285
225565576,0,164,164,0,1.0,0.0
946876237242347524,1,45,12,33,0.26666666666666666,0.7333333333333333
1502886231730008066,0,49,49,0,1.0,0.0
20579275,1,917,14,903,0.015267175572519083,0.9847328244274809
179532828,0,690,689,1,0.9985507246376811,0.0014492753623188406
1340937692205367301,1,601,105,496,0.17470881863560733,0.8252911813643927
172117032,0,114,114,0,1.0,0.0
622803573,1,217,12,205,0.055299539170506916,0.9447004608294931
192976679,0,450,448,2,0.9955555555555555,0.0044444444444444444
1300259315119390720,1,22,2,20,0.09090909090909091,0.9090909090909091
858012006607093764,0,392,320,72,0.8163265306122449,0.1836734693877551
14719333,1,920,56,864,0.06086956521739131,0.9391304347826087
1084210519861616642,0,15,14,1,0.9333333333333333,0.06666666666666667
101055558,1,385,51,334,0.13246753246753246,0.8675324675324675
142048769,0,17,16,1,0.9411764705882353,0.058823529411764705
4074459978,1,31,6,25,0.1935483870967742,0.8064516129032258
49229520,0,842,840,2,0.997624703087886,0.0023752969121140144
408813948,1,370,15,355,0.04054054054054054,0.9594594594594594
3031924432,0,1000,988,12,0.988,0.012
2561327695,1,881,51,830,0.05788876276958002,0.94211123723042
182158423,0,1000,987,13,0.987,0.013
852737940937506816,1,221,26,195,0.11764705882352941,0.8823529411764706
1406000195989610498,0,604,585,19,0.9685430463576159,0.03145695364238411
1041389388230344705,1,37,4,33,0.10810810810810811,0.8918918918918919
2596891688,0,459,458,1,0.9978213507625272,0.002178649237472767
1336592145243762689,1,210,38,172,0.18095238095238095,0.819047619047619
2892287848,0,344,344,0,1.0,0.0
53945504,0,173,173,0,1.0,0.0
877249874613460992,1,217,28,189,0.12903225806451613,0.8709677419354839
1513565693463207937,0,9,7,2,0.7777777777777778,0.2222222222222222
1516895461315129344,1,30,11,19,0.36666666666666664,0.6333333333333333
901146347721457668,0,1000,990,10,0.99,0.01
1158936986192887811,1,188,13,175,0.06914893617021277,0.9308510638297872
1274006087423995904,0,1000,997,3,0.997,0.003
18793213,1,245,21,224,0.08571428571428572,0.9142857142857143
1399113140818882563,0,14,14,0,1.0,0.0
1301337263557742592,1,1000,12,988,0.012,0.988
894429034947293186,0,1000,963,37,0.963,0.037
316841231,1,80,26,54,0.325,0.675
568867388,0,56,56,0,1.0,0.0
310055182,1,1000,101,899,0.101,0.899
1068296845842149376,0,826,782,44,0.9467312348668281,0.053268765133171914
111979218,1,416,71,345,0.17067307692307693,0.8293269230769231
1279622441107513345,0,894,894,0,1.0,0.0
1096088579086970880,1,208,16,192,0.07692307692307693,0.9230769230769231
114923626,0,25,25,0,1.0,0.0
197053397,1,224,14,210,0.0625,0.9375
814666679552765952,0,130,129,1,0.9923076923076923,0.007692307692307693
237102620,1,244,24,220,0.09836065573770492,0.9016393442622951
177200863,0,632,631,1,0.9984177215189873,0.0015822784810126582
822526213755469824,1,135,12,123,0.08888888888888889,0.9111111111111111
2184352878,0,682,647,35,0.9486803519061584,0.051319648093841645
1108790625657409538,1,102,14,88,0.13725490196078433,0.8627450980392157
1081179881797505025,0,67,66,1,0.9850746268656716,0.014925373134328358
2831909425,1,1000,163,837,0.163,0.837
17596611,0,86,86,0,1.0,0.0
738400769867583490,1,368,94,274,0.2554347826086957,0.7445652173913043
1511431324816580609,0,6,6,0,1.0,0.0
952351548,1,1000,35,965,0.035,0.965
849024625631776769,0,7,7,0,1.0,0.0
924352893582499841,1,3,1,2,0.3333333333333333,0.6666666666666666
595087971,0,279,279,0,1.0,0.0
1038604402196504576,1,321,13,308,0.040498442367601244,0.9595015576323987
258949502,0,1000,987,13,0.987,0.013
48918874,1,836,168,668,0.20095693779904306,0.7990430622009569
1599685254,0,37,37,0,1.0,0.0
76449502,1,952,81,871,0.08508403361344538,0.9149159663865546
322134353,0,596,590,6,0.9899328859060402,0.010067114093959731
869950696698793984,1,93,7,86,0.07526881720430108,0.9247311827956989
1047630892871680000,0,1,1,0,1.0,0.0
71710652,1,263,13,250,0.049429657794676805,0.9505703422053232
1242357804,0,278,265,13,0.9532374100719424,0.046762589928057555
803953699,1,59,7,52,0.11864406779661017,0.8813559322033898
390435375,0,1000,977,23,0.977,0.023
707713266026348544,1,97,0,97,0.0,1.0
90344734,0,498,449,49,0.9016064257028112,0.09839357429718876
542002507,1,923,137,786,0.14842903575297942,0.8515709642470206
1494662969682128900,0,1,1,0,1.0,0.0
131690337,1,634,56,578,0.08832807570977919,0.9116719242902208
747667709463302144,0,692,664,28,0.9595375722543352,0.04046242774566474
1564998559,1,44,23,21,0.5227272727272727,0.4772727272727273
33610851,0,1000,992,8,0.992,0.008
45573895,1,1000,55,945,0.055,0.945
4520998817,0,449,448,1,0.9977728285077951,0.0022271714922048997
519140453,1,836,33,803,0.039473684210526314,0.9605263157894737
728317236138680320,0,95,95,0,1.0,0.0
1105973640179388416,0,4,4,0,1.0,0.0
947655614032941056,1,17,6,11,0.35294117647058826,0.6470588235294118
1481386019429699591,0,123,123,0,1.0,0.0
777242609047580672,1,59,5,54,0.0847457627118644,0.9152542372881356
3199805765,0,35,35,0,1.0,0.0
18112415,1,177,22,155,0.12429378531073447,0.8757062146892656
759545480,0,1000,967,33,0.967,0.033
1282112005177061377,1,258,42,216,0.16279069767441862,0.8372093023255814
737682761285144576,0,303,301,2,0.9933993399339934,0.006600660066006601
1415415812865855490,1,94,16,78,0.1702127659574468,0.8297872340425532
3651963314,1,77,4,73,0.05194805194805195,0.948051948051948
64967818,0,20,20,0,1.0,0.0
2793477532,1,223,18,205,0.08071748878923767,0.9192825112107623
1373858202643746816,0,803,792,11,0.9863013698630136,0.0136986301369863
2788478623,1,133,23,110,0.17293233082706766,0.8270676691729323
1098248054363357184,0,90,76,14,0.8444444444444444,0.15555555555555556
1334954903127658504,1,35,4,31,0.11428571428571428,0.8857142857142857
16699903,0,491,490,1,0.9979633401221996,0.002036659877800407
898913024,1,578,81,497,0.14013840830449828,0.8598615916955017
2286007819,0,1000,998,2,0.998,0.002
1484741766,1,607,44,563,0.07248764415156507,0.9275123558484349
1100431678047162368,0,31,31,0,1.0,0.0
846791676,1,161,13,148,0.08074534161490683,0.9192546583850931
316269930,0,101,101,0,1.0,0.0
1139274684011352064,1,21,4,17,0.19047619047619047,0.8095238095238095
736035785770553349,0,20,20,0,1.0,0.0
199252444,1,527,5,522,0.009487666034155597,0.9905123339658444
150821535,0,161,161,0,1.0,0.0
3335415838,1,226,53,173,0.2345132743362832,0.7654867256637168
20316250,0,951,933,18,0.9810725552050473,0.01892744479495268
1328393328023330816,1,22,3,19,0.13636363636363635,0.8636363636363636
1518905648469229568,0,47,46,1,0.9787234042553191,0.02127659574468085
3158245456,1,355,39,316,0.10985915492957747,0.8901408450704226
338896028,1,1000,104,896,0.104,0.896
1134432599311618048,0,90,90,0,1.0,0.0
3192776880,1,120,10,110,0.08333333333333333,0.9166666666666666
1163902465349160961,0,45,43,2,0.9555555555555556,0.044444444444444446
20751296,1,203,39,164,0.1921182266009852,0.8078817733990148
1490504552591859712,0,10,10,0,1.0,0.0
2355793082,1,567,16,551,0.02821869488536155,0.9717813051146384
1393615292056576001,0,12,12,0,1.0,0.0
1334944842,1,1000,54,946,0.054,0.946
1039560610214752257,0,58,56,2,0.9655172413793104,0.034482758620689655
58209366,1,482,50,432,0.1037344398340249,0.8962655601659751
782102526455869440,0,1000,983,17,0.983,0.017
1272370661281808387,1,52,16,36,0.3076923076923077,0.6923076923076923
348882976,0,318,317,1,0.9968553459119497,0.0031446540880503146
402896033,1,385,125,260,0.3246753246753247,0.6753246753246753
867083976,0,240,240,0,1.0,0.0
23901267,1,180,13,167,0.07222222222222222,0.9277777777777778
60878166,1,759,129,630,0.16996047430830039,0.8300395256916996
1366569219010174977,0,244,223,21,0.9139344262295082,0.0860655737704918
1630164320,1,427,55,372,0.1288056206088993,0.8711943793911007
1186408931641495552,0,78,75,3,0.9615384615384616,0.038461538461538464
115636090,1,1000,350,650,0.35,0.65
903730627500851200,0,754,754,0,1.0,0.0
1003883154564964352,1,131,13,118,0.09923664122137404,0.9007633587786259
410866478,0,250,250,0,1.0,0.0
746125616,1,1000,198,802,0.198,0.802
1295374965299204099,0,120,120,0,1.0,0.0
705911002995548160,1,328,92,236,0.2804878048780488,0.7195121951219512
1469803270625320962,0,35,33,2,0.9428571428571428,0.05714285714285714
811255204217753600,1,172,33,139,0.19186046511627908,0.8081395348837209
3341446034,0,64,64,0,1.0,0.0
197672918,1,572,112,460,0.1958041958041958,0.8041958041958042
1012488458424733696,0,1000,970,30,0.97,0.03
465334699,1,847,99,748,0.11688311688311688,0.8831168831168831
4128354688,0,1000,1000,0,1.0,0.0
835612056,1,1000,15,985,0.015,0.985
1381368085815427072,0,224,224,0,1.0,0.0
1005425298,1,30,8,22,0.26666666666666666,0.7333333333333333
1423743821532344320,0,27,25,2,0.9259259259259259,0.07407407407407407
1502658907528904705,0,48,46,2,0.9583333333333334,0.041666666666666664
1017786134472978432,1,105,4,101,0.0380952380952381,0.9619047619047619
353206662,0,460,459,1,0.9978260869565218,0.002173913043478261
749511140040998912,1,59,12,47,0.2033898305084746,0.7966101694915254
1319264736538726400,0,637,517,120,0.8116169544740973,0.18838304552590268
435480975,1,1000,62,938,0.062,0.938
1053960822,0,147,147,0,1.0,0.0
269494843,1,324,30,294,0.09259259259259259,0.9074074074074074
42039256,0,9,9,0,1.0,0.0
1120952184122880001,1,21,0,21,0.0,1.0
44297479,0,1000,969,31,0.969,0.031
1404510115558957059,1,130,30,100,0.23076923076923078,0.7692307692307693
3052966944,0,85,85,0,1.0,0.0
1419050364075192332,1,49,16,33,0.32653061224489793,0.673469387755102
911722837832060928,0,11,10,1,0.9090909090909091,0.09090909090909091
1524952438230368280,1,337,60,277,0.17804154302670624,0.8219584569732937
3177128484,0,100,100,0,1.0,0.0
1260379378502041601,1,53,5,48,0.09433962264150944,0.9056603773584906
972758852,0,371,371,0,1.0,0.0
2228981683,1,132,22,110,0.16666666666666666,0.8333333333333334
1294376886693515269,0,2,2,0,1.0,0.0
24692390,1,1000,75,925,0.075,0.925
1265657220718567426,0,1000,945,55,0.945,0.055
311708900,1,295,70,225,0.23728813559322035,0.7627118644067796
1276973550528860160,0,157,157,0,1.0,0.0
4831645384,1,63,14,49,0.2222222222222222,0.7777777777777778
1378861206413393921,0,5,5,0,1.0,0.0
3163166652,1,470,95,375,0.20212765957446807,0.7978723404255319
453434572,0,1000,1000,0,1.0,0.0
575034211,1,159,43,116,0.27044025157232704,0.7295597484276729
729372074402177024,0,24,24,0,1.0,0.0
885584289252999169,1,181,37,144,0.20441988950276244,0.7955801104972375
599563562,1,1000,80,920,0.08,0.92
617667542,0,549,545,4,0.9927140255009107,0.007285974499089253
1306103990631899136,1,55,14,41,0.2545454545454545,0.7454545454545455
2414205430,0,122,121,1,0.9918032786885246,0.00819672131147541
815164405621125120,1,82,9,73,0.10975609756097561,0.8902439024390244
913184955303424000,0,22,22,0,1.0,0.0
1121586790597627904,1,1000,149,851,0.149,0.851
1509722287599149056,0,25,25,0,1.0,0.0
1244801137750020096,1,66,10,56,0.15151515151515152,0.8484848484848485
1179951386,0,146,141,5,0.9657534246575342,0.03424657534246575
2245865670,1,280,19,261,0.06785714285714285,0.9321428571428572
18260784,0,22,22,0,1.0,0.0
2852542961,1,355,77,278,0.21690140845070421,0.7830985915492957
15143785,0,1000,934,66,0.934,0.066
177816479,1,377,41,336,0.10875331564986737,0.8912466843501327
459349550,0,313,313,0,1.0,0.0
1152918301,1,333,51,282,0.15315315315315314,0.8468468468468469
32548693,0,89,88,1,0.9887640449438202,0.011235955056179775
1434361656,1,58,6,52,0.10344827586206896,0.896551724137931
47525659,0,1000,994,6,0.994,0.006
344317120,1,1000,405,595,0.405,0.595
2946860820,0,220,218,2,0.990909090909091,0.00909090909090909
1380496218544046081,1,321,70,251,0.21806853582554517,0.7819314641744548
1511164131000438800,0,3,3,0,1.0,0.0
385486049,1,33,3,30,0.09090909090909091,0.9090909090909091
80950771,0,177,169,8,0.9548022598870056,0.04519774011299435
293735774,1,348,104,244,0.2988505747126437,0.7011494252873564
220547128,0,1000,1000,0,1.0,0.0
199312800,1,102,5,97,0.049019607843137254,0.9509803921568627
975455713056223233,0,121,119,2,0.9834710743801653,0.01652892561983471
1361144504426913794,1,33,6,27,0.18181818181818182,0.8181818181818182
875450030131466241,0,649,649,0,1.0,0.0
1080277959850774529,1,56,3,53,0.05357142857142857,0.9464285714285714
1516957666014281729,0,19,19,0,1.0,0.0
1516260724686917633,1,1,1,0,1.0,0.0
709351249,0,1000,999,1,0.999,0.001
3015714057,1,323,94,229,0.29102167182662536,0.7089783281733746
1073413977521049600,0,49,49,0,1.0,0.0
301450268,1,1000,170,830,0.17,0.83
136091840,0,860,860,0,1.0,0.0
15621359,1,1000,166,834,0.166,0.834
1236040429377925120,0,228,228,0,1.0,0.0
1511889452536414209,1,137,19,118,0.1386861313868613,0.8613138686131386
1491419495868637192,0,249,248,1,0.9959839357429718,0.004016064257028112
423099090,1,405,22,383,0.05432098765432099,0.945679012345679
2516826355,0,1000,998,2,0.998,0.002
754570367793033216,1,103,10,93,0.0970873786407767,0.9029126213592233
301222170,0,76,67,9,0.881578947368421,0.11842105263157894
1311621162,1,223,65,158,0.2914798206278027,0.7085201793721974
30812208,0,60,60,0,1.0,0.0
946874809,1,340,23,317,0.06764705882352941,0.9323529411764706
911733146562867200,0,366,326,40,0.8907103825136612,0.1092896174863388
30002691,1,270,4,266,0.014814814814814815,0.9851851851851852
952690761627205632,0,339,339,0,1.0,0.0
2323134578,1,474,31,443,0.06540084388185655,0.9345991561181435
146666649,0,123,123,0,1.0,0.0
2841111,1,1000,22,978,0.022,0.978
270325553,0,43,42,1,0.9767441860465116,0.023255813953488372
106181954,1,223,74,149,0.33183856502242154,0.6681614349775785
53174701,0,1000,996,4,0.996,0.004
66413399,1,1000,121,879,0.121,0.879
917009162,1,244,10,234,0.040983606557377046,0.9590163934426229
1379059040223891460,0,24,24,0,1.0,0.0
1110012557253926912,1,528,18,510,0.03409090909090909,0.9659090909090909
1011469631461232640,0,25,25,0,1.0,0.0
16645680,1,1000,123,877,0.123,0.877
1367820308594491396,0,86,86,0,1.0,0.0
1729978231,1,843,125,718,0.14827995255041518,0.8517200474495848
1182494348040163328,0,94,94,0,1.0,0.0
292668172,1,1000,34,966,0.034,0.966
262402605,0,1000,997,3,0.997,0.003
18009083,1,1000,105,895,0.105,0.895
17348887,0,1000,999,1,0.999,0.001
1285441400604106752,1,21,5,16,0.23809523809523808,0.7619047619047619
569619791,0,1000,965,35,0.965,0.035
885503825821540352,1,1000,216,784,0.216,0.784
48618454,1,535,144,391,0.2691588785046729,0.7308411214953271
754648237739343872,0,1000,993,7,0.993,0.007
16029434,1,86,8,78,0.09302325581395349,0.9069767441860465
15391364,0,922,915,7,0.9924078091106291,0.007592190889370932
969617903640129536,1,47,5,42,0.10638297872340426,0.8936170212765957
52205743,1,267,16,251,0.0599250936329588,0.9400749063670412
214968735,0,16,16,0,1.0,0.0
934639928926982144,1,47,7,40,0.14893617021276595,0.851063829787234
273177601,0,136,135,1,0.9926470588235294,0.007352941176470588
16064144,1,1000,107,893,0.107,0.893
294113459,0,1000,987,13,0.987,0.013
2886511835,1,1000,82,918,0.082,0.918
1152799757020147713,0,10,10,0,1.0,0.0
4850358674,1,396,21,375,0.05303030303030303,0.946969696969697
3255937518,0,57,56,1,0.9824561403508771,0.017543859649122806
293223064,1,1000,320,680,0.32,0.68
1445092078615240710,0,423,415,8,0.9810874704491725,0.018912529550827423
855922623531765761,1,191,19,172,0.09947643979057591,0.900523560209424
857572134,0,65,63,2,0.9692307692307692,0.03076923076923077
18596244,1,1000,19,981,0.019,0.981
1169250939665965056,0,5,5,0,1.0,0.0
188892000,1,69,4,65,0.057971014492753624,0.9420289855072463
181662527,0,494,494,0,1.0,0.0
700056252,1,424,5,419,0.01179245283018868,0.9882075471698113
4798440033,0,38,38,0,1.0,0.0
1307277024,1,1000,39,961,0.039,0.961
849701439878332416,0,628,549,79,0.8742038216560509,0.12579617834394904
167155081,1,760,17,743,0.02236842105263158,0.9776315789473684
1256744371547893760,0,13,13,0,1.0,0.0
900860336,1,959,239,720,0.2492179353493222,0.7507820646506778
158843256,1,261,19,242,0.07279693486590039,0.9272030651340997
1136271834285035521,0,459,457,2,0.9956427015250545,0.004357298474945534
1063191522806587397,1,1000,101,899,0.101,0.899
182895150,0,1000,993,7,0.993,0.007
1013270991428915200,1,1000,189,811,0.189,0.811
2357349049,0,482,456,26,0.946058091286307,0.05394190871369295
625057188,1,1000,185,815,0.185,0.815
425275196,0,110,110,0,1.0,0.0
1007498495639674880,1,109,2,107,0.01834862385321101,0.981651376146789
860895227938168832,0,402,397,5,0.9875621890547264,0.012437810945273632
79035757,1,150,4,146,0.02666666666666667,0.9733333333333334
65398659,0,661,649,12,0.9818456883509834,0.018154311649016642
2746098316,1,1000,311,689,0.311,0.689
1049698073889390593,0,76,70,6,0.9210526315789473,0.07894736842105263
919890763,1,1000,325,675,0.325,0.675
1233477989997912064,0,46,45,1,0.9782608695652174,0.021739130434782608
335077586,1,220,16,204,0.07272727272727272,0.9272727272727272
2830699030,0,84,70,14,0.8333333333333334,0.16666666666666666
248385938,1,119,4,115,0.03361344537815126,0.9663865546218487
4429616659,0,6,6,0,1.0,0.0
748241041019527169,1,102,11,91,0.10784313725490197,0.8921568627450981
1493193829,0,80,80,0,1.0,0.0
1091881113553907714,1,15,1,14,0.06666666666666667,0.9333333333333333
41553770,0,330,330,0,1.0,0.0
1457175227570470916,1,238,83,155,0.3487394957983193,0.6512605042016807
1502209150058696704,0,6,6,0,1.0,0.0
703798214894288896,1,130,19,111,0.14615384615384616,0.8538461538461538
1474100084,0,85,84,1,0.9882352941176471,0.011764705882352941
16968425,1,244,45,199,0.18442622950819673,0.8155737704918032
172113066,0,3,3,0,1.0,0.0
830453272678854658,1,463,1,462,0.0021598272138228943,0.9978401727861771
256629501,0,141,134,7,0.950354609929078,0.04964539007092199
3279666679,1,861,188,673,0.2183507549361208,0.7816492450638792
1428663792901165056,0,42,42,0,1.0,0.0
2716347940,1,134,20,114,0.14925373134328357,0.8507462686567164
932353222622158848,0,844,747,97,0.8850710900473934,0.11492890995260663
2738007685,1,262,63,199,0.24045801526717558,0.7595419847328244
1371610798431277062,0,48,48,0,1.0,0.0
1270480773049724929,1,39,1,38,0.02564102564102564,0.9743589743589743
194472352,0,1000,991,9,0.991,0.009
1380989292,1,38,0,38,0.0,1.0
1495817464516689920,0,89,89,0,1.0,0.0
3062041392,1,1000,172,828,0.172,0.828
21585761,0,4,4,0,1.0,0.0
1422280179246845953,1,5,1,4,0.2,0.8
1214586524,0,43,43,0,1.0,0.0
128618614,1,1000,194,806,0.194,0.806
1518772044673941504,0,108,108,0,1.0,0.0
41582141,1,305,32,273,0.10491803278688525,0.8950819672131147
1055660162,0,136,135,1,0.9926470588235294,0.007352941176470588
91144719,1,52,11,41,0.21153846153846154,0.7884615384615384
2722096253,0,621,595,26,0.9581320450885669,0.04186795491143317
270108460,1,517,52,465,0.10058027079303675,0.8994197292069632
178772960,0,1000,998,2,0.998,0.002
704750992341016576,1,56,6,50,0.10714285714285714,0.8928571428571429
940671931182751744,0,1000,999,1,0.999,0.001
21424181,1,219,22,197,0.1004566210045662,0.8995433789954338
2563575233,0,386,386,0,1.0,0.0
911036951003828224,1,186,34,152,0.1827956989247312,0.8172043010752689
708807556576055296,0,64,63,1,0.984375,0.015625
785294844935540736,1,158,3,155,0.0189873417721519,0.9810126582278481
363843884,0,722,720,2,0.997229916897507,0.002770083102493075
17274580,1,136,14,122,0.10294117647058823,0.8970588235294118
1343219584707555328,0,53,48,5,0.9056603773584906,0.09433962264150944
3364066995,1,306,18,288,0.058823529411764705,0.9411764705882353
1484741144248471554,0,46,46,0,1.0,0.0
371026737,1,989,21,968,0.021233569261880688,0.9787664307381193
1078806760218079232,0,57,57,0,1.0,0.0
2358808632,1,255,5,250,0.0196078431372549,0.9803921568627451
315572062,0,514,513,1,0.9980544747081712,0.0019455252918287938
18079495,1,1000,60,940,0.06,0.94
143702991,0,1000,973,27,0.973,0.027
880222061389598721,1,56,15,41,0.26785714285714285,0.7321428571428571
1393614450,0,1000,976,24,0.976,0.024
236607011,1,122,16,106,0.13114754098360656,0.8688524590163934
883115083341197312,0,393,372,21,0.9465648854961832,0.05343511450381679
1301036714207649792,1,224,44,180,0.19642857142857142,0.8035714285714286
164162154,0,1000,996,4,0.996,0.004
1013981,1,607,16,591,0.026359143327841845,0.9736408566721582
19953824,0,200,179,21,0.895,0.105
3299968003,1,1000,147,853,0.147,0.853
1026640694398472192,0,18,18,0,1.0,0.0
1081670903086206976,1,270,18,252,0.06666666666666667,0.9333333333333333
138283644,0,33,30,3,0.9090909090909091,0.09090909090909091
497316757,1,1000,160,840,0.16,0.84
1499416059883008009,0,1000,964,36,0.964,0.036
395948217,1,441,26,415,0.05895691609977324,0.9410430839002267
92654480,0,1000,993,7,0.993,0.007
1207819105417474049,1,39,17,22,0.4358974358974359,0.5641025641025641
1526777005680779264,0,34,34,0,1.0,0.0
1240471491692703744,1,21,5,16,0.23809523809523808,0.7619047619047619
1212563166439202816,0,267,263,4,0.9850187265917603,0.0149812734082397
2901964710,1,308,17,291,0.05519480519480519,0.9448051948051948
33970665,0,1000,908,92,0.908,0.092
76963934,1,293,46,247,0.15699658703071673,0.8430034129692833
1355606143842791424,0,336,335,1,0.9970238095238095,0.002976190476190476
1468988009231970306,1,71,3,68,0.04225352112676056,0.9577464788732394
1215213081669853184,0,2,2,0,1.0,0.0
18148467,1,469,13,456,0.02771855010660981,0.9722814498933902
1372841132908896256,0,17,17,0,1.0,0.0
520433338,1,378,9,369,0.023809523809523808,0.9761904761904762
409470846,0,5,5,0,1.0,0.0
923196051716235265,1,575,116,459,0.20173913043478262,0.7982608695652174
700662340027461632,0,25,25,0,1.0,0.0
1061600461898309632,1,1000,83,917,0.083,0.917
1050188592444858369,0,232,231,1,0.9956896551724138,0.004310344827586207
891386164204253184,1,49,9,40,0.1836734693877551,0.8163265306122449
827171484707733509,0,296,280,16,0.9459459459459459,0.05405405405405406
1018453243792449537,1,43,7,36,0.16279069767441862,0.8372093023255814
379838451,0,1000,1000,0,1.0,0.0
1296137283779923969,1,19,1,18,0.05263157894736842,0.9473684210526315
3392001533,0,6,6,0,1.0,0.0
883406313580933121,1,42,15,27,0.35714285714285715,0.6428571428571429
956739278230507521,0,396,366,30,0.9242424242424242,0.07575757575757576
191907445,1,349,31,318,0.08882521489971347,0.9111747851002865
328768793,0,1000,1000,0,1.0,0.0
313727019,1,1000,66,934,0.066,0.934
389225700,0,174,174,0,1.0,0.0
1084543100,1,127,7,120,0.05511811023622047,0.9448818897637795
1441349766797922307,0,11,10,1,0.9090909090909091,0.09090909090909091
1329619452002934784,1,97,17,80,0.17525773195876287,0.8247422680412371
1283404304926289920,0,85,75,10,0.8823529411764706,0.11764705882352941
1120566144702791680,1,141,33,108,0.23404255319148937,0.7659574468085106
94680533,0,356,355,1,0.9971910112359551,0.0028089887640449437
34697706,1,370,55,315,0.14864864864864866,0.8513513513513513
1061324154794926088,0,637,574,63,0.9010989010989011,0.0989010989010989
1305769082,1,94,9,85,0.09574468085106383,0.9042553191489362
1424026961140125705,0,8,8,0,1.0,0.0
18572783,1,210,45,165,0.21428571428571427,0.7857142857142857
1452289997416112141,0,45,45,0,1.0,0.0
1008483933028155392,1,76,3,73,0.039473684210526314,0.9605263157894737
450197109,0,594,594,0,1.0,0.0
711838766,1,177,13,164,0.07344632768361582,0.9265536723163842
1019119951607627776,0,1000,970,30,0.97,0.03
1069708687864926208,1,736,254,482,0.3451086956521739,0.654891304347826
949077874971172864,0,91,89,2,0.978021978021978,0.02197802197802198
73661887,1,168,9,159,0.05357142857142857,0.9464285714285714
14233485,0,1000,965,35,0.965,0.035
269567050,1,160,16,144,0.1,0.9
1451728328,0,558,498,60,0.8924731182795699,0.10752688172043011
3012378441,1,1000,213,787,0.213,0.787
1011317962396094470,0,218,217,1,0.9954128440366973,0.0045871559633027525
763510362922549249,1,234,20,214,0.08547008547008547,0.9145299145299145
1453040738,0,463,451,12,0.9740820734341252,0.02591792656587473
1121409471924908032,1,1000,30,970,0.03,0.97
731217296870477825,0,12,12,0,1.0,0.0
93901666,1,1000,93,907,0.093,0.907
1054956932824477698,0,109,107,2,0.981651376146789,0.01834862385321101
2906969559,1,1000,172,828,0.172,0.828
1251009092862144512,0,48,47,1,0.9791666666666666,0.020833333333333332
1497239627379453952,1,32,3,29,0.09375,0.90625
389236413,0,174,174,0,1.0,0.0
341980192,1,319,17,302,0.05329153605015674,0.9467084639498433
746284261,0,63,63,0,1.0,0.0
942638765352411137,1,5,1,4,0.2,0.8
1499878999224467457,0,7,7,0,1.0,0.0
1550862121,1,443,92,351,0.2076749435665914,0.7923250564334086
1181973180929449987,0,6,6,0,1.0,0.0
1271202488138502157,1,405,92,313,0.2271604938271605,0.7728395061728395
1101751836,0,497,492,5,0.9899396378269618,0.01006036217303823
1353516003666354188,1,22,2,20,0.09090909090909091,0.9090909090909091
393703502,0,802,788,14,0.9825436408977556,0.017456359102244388
757890973,1,66,20,46,0.30303030303030304,0.696969696969697
1212962162320130050,1,187,23,164,0.12299465240641712,0.8770053475935828
16910141,1,246,29,217,0.11788617886178862,0.8821138211382114
1107154145381892096,0,121,120,1,0.9917355371900827,0.008264462809917356
2437689775,1,482,190,292,0.3941908713692946,0.6058091286307054
1479347643432198145,0,176,175,1,0.9943181818181818,0.005681818181818182
1275928094298251266,1,14,1,13,0.07142857142857142,0.9285714285714286
731882147041050625,0,130,130,0,1.0,0.0
482338695,1,1000,98,902,0.098,0.902
1362700174791831560,0,52,52,0,1.0,0.0
467930907,1,1000,221,779,0.221,0.779
99334853,0,692,676,16,0.976878612716763,0.023121387283236993
296047890,1,844,2,842,0.002369668246445498,0.9976303317535545
2397246367,0,184,183,1,0.9945652173913043,0.005434782608695652
1457320541141049349,1,121,38,83,0.3140495867768595,0.6859504132231405
1034917130339119104,0,487,478,9,0.9815195071868583,0.018480492813141684
1173735041723195392,1,44,5,39,0.11363636363636363,0.8863636363636364
9902582,1,150,12,138,0.08,0.92
148538436,0,226,211,15,0.9336283185840708,0.06637168141592921
116929774,1,1000,82,918,0.082,0.918
1400661095358947329,0,6,6,0,1.0,0.0
1449872748,1,1000,265,735,0.265,0.735
1447647088574144513,0,1000,1000,0,1.0,0.0
765337054968422400,1,314,42,272,0.1337579617834395,0.8662420382165605
38798035,0,362,362,0,1.0,0.0
728315675073122304,1,940,26,914,0.027659574468085105,0.9723404255319149
137399913,0,328,326,2,0.9939024390243902,0.006097560975609756
1511529766238699521,1,89,37,52,0.4157303370786517,0.5842696629213483
238150147,0,18,18,0,1.0,0.0
1854074754,1,372,48,324,0.12903225806451613,0.8709677419354839
1456517739602907143,0,123,123,0,1.0,0.0
1571641525,1,697,57,640,0.08177905308464849,0.9182209469153515
1071494053349519361,0,460,456,4,0.991304347826087,0.008695652173913044
110806709,1,939,83,856,0.08839190628328009,0.9116080937167199
2653009243,0,958,903,55,0.94258872651357,0.05741127348643006
867974300833153025,1,720,54,666,0.075,0.925
929054521,0,51,51,0,1.0,0.0
980997424293478400,1,1000,327,673,0.327,0.673
334138693,0,635,634,1,0.9984251968503937,0.0015748031496062992
1190336482881474560,1,810,62,748,0.07654320987654321,0.9234567901234568
48049436,0,727,710,17,0.9766162310866575,0.023383768913342505
42175241,1,80,1,79,0.0125,0.9875
323906687,0,192,187,5,0.9739583333333334,0.026041666666666668
2758028338,1,1000,52,948,0.052,0.948
254914185,0,82,82,0,1.0,0.0
15823984,1,756,148,608,0.19576719576719576,0.8042328042328042
477955953,0,307,285,22,0.9283387622149837,0.07166123778501629
2168587896,1,1000,170,830,0.17,0.83
188429262,0,11,10,1,0.9090909090909091,0.09090909090909091
1012047769723285504,1,169,43,126,0.25443786982248523,0.7455621301775148
27857716,0,305,305,0,1.0,0.0
17751831,1,116,25,91,0.21551724137931033,0.7844827586206896
1326617461890965504,0,151,150,1,0.9933774834437086,0.006622516556291391
525560785,1,117,18,99,0.15384615384615385,0.8461538461538461
75330601,0,76,75,1,0.9868421052631579,0.013157894736842105
894734335365963777,1,41,9,32,0.21951219512195122,0.7804878048780488
317422986,0,27,27,0,1.0,0.0
2203548597,1,322,12,310,0.037267080745341616,0.9627329192546584
339179325,0,1000,994,6,0.994,0.006
3894168381,1,42,6,36,0.14285714285714285,0.8571428571428571
1184506388,0,350,349,1,0.9971428571428571,0.002857142857142857
1303445525954531329,1,1000,28,972,0.028,0.972
1212220773873532928,0,13,12,1,0.9230769230769231,0.07692307692307693
138614588,1,141,51,90,0.3617021276595745,0.6382978723404256
1204913612256624640,0,289,272,17,0.9411764705882353,0.058823529411764705
18381846,1,159,3,156,0.018867924528301886,0.9811320754716981
2209427999,0,43,43,0,1.0,0.0
14933852,1,1000,65,935,0.065,0.935
4743449124,0,15,15,0,1.0,0.0
1057403565407387651,1,441,39,402,0.08843537414965986,0.9115646258503401
37320408,0,13,12,1,0.9230769230769231,0.07692307692307693
1319683320561717248,1,278,38,240,0.1366906474820144,0.8633093525179856
1470207042786938885,0,219,219,0,1.0,0.0
2818397648,1,1000,113,887,0.113,0.887
820680140,0,1000,995,5,0.995,0.005
3095047781,1,1000,32,968,0.032,0.968
1327012825873715207,0,53,53,0,1.0,0.0
900701838714040320,1,344,24,320,0.06976744186046512,0.9302325581395349
110283254,0,258,257,1,0.9961240310077519,0.003875968992248062
70706023,1,142,29,113,0.20422535211267606,0.795774647887324
38265569,0,135,119,16,0.8814814814814815,0.11851851851851852
811048416709054465,0,40,40,0,1.0,0.0
281312879,1,174,23,151,0.13218390804597702,0.867816091954023
16209083,0,260,260,0,1.0,0.0
2534492055,1,243,11,232,0.04526748971193416,0.9547325102880658
1210762242,0,302,301,1,0.9966887417218543,0.0033112582781456954
24847384,1,404,16,388,0.039603960396039604,0.9603960396039604
864197773,0,3,3,0,1.0,0.0
54423596,0,392,392,0,1.0,0.0
923551046089216008,1,45,11,34,0.24444444444444444,0.7555555555555555
1501450081307824132,0,15,15,0,1.0,0.0
6512482,1,1000,165,835,0.165,0.835
839264134210314240,0,220,217,3,0.9863636363636363,0.013636363636363636
56607198,1,1000,55,945,0.055,0.945
940785777335787521,0,1000,988,12,0.988,0.012
1085269131102957569,1,474,11,463,0.023206751054852322,0.9767932489451476
984262673079693313,0,221,221,0,1.0,0.0
1019624703047106560,1,46,6,40,0.13043478260869565,0.8695652173913043
708081124,0,126,126,0,1.0,0.0
45399422,1,1000,16,984,0.016,0.984
852845368391979014,0,1000,1000,0,1.0,0.0
16162215,1,255,43,212,0.16862745098039217,0.8313725490196079
150870895,0,1000,999,1,0.999,0.001
63631386,1,1000,171,829,0.171,0.829
456109432,0,1000,990,10,0.99,0.01
836755926791110660,1,354,130,224,0.3672316384180791,0.632768361581921
886431283,0,485,484,1,0.9979381443298969,0.002061855670103093
12795322,1,1000,187,813,0.187,0.813
3326670449,0,401,401,0,1.0,0.0
1214660734803730432,1,199,2,197,0.010050251256281407,0.9899497487437185
38984192,0,57,56,1,0.9824561403508771,0.017543859649122806
1123790361137221638,1,1000,45,955,0.045,0.955
1722086180,0,139,139,0,1.0,0.0
1233292030492561409,1,133,6,127,0.045112781954887216,0.9548872180451128
369280657,0,613,607,6,0.9902120717781403,0.009787928221859706
573753951,1,988,24,964,0.024291497975708502,0.9757085020242915
910965744,0,292,292,0,1.0,0.0
1457053299627147266,1,992,99,893,0.09979838709677419,0.9002016129032258
2953573973,0,1000,858,142,0.858,0.142
858153623666208768,1,59,5,54,0.0847457627118644,0.9152542372881356
2292804382,0,72,67,5,0.9305555555555556,0.06944444444444445
363326502,1,59,7,52,0.11864406779661017,0.8813559322033898
1515054242964205568,0,31,31,0,1.0,0.0
1118528298005553153,1,247,25,222,0.10121457489878542,0.8987854251012146
1055294762226540544,0,125,125,0,1.0,0.0
3236346218,1,200,27,173,0.135,0.865
50695389,0,74,73,1,0.9864864864864865,0.013513513513513514
2173907014,1,58,14,44,0.2413793103448276,0.7586206896551724
1495653771677868035,0,57,56,1,0.9824561403508771,0.017543859649122806
1399514073394401280,1,339,86,253,0.2536873156342183,0.7463126843657817
990044387181723648,0,383,381,2,0.9947780678851175,0.005221932114882507
827983790,1,391,17,374,0.043478260869565216,0.9565217391304348
1427095328491069443,0,418,389,29,0.930622009569378,0.06937799043062201
2358905879,1,429,9,420,0.02097902097902098,0.9790209790209791
1314036920138293252,0,19,19,0,1.0,0.0
16696636,1,656,88,568,0.13414634146341464,0.8658536585365854
1098674581299228675,0,759,757,2,0.997364953886693,0.002635046113306983
725067325393784837,1,1000,225,775,0.225,0.775
1466417324387450894,0,279,279,0,1.0,0.0
1887815930,1,1000,143,857,0.143,0.857
1684321501,0,115,115,0,1.0,0.0
921317659,1,114,41,73,0.35964912280701755,0.6403508771929824
237126905,0,1000,947,53,0.947,0.053
703898318,1,229,81,148,0.3537117903930131,0.6462882096069869
2196067467,0,557,556,1,0.9982046678635548,0.0017953321364452424
908114118716125184,1,140,22,118,0.15714285714285714,0.8428571428571429
120591929,0,464,464,0,1.0,0.0
1062551900921356288,1,215,23,192,0.10697674418604651,0.8930232558139535
783763128,0,3,3,0,1.0,0.0
719872596842516480,1,253,32,221,0.12648221343873517,0.8735177865612648
2829408154,0,371,371,0,1.0,0.0
46920733,1,348,4,344,0.011494252873563218,0.9885057471264368
323294528,0,229,192,37,0.8384279475982532,0.1615720524017467
1292342068249952256,1,594,102,492,0.1717171717171717,0.8282828282828283
739898933271363584,0,468,460,8,0.9829059829059829,0.017094017094017096
817780730797375489,1,651,197,454,0.30261136712749614,0.6973886328725039
24279966,0,408,395,13,0.9681372549019608,0.031862745098039214
161786654,1,1000,54,946,0.054,0.946
88087007,0,292,289,3,0.9897260273972602,0.010273972602739725
1206265657,1,83,2,81,0.024096385542168676,0.9759036144578314
91470256,0,204,204,0,1.0,0.0
591951730,1,1000,24,976,0.024,0.976
832512208710094848,0,200,200,0,1.0,0.0
822779477717614592,1,1000,18,982,0.018,0.982
4378079063,0,430,430,0,1.0,0.0
2315717678,1,260,6,254,0.023076923076923078,0.9769230769230769
19186802,0,239,221,18,0.9246861924686193,0.07531380753138076
524780823,1,732,5,727,0.006830601092896175,0.9931693989071039
909985708802060290,0,6,6,0,1.0,0.0
42034987,1,286,32,254,0.11188811188811189,0.8881118881118881
1467972243863048198,0,1000,979,21,0.979,0.021
56493945,1,124,8,116,0.06451612903225806,0.9354838709677419
4251124179,0,2,2,0,1.0,0.0
936117519064035328,1,287,102,185,0.3554006968641115,0.6445993031358885
3572467814,0,137,134,3,0.9781021897810219,0.021897810218978103
1075507362293841920,1,37,4,33,0.10810810810810811,0.8918918918918919
163503491,0,121,120,1,0.9917355371900827,0.008264462809917356
1435691597841108996,1,30,4,26,0.13333333333333333,0.8666666666666667
76249137,0,93,93,0,1.0,0.0
1439092320289361923,1,1000,50,950,0.05,0.95
1265915948038590465,0,12,12,0,1.0,0.0
1069739461330829312,1,1000,40,960,0.04,0.96
1361533556720242696,0,520,519,1,0.9980769230769231,0.0019230769230769232
57262800,1,174,24,150,0.13793103448275862,0.8620689655172413
30045742,0,151,151,0,1.0,0.0
2716427183,1,33,5,28,0.15151515151515152,0.8484848484848485
1686723050,0,253,253,0,1.0,0.0
1119940601947017227,1,1000,188,812,0.188,0.812
1506710012818694146,0,56,50,6,0.8928571428571429,0.10714285714285714
415669942,1,521,171,350,0.32821497120921306,0.6717850287907869
2262919911,0,520,520,0,1.0,0.0
33674587,1,237,10,227,0.04219409282700422,0.9578059071729957
770022748475252739,0,310,263,47,0.8483870967741935,0.15161290322580645
1280658513338028034,1,44,8,36,0.18181818181818182,0.8181818181818182
793498399240839168,0,588,569,19,0.967687074829932,0.03231292517006803
858857425285373952,1,318,65,253,0.20440251572327045,0.7955974842767296
1377655714181701633,0,73,73,0,1.0,0.0
325949439,1,174,35,139,0.20114942528735633,0.7988505747126436
615243320,0,33,33,0,1.0,0.0
3614211917,0,139,136,3,0.9784172661870504,0.02158273381294964
1433591669409075202,1,1000,105,895,0.105,0.895
3182167735,0,67,64,3,0.9552238805970149,0.04477611940298507
1244452547311460352,1,15,3,12,0.2,0.8
780151105946787840,0,210,210,0,1.0,0.0
925798253337051136,0,993,911,82,0.9174219536757301,0.08257804632426989
393646856,1,114,2,112,0.017543859649122806,0.9824561403508771
1519940121293774851,0,104,103,1,0.9903846153846154,0.009615384615384616
824766972424359936,1,337,26,311,0.0771513353115727,0.9228486646884273
4209252673,0,12,11,1,0.9166666666666666,0.08333333333333333
1354567256949198849,0,3,3,0,1.0,0.0
980395220,1,161,29,132,0.18012422360248448,0.8198757763975155
1401782989089132553,0,165,159,6,0.9636363636363636,0.03636363636363636
3375934216,1,353,2,351,0.0056657223796034,0.9943342776203966
4362381868,0,1000,997,3,0.997,0.003
234130532,1,84,26,58,0.30952380952380953,0.6904761904761905
345923596,0,14,14,0,1.0,0.0
42685931,1,1000,184,816,0.184,0.816
389155601,0,428,423,5,0.9883177570093458,0.011682242990654205
281707046,1,1000,146,854,0.146,0.854
36179545,0,1000,952,48,0.952,0.048
19506509,0,25,25,0,1.0,0.0
733799664,1,74,11,63,0.14864864864864866,0.8513513513513513
1057341191593885696,0,129,122,7,0.9457364341085271,0.05426356589147287
113392260,1,294,33,261,0.11224489795918367,0.8877551020408163
958134166540996608,0,579,577,2,0.9965457685664939,0.0034542314335060447
1170049421243015168,1,2,2,0,1.0,0.0
887189862406733829,0,340,339,1,0.9970588235294118,0.0029411764705882353
20257093,1,1000,221,779,0.221,0.779
780218589496250368,0,412,408,4,0.9902912621359223,0.009708737864077669
821526918847528960,0,79,78,1,0.9873417721518988,0.012658227848101266
1127557370828283904,1,997,230,767,0.23069207622868607,0.769307923771314
1248883345804505090,0,1000,814,186,0.814,0.186
1303108978914791425,1,334,114,220,0.3413173652694611,0.6586826347305389
293229822,0,757,708,49,0.9352708058124174,0.06472919418758256
230944158,1,1000,106,894,0.106,0.894
1332306973673594886,0,1000,991,9,0.991,0.009
46026213,1,209,34,175,0.16267942583732056,0.8373205741626795
1263169783228436480,0,115,111,4,0.9652173913043478,0.034782608695652174
844928048633917442,1,91,3,88,0.03296703296703297,0.967032967032967
716476548098854914,1,212,37,175,0.17452830188679244,0.8254716981132075
1447294652,0,982,972,10,0.9898167006109979,0.010183299389002037
823656303994118144,1,23,4,19,0.17391304347826086,0.8260869565217391
1345331845819371522,0,155,154,1,0.9935483870967742,0.0064516129032258064
19871552,1,101,25,76,0.24752475247524752,0.7524752475247525
1063935027594039297,0,37,37,0,1.0,0.0
1072860262082826241,1,1000,28,972,0.028,0.972
1215569989,0,890,890,0,1.0,0.0
829555236490579968,0,20,20,0,1.0,0.0
1862893501,1,387,14,373,0.03617571059431524,0.9638242894056848
1210238441503502337,0,1000,977,23,0.977,0.023
121273085,1,26,2,24,0.07692307692307693,0.9230769230769231
3733455859,1,262,7,255,0.026717557251908396,0.9732824427480916
1183858579079487489,0,170,154,16,0.9058823529411765,0.09411764705882353
1466281729212116992,1,40,4,36,0.1,0.9
831597936,0,237,224,13,0.9451476793248945,0.05485232067510549
19929940,0,1000,945,55,0.945,0.055
1210706080025595904,1,48,10,38,0.20833333333333334,0.7916666666666666
383607779,0,300,295,5,0.9833333333333333,0.016666666666666666
1467883719088168963,1,199,18,181,0.09045226130653267,0.9095477386934674
551294719,0,197,196,1,0.9949238578680203,0.005076142131979695
1012606293478203394,1,256,5,251,0.01953125,0.98046875
221069193,0,82,82,0,1.0,0.0
3840950294,1,104,39,65,0.375,0.625
1000502492067745792,0,12,12,0,1.0,0.0
1053395023897735168,1,92,20,72,0.21739130434782608,0.782608695652174
1478043407410946049,0,6,6,0,1.0,0.0
3214603065,1,389,4,385,0.010282776349614395,0.9897172236503856
1152664422323818496,0,26,26,0,1.0,0.0
9885942,1,415,12,403,0.02891566265060241,0.9710843373493976
1427059683848867847,0,20,20,0,1.0,0.0
843259821247926272,1,359,35,324,0.09749303621169916,0.9025069637883009
22709144,0,1000,969,31,0.969,0.031
1541419321,1,311,17,294,0.05466237942122187,0.9453376205787781
1513566636925616130,0,116,116,0,1.0,0.0
1927109622,1,446,17,429,0.03811659192825112,0.9618834080717489
31559965,0,1000,976,24,0.976,0.024
1330594373365542922,1,932,259,673,0.2778969957081545,0.7221030042918455
3035218798,0,17,17,0,1.0,0.0
766435813689286656,1,79,18,61,0.22784810126582278,0.7721518987341772
517241526,0,1000,999,1,0.999,0.001
861052948289208322,1,21,9,12,0.42857142857142855,0.5714285714285714
4241941334,0,358,336,22,0.9385474860335196,0.061452513966480445
920774717073539072,1,286,64,222,0.22377622377622378,0.7762237762237763
947251902819028992,0,155,154,1,0.9935483870967742,0.0064516129032258064
2946947340,1,277,26,251,0.09386281588447654,0.9061371841155235
4880089457,0,248,236,12,0.9516129032258065,0.04838709677419355
1207469637065162752,1,131,14,117,0.10687022900763359,0.8931297709923665
827577793525456899,1,43,4,39,0.09302325581395349,0.9069767441860465
985094171391332352,0,1000,1000,0,1.0,0.0
890279297063288832,1,993,123,870,0.12386706948640483,0.8761329305135952
868113024628002816,0,218,201,17,0.9220183486238532,0.0779816513761468
1268551316097335297,1,1000,97,903,0.097,0.903
1003302699713130500,0,32,30,2,0.9375,0.0625
1185019805327413249,1,68,14,54,0.20588235294117646,0.7941176470588235
212759709,0,139,138,1,0.9928057553956835,0.007194244604316547
1153037667241562112,1,84,18,66,0.21428571428571427,0.7857142857142857
877250204839403520,0,643,643,0,1.0,0.0
287681935,1,329,23,306,0.06990881458966565,0.9300911854103343
801109368511070208,0,127,127,0,1.0,0.0
157195269,1,1000,53,947,0.053,0.947
612783809,0,389,389,0,1.0,0.0
400413382,1,681,6,675,0.00881057268722467,0.9911894273127754
1488675935318528001,0,396,396,0,1.0,0.0
1397751828633243651,1,199,4,195,0.020100502512562814,0.9798994974874372
1462253568212283400,0,1,1,0,1.0,0.0
317332154,1,149,18,131,0.12080536912751678,0.8791946308724832
1138896960188846080,0,398,394,4,0.9899497487437185,0.010050251256281407
847108504234184704,1,69,6,63,0.08695652173913043,0.9130434782608695
1147670529366585344,0,138,138,0,1.0,0.0
1070083100330348547,1,30,4,26,0.13333333333333333,0.8666666666666667
1462192225220272138,0,138,138,0,1.0,0.0
2354027868,1,290,39,251,0.13448275862068965,0.8655172413793103
1505676387402850304,0,5,5,0,1.0,0.0
1492163070524854282,0,111,106,5,0.954954954954955,0.04504504504504504
197423541,1,300,31,269,0.10333333333333333,0.8966666666666666
219354637,0,1000,987,13,0.987,0.013
719712444155879432,1,21,3,18,0.14285714285714285,0.8571428571428571
499337422,0,5,5,0,1.0,0.0
4712625698,1,576,128,448,0.2222222222222222,0.7777777777777778
1069342049369960448,0,57,57,0,1.0,0.0
9998012,1,1000,20,980,0.02,0.98
4531653074,0,16,16,0,1.0,0.0
1038954495215128578,1,63,28,35,0.4444444444444444,0.5555555555555556
859507453918097408,0,173,173,0,1.0,0.0
1140426241704640513,1,144,26,118,0.18055555555555555,0.8194444444444444
70261323,0,482,482,0,1.0,0.0
849408816,1,421,67,354,0.15914489311163896,0.8408551068883611
866822525640216576,0,290,245,45,0.8448275862068966,0.15517241379310345
1461420788993560578,1,1000,40,960,0.04,0.96
1210595108858531841,0,40,40,0,1.0,0.0
367511288,1,945,40,905,0.042328042328042326,0.9576719576719577
630791628,0,428,422,6,0.985981308411215,0.014018691588785047
926520151,1,239,13,226,0.05439330543933055,0.9456066945606695
1300137062637678592,0,30,29,1,0.9666666666666667,0.03333333333333333
26013001,1,145,1,144,0.006896551724137931,0.993103448275862
1128730533524115456,0,16,16,0,1.0,0.0
881023362,1,26,4,22,0.15384615384615385,0.8461538461538461
27756966,0,718,642,76,0.8941504178272981,0.10584958217270195
895183582054031361,1,26,0,26,0.0,1.0
392842205,0,50,50,0,1.0,0.0
1198816603300941829,1,1000,201,799,0.201,0.799
311677530,0,532,530,2,0.9962406015037594,0.0037593984962406013
1438527828576768002,1,204,8,196,0.0392156862745098,0.9607843137254902
1494823473847275522,0,9,9,0,1.0,0.0
1472768685735436289,1,213,25,188,0.11737089201877934,0.8826291079812206
361764480,0,47,47,0,1.0,0.0
813880985016102912,1,322,17,305,0.052795031055900624,0.9472049689440993
16797786,0,245,239,6,0.9755102040816327,0.024489795918367346
3104795811,1,1000,0,1000,0.0,1.0
32011847,0,587,583,4,0.9931856899488927,0.0068143100511073255
1389233406806953990,1,703,95,608,0.13513513513513514,0.8648648648648649
707378438,0,18,18,0,1.0,0.0
883068494220328961,1,9,2,7,0.2222222222222222,0.7777777777777778
864614400744882176,0,147,145,2,0.9863945578231292,0.013605442176870748
29868684,1,878,70,808,0.07972665148063782,0.9202733485193622
228279426,0,1000,999,1,0.999,0.001
700931106896412672,1,142,9,133,0.06338028169014084,0.9366197183098591
1872786284,0,31,31,0,1.0,0.0
1425188576371699712,1,87,31,56,0.3563218390804598,0.6436781609195402
1318375503359733762,0,26,25,1,0.9615384615384616,0.038461538461538464
607354691,1,726,115,611,0.1584022038567493,0.8415977961432507
266780918,0,425,424,1,0.9976470588235294,0.002352941176470588
1319370839599493122,1,29,13,16,0.4482758620689655,0.5517241379310345
1479285677237940231,0,161,155,6,0.9627329192546584,0.037267080745341616
1346206612730617857,1,102,9,93,0.08823529411764706,0.9117647058823529
1227802465858392064,0,13,13,0,1.0,0.0
3002485553,1,372,39,333,0.10483870967741936,0.8951612903225806
4801672825,0,26,26,0,1.0,0.0
32156433,0,1000,979,21,0.979,0.021
30403595,1,535,72,463,0.13457943925233645,0.8654205607476636
533492565,0,479,475,4,0.9916492693110647,0.008350730688935281
1178321728755372035,1,28,0,28,0.0,1.0
57016458,0,71,71,0,1.0,0.0
1320784417187483649,1,24,1,23,0.041666666666666664,0.9583333333333334
1468352584553414656,0,478,460,18,0.9623430962343096,0.03765690376569038
983703889227608065,1,116,13,103,0.11206896551724138,0.8879310344827587
1710872245,0,304,302,2,0.993421052631579,0.006578947368421052
1178440387888705536,1,170,15,155,0.08823529411764706,0.9117647058823529
17600306,0,96,96,0,1.0,0.0
1191549362444345344,1,196,23,173,0.11734693877551021,0.8826530612244898
1268658862418165761,0,635,621,14,0.9779527559055118,0.02204724409448819
529048304,1,817,51,766,0.06242350061199511,0.9375764993880049
1461545991136374785,0,715,691,24,0.9664335664335665,0.033566433566433566
1025143698609168385,1,19,5,14,0.2631578947368421,0.7368421052631579
994729377085747201,0,109,108,1,0.9908256880733946,0.009174311926605505
20495969,1,1000,159,841,0.159,0.841
1382026028,0,467,466,1,0.9978586723768736,0.0021413276231263384
3068440758,1,120,29,91,0.24166666666666667,0.7583333333333333
442057563,0,831,831,0,1.0,0.0
18714511,1,1000,71,929,0.071,0.929
29597605,0,742,708,34,0.954177897574124,0.04582210242587601
1432818150085644289,1,150,33,117,0.22,0.78
405820398,0,82,76,6,0.926829268292683,0.07317073170731707
1508935995684700163,1,3,0,3,0.0,1.0
1132034690230169600,0,2,2,0,1.0,0.0
233674117,1,164,19,145,0.11585365853658537,0.8841463414634146
2797291486,0,74,74,0,1.0,0.0
214723934,1,458,13,445,0.028384279475982533,0.9716157205240175
554451611,0,112,109,3,0.9732142857142857,0.026785714285714284
2557625556,1,208,12,196,0.057692307692307696,0.9423076923076923
361243604,0,1000,975,25,0.975,0.025
1390738459,1,199,10,189,0.05025125628140704,0.949748743718593
3353742314,0,18,17,1,0.9444444444444444,0.05555555555555555
206526338,1,1000,184,816,0.184,0.816
1535203412010315776,0,129,129,0,1.0,0.0
712996148,1,832,84,748,0.10096153846153846,0.8990384615384616
737013741141757952,0,3,3,0,1.0,0.0
1388636026084724740,1,1000,278,722,0.278,0.722
2978625124,0,1000,931,69,0.931,0.069
826554393566785537,1,552,65,487,0.11775362318840579,0.8822463768115942
172179202,0,600,599,1,0.9983333333333333,0.0016666666666666668
17059866,1,1000,236,764,0.236,0.764
1364797268797190146,0,299,259,40,0.8662207357859532,0.13377926421404682
2949627057,1,156,6,150,0.038461538461538464,0.9615384615384616
1208951688016609281,0,332,278,54,0.8373493975903614,0.16265060240963855
2176033069,1,1000,305,695,0.305,0.695
919200594,0,854,851,3,0.9964871194379391,0.00351288056206089
399206337,1,107,3,104,0.028037383177570093,0.9719626168224299
1439431849844039683,0,36,36,0,1.0,0.0
1504291308487286795,1,8,0,8,0.0,1.0
28624542,1,1000,18,982,0.018,0.982
601211641,0,83,83,0,1.0,0.0
2404780848,1,17,0,17,0.0,1.0
1856117070,0,64,64,0,1.0,0.0
1020204231242833921,0,64,64,0,1.0,0.0
1664032628,1,242,29,213,0.11983471074380166,0.8801652892561983
870742915164905472,0,13,13,0,1.0,0.0
3854864053,1,485,63,422,0.12989690721649486,0.8701030927835052
146771896,0,228,215,13,0.9429824561403509,0.05701754385964912
1687405916,1,1000,138,862,0.138,0.862
251732918,0,546,544,2,0.9963369963369964,0.003663003663003663
15657399,1,803,129,674,0.16064757160647572,0.8393524283935243
1476390909831008264,0,24,24,0,1.0,0.0
776918385489608704,1,12,0,12,0.0,1.0
1204913508825141248,0,121,121,0,1.0,0.0
319896706,1,576,69,507,0.11979166666666667,0.8802083333333334
329314356,0,1000,999,1,0.999,0.001
24848284,1,243,41,202,0.16872427983539096,0.831275720164609
1267613276487192577,0,113,112,1,0.9911504424778761,0.008849557522123894
1170509564061638658,1,757,162,595,0.21400264200792601,0.7859973579920739
842505830289326084,0,262,252,10,0.9618320610687023,0.03816793893129771
4100681705,0,361,354,7,0.9806094182825484,0.019390581717451522
895490517588475904,1,192,29,163,0.15104166666666666,0.8489583333333334
2916676406,0,98,98,0,1.0,0.0
1007381429884542976,1,403,93,310,0.23076923076923078,0.7692307692307693
862944583,0,414,414,0,1.0,0.0
976238490240409600,1,174,8,166,0.04597701149425287,0.9540229885057471
1461259276333158401,0,122,122,0,1.0,0.0
317936026,1,338,28,310,0.08284023668639054,0.9171597633136095
1442377214,0,1000,999,1,0.999,0.001
935242769852915712,1,500,138,362,0.276,0.724
995750681805033473,0,366,352,14,0.9617486338797814,0.03825136612021858
1299342410833592321,1,52,9,43,0.17307692307692307,0.8269230769230769
305958258,0,218,215,3,0.9862385321100917,0.013761467889908258
3363306975,1,45,2,43,0.044444444444444446,0.9555555555555556
102208753,0,635,632,3,0.9952755905511811,0.004724409448818898
15694379,1,215,36,179,0.16744186046511628,0.8325581395348837
953285955917664256,0,140,137,3,0.9785714285714285,0.02142857142857143
771815472689995776,1,37,6,31,0.16216216216216217,0.8378378378378378
1309303115850674176,0,382,382,0,1.0,0.0
1147217595243716609,1,499,71,428,0.14228456913827656,0.8577154308617234
1423943903380742144,0,156,155,1,0.9935897435897436,0.00641025641025641
284073207,1,1000,51,949,0.051,0.949
989905420495048704,0,77,77,0,1.0,0.0
857008922506539008,1,99,15,84,0.15151515151515152,0.8484848484848485
3033324172,0,1000,919,81,0.919,0.081
2245979155,1,398,23,375,0.05778894472361809,0.9422110552763819
1345513312499474432,0,32,32,0,1.0,0.0
3973867156,1,255,8,247,0.03137254901960784,0.9686274509803922
1296921387798540288,0,405,389,16,0.9604938271604938,0.03950617283950617
776225117122785280,1,399,131,268,0.3283208020050125,0.6716791979949874
1464610720973307923,0,37,37,0,1.0,0.0
1338467036264067076,1,271,91,180,0.33579335793357934,0.6642066420664207
1029575748,0,634,623,11,0.9826498422712934,0.017350157728706624
35112320,1,138,3,135,0.021739130434782608,0.9782608695652174
1184383300053458949,0,1000,993,7,0.993,0.007
1179799067653574657,0,247,246,1,0.9959514170040485,0.004048582995951417
859049980971151365,1,75,22,53,0.29333333333333333,0.7066666666666667
1113367768265580544,0,124,119,5,0.9596774193548387,0.04032258064516129
1915638655,1,102,17,85,0.16666666666666666,0.8333333333333334
23782772,0,272,269,3,0.9889705882352942,0.011029411764705883
68583134,1,1000,167,833,0.167,0.833
1229832059838980099,0,54,53,1,0.9814814814814815,0.018518518518518517
824317955504799751,1,77,20,57,0.2597402597402597,0.7402597402597403
1467741028136341508,0,34,32,2,0.9411764705882353,0.058823529411764705
3251995713,1,327,47,280,0.1437308868501529,0.8562691131498471
603703631,1,141,9,132,0.06382978723404255,0.9361702127659575
1327601941938106372,0,206,205,1,0.9951456310679612,0.0048543689320388345
3461571434,1,479,180,299,0.3757828810020877,0.6242171189979123
1018896294,0,870,870,0,1.0,0.0
10657652,1,484,14,470,0.028925619834710745,0.9710743801652892
107264343,0,356,327,29,0.9185393258426966,0.08146067415730338
1046163568067047427,1,470,111,359,0.23617021276595745,0.7638297872340426
1302426604371677188,0,501,500,1,0.998003992015968,0.001996007984031936
1021260843806347264,1,175,19,156,0.10857142857142857,0.8914285714285715
1187755452,0,1000,993,7,0.993,0.007
1168009172450861060,1,24,7,17,0.2916666666666667,0.7083333333333334
551405743,0,30,30,0,1.0,0.0
1121831032431316992,1,214,6,208,0.028037383177570093,0.9719626168224299
958190864823738368,0,178,177,1,0.9943820224719101,0.0056179775280898875
1282856728132849664,1,488,62,426,0.12704918032786885,0.8729508196721312
1086003935356350465,0,566,564,2,0.9964664310954063,0.0035335689045936395
3071221025,1,229,40,189,0.17467248908296942,0.8253275109170306
1068752391695228928,0,48,48,0,1.0,0.0
980366629451137026,1,1000,18,982,0.018,0.982
2330923484,0,6,4,2,0.6666666666666666,0.3333333333333333
1223031800932503552,1,1000,88,912,0.088,0.912
50277640,0,331,328,3,0.9909365558912386,0.00906344410876133
991119423477035009,1,115,16,99,0.1391304347826087,0.8608695652173913
18206079,1,555,106,449,0.19099099099099098,0.809009009009009
1368261525199261703,0,9,8,1,0.8888888888888888,0.1111111111111111
1272952914231922698,1,534,37,497,0.06928838951310862,0.9307116104868914
770286563628494848,0,1000,896,104,0.896,0.104
615506640,1,350,91,259,0.26,0.74
1089430914646532096,0,140,139,1,0.9928571428571429,0.007142857142857143
863065216384249858,1,308,74,234,0.24025974025974026,0.7597402597402597
343434808,0,146,146,0,1.0,0.0
788487013,1,221,13,208,0.058823529411764705,0.9411764705882353
1482374468437626880,0,4,4,0,1.0,0.0
2273845268,1,295,15,280,0.05084745762711865,0.9491525423728814
1422462044972986371,0,281,281,0,1.0,0.0
444375235,1,235,37,198,0.1574468085106383,0.8425531914893617
1154580144746586112,0,393,393,0,1.0,0.0
815288163497365504,1,226,70,156,0.30973451327433627,0.6902654867256637
16988625,1,1000,6,994,0.006,0.994
767951146275184640,0,579,575,4,0.9930915371329879,0.0069084628670120895
1365337801521307652,1,189,16,173,0.08465608465608465,0.9153439153439153
35056792,0,129,128,1,0.9922480620155039,0.007751937984496124
56084376,1,651,20,631,0.030721966205837174,0.9692780337941628
486343450,0,470,463,7,0.9851063829787234,0.014893617021276596
34540379,1,1000,202,798,0.202,0.798
1513230530191380480,0,208,199,9,0.9567307692307693,0.04326923076923077
9841042,1,1000,63,937,0.063,0.937
14611544,1,957,33,924,0.034482758620689655,0.9655172413793104
1129736167815909376,0,44,44,0,1.0,0.0
1446324585700356106,1,87,17,70,0.19540229885057472,0.8045977011494253
318473802,0,745,739,6,0.9919463087248322,0.008053691275167786
1172466469,1,166,13,153,0.0783132530120482,0.9216867469879518
33617636,0,1000,961,39,0.961,0.039
933395251,1,127,18,109,0.14173228346456693,0.8582677165354331
3012898054,0,1000,993,7,0.993,0.007
713673576,1,443,81,362,0.18284424379232506,0.8171557562076749
1623031411,0,186,185,1,0.9946236559139785,0.005376344086021506
2910180869,1,385,74,311,0.19220779220779222,0.8077922077922078
2990384396,0,760,757,3,0.9960526315789474,0.003947368421052632
36230829,1,313,10,303,0.03194888178913738,0.9680511182108626
325649413,0,274,272,2,0.9927007299270073,0.0072992700729927005
1344518365034008577,1,118,23,95,0.19491525423728814,0.8050847457627118
1058836022874693632,0,107,104,3,0.9719626168224299,0.028037383177570093
372488479,1,420,58,362,0.1380952380952381,0.861904761904762
1243618882230931456,0,1000,959,41,0.959,0.041
1201465410,1,56,13,43,0.23214285714285715,0.7678571428571429
340613703,0,1000,997,3,0.997,0.003
1067884761207717888,1,204,62,142,0.30392156862745096,0.696078431372549
776972356279345152,0,118,118,0,1.0,0.0
714440248172761088,1,302,65,237,0.2152317880794702,0.7847682119205298
1423570469496758275,0,729,728,1,0.9986282578875172,0.0013717421124828531
62062562,1,1000,3,997,0.003,0.997
1141113552075415552,0,1000,982,18,0.982,0.018
1128752191991308288,1,969,72,897,0.07430340557275542,0.9256965944272446
40017222,0,82,82,0,1.0,0.0
1402815937070370817,1,360,86,274,0.2388888888888889,0.7611111111111111
1381771543051710468,0,235,235,0,1.0,0.0
3337279307,1,85,0,85,0.0,1.0
3995914873,0,47,47,0,1.0,0.0
2400608166,1,29,5,24,0.1724137931034483,0.8275862068965517
1333893264429125633,0,50,44,6,0.88,0.12
991767416,1,398,10,388,0.02512562814070352,0.9748743718592965
826918967721746438,0,60,60,0,1.0,0.0
1120991818991247362,1,353,62,291,0.17563739376770537,0.8243626062322946
1049851137602580480,0,86,86,0,1.0,0.0
1028739278598221826,1,468,115,353,0.24572649572649571,0.7542735042735043
20805704,0,678,654,24,0.9646017699115044,0.035398230088495575
325727282,1,204,1,203,0.004901960784313725,0.9950980392156863
4700943795,0,892,889,3,0.9966367713004485,0.0033632286995515697
2992782463,1,620,21,599,0.03387096774193549,0.9661290322580646
1084195072671793152,0,223,196,27,0.8789237668161435,0.1210762331838565
1280294278619684868,1,16,4,12,0.25,0.75
3139640550,0,1000,988,12,0.988,0.012
1265494809868935168,1,130,9,121,0.06923076923076923,0.9307692307692308
220012134,0,1000,993,7,0.993,0.007
287654353,1,1000,116,884,0.116,0.884
19746199,1,1000,135,865,0.135,0.865
1503031982229495810,0,42,42,0,1.0,0.0
3820801465,1,149,25,124,0.16778523489932887,0.8322147651006712
20340045,0,758,746,12,0.9841688654353562,0.0158311345646438
704712215497060353,1,499,13,486,0.026052104208416832,0.9739478957915831
920342216,0,596,565,31,0.947986577181208,0.05201342281879195
331303868,1,326,34,292,0.10429447852760736,0.8957055214723927
787866828,0,380,359,21,0.9447368421052632,0.05526315789473684
1073096612,1,223,60,163,0.26905829596412556,0.7309417040358744
451815139,0,53,52,1,0.9811320754716981,0.018867924528301886
1500283628,1,100,20,80,0.2,0.8
614369360,0,1000,995,5,0.995,0.005
154725016,1,130,9,121,0.06923076923076923,0.9307692307692308
1495526239989293064,0,83,79,4,0.9518072289156626,0.04819277108433735
1432973424385687552,1,1000,9,991,0.009,0.991
824770093448036352,0,42,42,0,1.0,0.0
3613417708,1,1000,38,962,0.038,0.962
3000663105,0,132,130,2,0.9848484848484849,0.015151515151515152
918177757275836417,1,1000,234,766,0.234,0.766
323000755,0,196,193,3,0.9846938775510204,0.015306122448979591
768707270,1,52,13,39,0.25,0.75
34054073,0,480,474,6,0.9875,0.0125
1282498275241857024,1,116,21,95,0.1810344827586207,0.8189655172413793
1252952834468917249,0,681,680,1,0.9985315712187959,0.0014684287812041115
1494288721033801736,1,45,3,42,0.06666666666666667,0.9333333333333333
509761130,0,197,197,0,1.0,0.0
2962373596,1,436,15,421,0.034403669724770644,0.9655963302752294
3667124596,0,4,4,0,1.0,0.0
26778761,1,1000,26,974,0.026,0.974
1457802418784284677,0,190,190,0,1.0,0.0
185377350,1,1000,26,974,0.026,0.974
76968393,0,1000,988,12,0.988,0.012
3007036912,1,1000,101,899,0.101,0.899
936437491762069505,0,728,728,0,1.0,0.0
1405526114013831180,1,155,71,84,0.45806451612903226,0.5419354838709678
1139913370998575104,0,7,6,1,0.8571428571428571,0.14285714285714285
350104678,1,397,34,363,0.08564231738035265,0.9143576826196473
2970077180,0,15,15,0,1.0,0.0
461459390,1,254,47,207,0.18503937007874016,0.8149606299212598
119767850,1,202,3,199,0.01485148514851485,0.9851485148514851
1229193840810168322,0,7,7,0,1.0,0.0
882472091169193984,1,14,2,12,0.14285714285714285,0.8571428571428571
1487241611448778753,0,5,5,0,1.0,0.0
2781188264,1,1000,91,909,0.091,0.909
490932780,0,1000,990,10,0.99,0.01
14713135,1,372,19,353,0.051075268817204304,0.9489247311827957
2816189491,0,201,191,10,0.9502487562189055,0.04975124378109453
4822647166,1,132,17,115,0.12878787878787878,0.8712121212121212
1463628972,0,770,767,3,0.9961038961038962,0.003896103896103896
2465064300,1,136,2,134,0.014705882352941176,0.9852941176470589
546612340,0,37,36,1,0.972972972972973,0.02702702702702703
905878745071796224,1,21,3,18,0.14285714285714285,0.8571428571428571
1486888285611905024,0,50,46,4,0.92,0.08
838205125,1,124,9,115,0.07258064516129033,0.9274193548387096
57370289,0,14,14,0,1.0,0.0
1337979974570151943,1,1000,187,813,0.187,0.813
23057384,0,271,264,7,0.974169741697417,0.025830258302583026
1301905394449739776,0,44,44,0,1.0,0.0
794683131387219968,1,33,2,31,0.06060606060606061,0.9393939393939394
1045842982866497536,1,142,23,119,0.1619718309859155,0.8380281690140845
1261756126330327050,0,1000,924,76,0.924,0.076
1070134676679942144,1,253,11,242,0.043478260869565216,0.9565217391304348
212711129,0,76,69,7,0.9078947368421053,0.09210526315789473
316815248,1,444,38,406,0.08558558558558559,0.9144144144144144
1020498951076761606,0,54,54,0,1.0,0.0
14890004,1,308,36,272,0.11688311688311688,0.8831168831168831
908899863336833024,0,96,96,0,1.0,0.0
782290717364236288,1,225,6,219,0.02666666666666667,0.9733333333333334
721247799384416256,0,313,305,8,0.9744408945686901,0.025559105431309903
49373310,1,198,11,187,0.05555555555555555,0.9444444444444444
222700143,0,291,289,2,0.993127147766323,0.006872852233676976
432863129,1,1000,194,806,0.194,0.806
2853943345,0,9,9,0,1.0,0.0
293791508,1,928,113,815,0.12176724137931035,0.8782327586206896
1525509008,0,29,29,0,1.0,0.0
305811981,1,816,47,769,0.05759803921568627,0.9424019607843137
17770818,0,590,584,6,0.9898305084745763,0.010169491525423728
318743314,1,179,9,170,0.05027932960893855,0.9497206703910615
39179042,0,676,675,1,0.9985207100591716,0.0014792899408284023
1465575595,1,1000,86,914,0.086,0.914
3377783735,0,387,381,6,0.9844961240310077,0.015503875968992248
369323735,1,1000,254,746,0.254,0.746
1479047025354178563,0,14,14,0,1.0,0.0
77598847,1,248,20,228,0.08064516129032258,0.9193548387096774
8414802,0,487,449,38,0.9219712525667351,0.07802874743326489
305817588,1,263,27,236,0.10266159695817491,0.8973384030418251
1253750771595702273,0,423,421,2,0.9952718676122931,0.004728132387706856
228969383,1,1000,314,686,0.314,0.686
62972583,0,38,36,2,0.9473684210526315,0.05263157894736842
4924206448,1,612,54,558,0.08823529411764706,0.9117647058823529
37089614,0,196,193,3,0.9846938775510204,0.015306122448979591
7994862,1,442,77,365,0.17420814479638008,0.8257918552036199
2432934109,0,243,243,0,1.0,0.0
1618994802,1,1000,139,861,0.139,0.861
1025207309654548481,0,172,170,2,0.9883720930232558,0.011627906976744186
1049107239880069125,1,258,33,225,0.12790697674418605,0.872093023255814
2348509904,0,719,672,47,0.9346314325452016,0.06536856745479833
1070896869004533762,1,283,75,208,0.26501766784452296,0.734982332155477
4678975952,0,117,113,4,0.9658119658119658,0.03418803418803419
1268794801752649728,1,1000,74,926,0.074,0.926
3739807996,0,141,141,0,1.0,0.0
113141657,1,166,1,165,0.006024096385542169,0.9939759036144579
357614509,0,389,354,35,0.910025706940874,0.08997429305912596
318508467,1,1000,105,895,0.105,0.895
954243752427532288,0,308,303,5,0.9837662337662337,0.016233766233766232
4884050076,1,23,1,22,0.043478260869565216,0.9565217391304348
768636531489636352,0,560,433,127,0.7732142857142857,0.22678571428571428
620662270,1,1000,382,618,0.382,0.618
1087688078876127232,0,42,42,0,1.0,0.0
4909819443,1,917,106,811,0.11559432933478735,0.8844056706652127
498626278,0,160,160,0,1.0,0.0
50702164,1,1000,26,974,0.026,0.974
1494424471016546307,0,591,578,13,0.9780033840947546,0.021996615905245348
2517978004,1,320,24,296,0.075,0.925
873899724,0,1000,951,49,0.951,0.049
1481777042966392836,1,2,0,2,0.0,1.0
1499624916194185216,0,2,2,0,1.0,0.0
3241934463,1,891,259,632,0.29068462401795736,0.7093153759820426
1450367786,0,1000,958,42,0.958,0.042
906828512,1,326,19,307,0.05828220858895705,0.941717791411043
1283806670846664707,0,61,59,2,0.9672131147540983,0.03278688524590164
483920867,1,329,43,286,0.13069908814589665,0.8693009118541033
31577853,0,437,436,1,0.9977116704805492,0.002288329519450801
2352171439,1,77,9,68,0.11688311688311688,0.8831168831168831
1471974371484971010,0,572,564,8,0.986013986013986,0.013986013986013986
2970370649,1,1000,131,869,0.131,0.869
53298866,0,1000,943,57,0.943,0.057
727602906,1,159,21,138,0.1320754716981132,0.8679245283018868
3990908590,0,280,278,2,0.9928571428571429,0.007142857142857143
4319938097,1,97,10,87,0.10309278350515463,0.8969072164948454
18498712,1,263,76,187,0.2889733840304182,0.7110266159695817
953295821780455426,0,28,28,0,1.0,0.0
1375615373991497730,1,12,1,11,0.08333333333333333,0.9166666666666666
891362959108091904,0,90,89,1,0.9888888888888889,0.011111111111111112
925806910837788672,1,119,5,114,0.04201680672268908,0.957983193277311
381691599,0,343,343,0,1.0,0.0
745506448491188224,1,313,92,221,0.2939297124600639,0.7060702875399361
2388250945,0,453,447,6,0.9867549668874173,0.013245033112582781
482243639,1,300,15,285,0.05,0.95
1925256252,0,116,116,0,1.0,0.0
968887754456293376,1,284,89,195,0.31338028169014087,0.6866197183098591
1305738582703968256,0,69,68,1,0.9855072463768116,0.014492753623188406
3367319897,1,733,145,588,0.19781718963165076,0.8021828103683493
932638316947738624,0,334,318,16,0.9520958083832335,0.04790419161676647
1157502812617658368,1,71,6,65,0.08450704225352113,0.9154929577464789
971886769653342209,0,23,23,0,1.0,0.0
14765609,1,325,111,214,0.3415384615384615,0.6584615384615384
1106945000,0,509,496,13,0.9744597249508841,0.025540275049115914
301210766,1,704,24,680,0.03409090909090909,0.9659090909090909
632956955,0,335,335,0,1.0,0.0
27090783,1,206,25,181,0.12135922330097088,0.8786407766990292
303539909,0,1000,993,7,0.993,0.007
2728096568,1,97,16,81,0.16494845360824742,0.8350515463917526
2317959284,0,125,124,1,0.992,0.008
42507172,1,1000,186,814,0.186,0.814
695691534788915200,0,1000,1000,0,1.0,0.0
821017521700663299,1,420,13,407,0.030952380952380953,0.969047619047619
434551418,0,644,641,3,0.9953416149068323,0.004658385093167702
39753421,0,325,319,6,0.9815384615384616,0.018461538461538463
823064193087586304,1,29,6,23,0.20689655172413793,0.7931034482758621
1078012119394603008,0,371,366,5,0.9865229110512129,0.013477088948787063
1236065033953488896,1,3,0,3,0.0,1.0
736653406736113664,0,66,66,0,1.0,0.0
930464094070513664,1,10,2,8,0.2,0.8
43181632,0,166,165,1,0.9939759036144579,0.006024096385542169
522548609,1,699,30,669,0.04291845493562232,0.9570815450643777
1482104103224287237,0,43,43,0,1.0,0.0
1246410256516857856,1,58,1,57,0.017241379310344827,0.9827586206896551
403664648,0,921,915,6,0.993485342019544,0.006514657980456026
454232252,1,816,253,563,0.31004901960784315,0.6899509803921569
913277928,0,315,308,7,0.9777777777777777,0.022222222222222223
1082333469798088704,1,403,72,331,0.17866004962779156,0.8213399503722084
1550935783,0,497,481,16,0.9678068410462777,0.03219315895372234
22076364,1,1000,185,815,0.185,0.815
700520762264985600,0,1000,880,120,0.88,0.12
247593625,1,576,114,462,0.19791666666666666,0.8020833333333334
800880974,0,964,873,91,0.9056016597510373,0.09439834024896265
1003068680736067585,1,1000,244,756,0.244,0.756
888136995305734144,0,97,92,5,0.9484536082474226,0.05154639175257732
947020986,1,287,98,189,0.34146341463414637,0.6585365853658537
948259171492941824,0,68,68,0,1.0,0.0
703850108400500738,1,234,30,204,0.1282051282051282,0.8717948717948718
3059463425,0,727,725,2,0.9972489683631361,0.002751031636863824
18283266,1,307,16,291,0.05211726384364821,0.9478827361563518
1358836078627729410,0,105,105,0,1.0,0.0
1410252013091364871,1,286,23,263,0.08041958041958042,0.9195804195804196
2216963622,0,612,608,4,0.9934640522875817,0.006535947712418301
48903992,1,815,35,780,0.04294478527607362,0.9570552147239264
1411119818221277194,0,31,31,0,1.0,0.0
3438801082,1,342,14,328,0.04093567251461988,0.9590643274853801
216781598,0,83,77,6,0.927710843373494,0.07228915662650602
1042300171768356864,1,37,2,35,0.05405405405405406,0.9459459459459459
52233287,0,1000,994,6,0.994,0.006
917145051846889472,1,492,119,373,0.241869918699187,0.758130081300813
1496705608669708297,0,73,73,0,1.0,0.0
1079559315265073152,1,115,19,96,0.16521739130434782,0.8347826086956521
407117884,0,81,77,4,0.9506172839506173,0.04938271604938271
2934255186,1,404,10,394,0.024752475247524754,0.9752475247524752
1705947679,0,207,206,1,0.9951690821256038,0.004830917874396135
1262993320797708289,1,30,0,30,0.0,1.0
1025402377862402049,0,96,89,7,0.9270833333333334,0.07291666666666667
1411757129241878528,1,122,29,93,0.23770491803278687,0.7622950819672131
1141996324272787456,1,21,2,19,0.09523809523809523,0.9047619047619048
767939371299246081,0,557,485,72,0.8707360861759426,0.12926391382405744
2347745875,1,229,54,175,0.23580786026200873,0.7641921397379913
870837623635402752,0,14,13,1,0.9285714285714286,0.07142857142857142
1148357679171166208,1,291,37,254,0.12714776632302405,0.872852233676976
1401176609298780170,1,16,1,15,0.0625,0.9375
769777635794702337,0,424,417,7,0.9834905660377359,0.01650943396226415
869955581011910657,1,62,7,55,0.11290322580645161,0.8870967741935484
386930885,0,651,614,37,0.9431643625192012,0.05683563748079877
1371603134385119232,1,56,5,51,0.08928571428571429,0.9107142857142857
1123812668169773057,0,1000,1000,0,1.0,0.0
1383342612543770630,1,444,61,383,0.1373873873873874,0.8626126126126126
1230329966103011328,0,184,184,0,1.0,0.0
1312157580479799296,1,28,1,27,0.03571428571428571,0.9642857142857143
1031819786,0,1000,984,16,0.984,0.016
1479002318112796674,1,257,36,221,0.14007782101167315,0.8599221789883269
1533146372492431360,0,114,114,0,1.0,0.0
1694898810,1,131,17,114,0.1297709923664122,0.8702290076335878
29185969,0,1000,993,7,0.993,0.007
814954718233563136,1,87,12,75,0.13793103448275862,0.8620689655172413
52178783,0,754,744,10,0.986737400530504,0.013262599469496022
2415299814,1,1000,147,853,0.147,0.853
22347406,0,12,12,0,1.0,0.0
886494613,1,19,3,16,0.15789473684210525,0.8421052631578947
17418906,0,1000,998,2,0.998,0.002
3229607266,0,14,14,0,1.0,0.0
1033879708298043392,1,527,124,403,0.23529411764705882,0.7647058823529411
330518178,0,183,182,1,0.994535519125683,0.00546448087431694
770916314592473088,1,78,18,60,0.23076923076923078,0.7692307692307693
1245226683994492930,0,57,48,9,0.8421052631578947,0.15789473684210525
1243325194879418368,1,192,7,185,0.036458333333333336,0.9635416666666666
526988488,0,70,70,0,1.0,0.0
1118539643404857344,1,569,67,502,0.11775043936731107,0.8822495606326889
3142892936,1,94,19,75,0.20212765957446807,0.7978723404255319
871426544358608900,0,1000,989,11,0.989,0.011
1419394365827526659,1,29,5,24,0.1724137931034483,0.8275862068965517
1350587387844374531,0,428,428,0,1.0,0.0
753669605382582272,1,513,95,418,0.18518518518518517,0.8148148148148148
1134172273634664448,0,160,156,4,0.975,0.025
937033699727691776,1,116,26,90,0.22413793103448276,0.7758620689655172
934945916066418688,0,997,996,1,0.9989969909729187,0.0010030090270812437
58264702,1,203,33,170,0.1625615763546798,0.8374384236453202
1513895348397297673,0,2,2,0,1.0,0.0
14270824,1,263,10,253,0.03802281368821293,0.9619771863117871
1478406798285623299,0,22,22,0,1.0,0.0
1045790095754842112,1,43,9,34,0.20930232558139536,0.7906976744186046
1238344978079739904,0,1000,846,154,0.846,0.154
4751871556,1,117,4,113,0.03418803418803419,0.9658119658119658
2841604200,0,273,271,2,0.9926739926739927,0.007326007326007326
1350852003845591043,1,784,24,760,0.030612244897959183,0.9693877551020408
1407045440218943493,0,48,48,0,1.0,0.0
414793848,0,332,304,28,0.9156626506024096,0.08433734939759036
2943634651,1,181,11,170,0.06077348066298342,0.9392265193370166
455334096,0,1000,996,4,0.996,0.004
128353178,1,1000,244,756,0.244,0.756
3703674555,0,1000,994,6,0.994,0.006
258000822,1,778,33,745,0.042416452442159386,0.9575835475578406
387860856,0,173,173,0,1.0,0.0
455340989,1,454,33,421,0.07268722466960352,0.9273127753303965
1121226373849407490,0,470,399,71,0.8489361702127659,0.15106382978723404
1184507000366850048,1,713,56,657,0.0785413744740533,0.9214586255259467
34789803,0,280,280,0,1.0,0.0
942533553711087618,1,235,70,165,0.2978723404255319,0.7021276595744681
31519201,0,405,403,2,0.9950617283950617,0.0049382716049382715
1477307622965616648,0,12,12,0,1.0,0.0
1204048133048668162,1,27,0,27,0.0,1.0
1112520610146648065,0,6,6,0,1.0,0.0
2430430843,1,147,7,140,0.047619047619047616,0.9523809523809523
811723596,0,375,370,5,0.9866666666666667,0.013333333333333334
1562100757,1,597,224,373,0.37520938023450584,0.6247906197654941
601777178,0,1000,1000,0,1.0,0.0
409490745,1,1000,118,882,0.118,0.882
1477662520965939205,0,2,2,0,1.0,0.0
1364992855505309703,1,115,9,106,0.0782608695652174,0.9217391304347826
1316873297766813697,0,208,170,38,0.8173076923076923,0.18269230769230768
1195946352,1,658,70,588,0.10638297872340426,0.8936170212765957
1150965001726787584,0,43,40,3,0.9302325581395349,0.06976744186046512
3054045651,1,106,7,99,0.0660377358490566,0.9339622641509434
2438503970,1,465,33,432,0.07096774193548387,0.9290322580645162
4764137834,0,432,431,1,0.9976851851851852,0.0023148148148148147
45567650,1,425,20,405,0.047058823529411764,0.9529411764705882
26342947,1,400,41,359,0.1025,0.8975
1487385118536876032,0,81,81,0,1.0,0.0
388018081,1,700,2,698,0.002857142857142857,0.9971428571428571
274996362,0,165,165,0,1.0,0.0
902970146,1,1000,10,990,0.01,0.99
899787310853742592,0,50,50,0,1.0,0.0
61078250,1,256,38,218,0.1484375,0.8515625
2560057382,0,300,300,0,1.0,0.0
163676200,1,324,38,286,0.11728395061728394,0.8827160493827161
2484428353,0,747,702,45,0.9397590361445783,0.060240963855421686
1106294650887917568,1,908,122,786,0.1343612334801762,0.8656387665198237
828419764473180161,0,904,844,60,0.9336283185840708,0.06637168141592921
267596389,1,186,25,161,0.13440860215053763,0.8655913978494624
2850772620,0,254,247,7,0.9724409448818898,0.027559055118110236
88749405,1,196,13,183,0.0663265306122449,0.9336734693877551
1323044194714329089,0,15,15,0,1.0,0.0
891412453145194496,1,947,92,855,0.09714889123548047,0.9028511087645196
1121926112563597312,0,51,50,1,0.9803921568627451,0.0196078431372549
155795275,1,193,54,139,0.27979274611398963,0.7202072538860104
876357163421192192,0,442,440,2,0.995475113122172,0.004524886877828055
816447811256516608,1,39,6,33,0.15384615384615385,0.8461538461538461
902339986665635841,0,181,167,14,0.9226519337016574,0.07734806629834254
1449962062856089600,1,76,7,69,0.09210526315789473,0.9078947368421053
774853772,0,1000,982,18,0.982,0.018
1010662847460921344,0,162,162,0,1.0,0.0
848227894451093504,1,32,2,30,0.0625,0.9375
1483733104250716164,0,40,40,0,1.0,0.0
903338536077713408,1,267,18,249,0.06741573033707865,0.9325842696629213
329771431,0,1000,998,2,0.998,0.002
324783461,1,580,23,557,0.039655172413793106,0.9603448275862069
792148883602190336,0,24,22,2,0.9166666666666666,0.08333333333333333
99009461,1,436,23,413,0.052752293577981654,0.9472477064220184
3307974272,0,30,30,0,1.0,0.0
1265691987681742848,1,794,170,624,0.2141057934508816,0.7858942065491183
66525767,0,1000,1000,0,1.0,0.0
1405311295,1,246,6,240,0.024390243902439025,0.975609756097561
1085423018,0,117,115,2,0.9829059829059829,0.017094017094017096
606914784,1,1000,58,942,0.058,0.942
572086275,0,985,978,7,0.9928934010152284,0.007106598984771574
391741675,1,22,3,19,0.13636363636363635,0.8636363636363636
29522936,0,115,114,1,0.991304347826087,0.008695652173913044
709469732160856064,1,781,103,678,0.13188220230473752,0.8681177976952625
2556012501,0,42,41,1,0.9761904761904762,0.023809523809523808
1128461882891866114,1,17,1,16,0.058823529411764705,0.9411764705882353
29149291,0,127,126,1,0.9921259842519685,0.007874015748031496
946970269,1,475,35,440,0.07368421052631578,0.9263157894736842
1668558524,0,1000,992,8,0.992,0.008
1338424454905352193,1,16,6,10,0.375,0.625
1502954688861421574,0,20,20,0,1.0,0.0
1066198387152875520,1,119,25,94,0.21008403361344538,0.7899159663865546
1054525345716568064,0,52,52,0,1.0,0.0
1078738517159751680,1,554,111,443,0.2003610108303249,0.7996389891696751
1427307206966349835,0,1,1,0,1.0,0.0
776906953759002626,1,103,12,91,0.11650485436893204,0.883495145631068
220724379,0,1000,997,3,0.997,0.003
735876007882805248,1,547,61,486,0.11151736745886655,0.8884826325411335
1486232116736278530,0,17,16,1,0.9411764705882353,0.058823529411764705
16724823,1,18,8,10,0.4444444444444444,0.5555555555555556
318911986,0,360,360,0,1.0,0.0
718349965,1,267,86,181,0.32209737827715357,0.6779026217228464
1363546664112373762,0,497,497,0,1.0,0.0
1038550567,1,177,22,155,0.12429378531073447,0.8757062146892656
1521723436426731520,0,2,2,0,1.0,0.0
1427503485524738051,1,31,10,21,0.3225806451612903,0.6774193548387096
1413197372,0,279,274,5,0.982078853046595,0.017921146953405017
1508195535399890950,1,76,5,71,0.06578947368421052,0.9342105263157895
159455613,0,11,11,0,1.0,0.0
497454203,1,80,9,71,0.1125,0.8875
348211924,0,716,716,0,1.0,0.0
1074568216113020928,1,187,81,106,0.43315508021390375,0.5668449197860963
493514575,0,39,39,0,1.0,0.0
2435786947,1,6,1,5,0.16666666666666666,0.8333333333333334
1092827307826237440,0,29,29,0,1.0,0.0
1013979236,1,279,24,255,0.08602150537634409,0.9139784946236559
1477506207631876099,0,1000,925,75,0.925,0.075
1023284017,1,555,24,531,0.043243243243243246,0.9567567567567568
1024400058035445760,0,136,136,0,1.0,0.0
448358746,1,397,21,376,0.05289672544080604,0.947103274559194
1139028230621413381,1,17,1,16,0.058823529411764705,0.9411764705882353
968239884,0,291,290,1,0.9965635738831615,0.003436426116838488
552020534,1,129,24,105,0.18604651162790697,0.813953488372093
4239768520,0,124,120,4,0.967741935483871,0.03225806451612903
42873122,1,354,103,251,0.2909604519774011,0.7090395480225988
843789242073595906,0,1000,981,19,0.981,0.019
88353151,1,288,42,246,0.14583333333333334,0.8541666666666666
32964565,0,1000,994,6,0.994,0.006
1532117042,1,318,42,276,0.1320754716981132,0.8679245283018868
66075053,0,1000,999,1,0.999,0.001
124526394,1,1000,352,648,0.352,0.648
2147534310,0,282,280,2,0.9929078014184397,0.0070921985815602835
26201509,1,613,68,545,0.11092985318107668,0.8890701468189234
1039523936835268608,0,1000,682,318,0.682,0.318
1193634668563902464,1,5,3,2,0.6,0.4
1071772138439348224,0,229,224,5,0.9781659388646288,0.021834061135371178
1502340822041169922,1,1,1,0,1.0,0.0
29854390,0,213,207,6,0.971830985915493,0.028169014084507043
719352290709086208,1,61,6,55,0.09836065573770492,0.9016393442622951
14957907,0,141,140,1,0.9929078014184397,0.0070921985815602835
1358575060710162433,1,20,1,19,0.05,0.95
165747537,0,1000,991,9,0.991,0.009
18733356,1,748,223,525,0.29812834224598933,0.7018716577540107
232007430,0,428,427,1,0.9976635514018691,0.002336448598130841
1180664396638560263,1,1000,99,901,0.099,0.901
1437776728470982669,0,393,366,27,0.9312977099236641,0.06870229007633588
1067108562550358017,1,203,12,191,0.059113300492610835,0.9408866995073891
713861510905204737,0,159,158,1,0.9937106918238994,0.006289308176100629
1478128123,1,254,58,196,0.2283464566929134,0.7716535433070866
1245831384716857344,0,1000,985,15,0.985,0.015
1005880182740344832,1,412,89,323,0.21601941747572814,0.7839805825242718
1135795693,0,32,31,1,0.96875,0.03125
859582373318492160,1,228,20,208,0.08771929824561403,0.9122807017543859
436059011,0,69,69,0,1.0,0.0
1268287896722780161,1,211,12,199,0.05687203791469194,0.943127962085308
1466857813091753987,0,1000,993,7,0.993,0.007
1034883468487024641,1,40,2,38,0.05,0.95
1454216837911220229,0,3,3,0,1.0,0.0
893191065318064128,1,7,1,6,0.14285714285714285,0.8571428571428571
90958042,0,1000,985,15,0.985,0.015
737039237233709056,1,1000,39,961,0.039,0.961
1374763357635497991,0,65,65,0,1.0,0.0
1310718026094989313,1,140,49,91,0.35,0.65
72486807,0,541,541,0,1.0,0.0
1112893217802936320,1,14,0,14,0.0,1.0
569191153,0,336,336,0,1.0,0.0
574042569,1,297,7,290,0.02356902356902357,0.9764309764309764
2374167432,0,23,23,0,1.0,0.0
1436744244182536202,0,5,4,1,0.8,0.2
2249464214,1,103,2,101,0.019417475728155338,0.9805825242718447
569509339,0,581,581,0,1.0,0.0
1133062615939239936,1,1000,50,950,0.05,0.95
269639059,0,760,759,1,0.9986842105263158,0.0013157894736842105
1224495121753870336,1,156,12,144,0.07692307692307693,0.9230769230769231
332015330,0,706,706,0,1.0,0.0
1015251335049072640,1,316,38,278,0.12025316455696203,0.879746835443038
1398116466403201024,0,436,435,1,0.9977064220183486,0.0022935779816513763
1123240124223979520,1,1000,20,980,0.02,0.98
198376584,0,232,217,15,0.9353448275862069,0.06465517241379311
1280583005766123520,1,861,24,837,0.027874564459930314,0.9721254355400697
858901952943464448,0,168,149,19,0.8869047619047619,0.1130952380952381
1180173357762916352,1,1000,55,945,0.055,0.945
185826743,0,166,165,1,0.9939759036144579,0.006024096385542169
1352715644303597568,1,43,5,38,0.11627906976744186,0.8837209302325582
284952128,0,576,574,2,0.9965277777777778,0.003472222222222222
1070443598880088065,1,1000,148,852,0.148,0.852
3311672082,0,47,47,0,1.0,0.0
214018531,1,1000,127,873,0.127,0.873
97258199,0,143,143,0,1.0,0.0
953037573684846592,1,77,8,69,0.1038961038961039,0.8961038961038961
1108101012374593541,0,434,432,2,0.9953917050691244,0.004608294930875576
15294292,1,462,41,421,0.08874458874458875,0.9112554112554112
2967965733,0,825,756,69,0.9163636363636364,0.08363636363636363
1071618248838402048,1,515,26,489,0.05048543689320388,0.9495145631067962
41895420,1,1000,70,930,0.07,0.93
1400123199023636481,0,211,211,0,1.0,0.0
1285577190885777416,1,155,41,114,0.2645161290322581,0.7354838709677419
4870944531,0,509,492,17,0.9666011787819253,0.03339882121807466
792527499049566208,1,33,10,23,0.30303030303030304,0.696969696969697
4889709215,0,51,51,0,1.0,0.0
1254732385893015554,0,298,292,6,0.9798657718120806,0.020134228187919462
2350297813,1,52,4,48,0.07692307692307693,0.9230769230769231
1377985039930073089,0,3,3,0,1.0,0.0
36419591,1,715,83,632,0.11608391608391608,0.8839160839160839
1455407867176103946,0,14,14,0,1.0,0.0
2864393788,1,1000,69,931,0.069,0.931
114917557,0,1000,1000,0,1.0,0.0
53709452,1,1000,206,794,0.206,0.794
631587538,1,167,18,149,0.10778443113772455,0.8922155688622755
37989554,0,1000,996,4,0.996,0.004
353226065,1,1000,114,886,0.114,0.886
1176772610245517312,0,1000,999,1,0.999,0.001
610544190,1,206,35,171,0.16990291262135923,0.8300970873786407
159882181,0,106,105,1,0.9905660377358491,0.009433962264150943
2279301230,1,242,18,224,0.0743801652892562,0.9256198347107438
1513537184091066371,0,62,62,0,1.0,0.0
4584491719,1,174,28,146,0.16091954022988506,0.8390804597701149
22460990,0,1000,1000,0,1.0,0.0
2996167971,1,1000,233,767,0.233,0.767
24954011,0,1000,999,1,0.999,0.001
74644149,1,276,28,248,0.10144927536231885,0.8985507246376812
1566486404,0,561,559,2,0.9964349376114082,0.0035650623885918
3408965652,1,276,9,267,0.03260869565217391,0.967391304347826
807251681369006080,0,436,433,3,0.9931192660550459,0.006880733944954129
244161661,1,1000,169,831,0.169,0.831
2569462052,0,14,14,0,1.0,0.0
1421133929524862976,1,30,5,25,0.16666666666666666,0.8333333333333334
1698211945,0,51,50,1,0.9803921568627451,0.0196078431372549
1331886541816270860,1,1000,60,940,0.06,0.94
1176914856,0,173,169,4,0.976878612716763,0.023121387283236993
749373780900937728,1,308,67,241,0.21753246753246752,0.7824675324675324
849371650290323456,0,41,41,0,1.0,0.0
958436987404464129,1,117,22,95,0.18803418803418803,0.811965811965812
784405287646076928,0,407,407,0,1.0,0.0
3113668621,1,599,36,563,0.06010016694490818,0.9398998330550918
108101526,1,1000,68,932,0.068,0.932
3230926400,0,312,307,5,0.9839743589743589,0.016025641025641024
1239321002884001793,1,44,7,37,0.1590909090909091,0.8409090909090909
1186290606269779968,0,30,29,1,0.9666666666666667,0.03333333333333333
961503306,1,862,244,618,0.28306264501160094,0.7169373549883991
1287793863994769408,0,29,29,0,1.0,0.0
712826762355298304,1,1000,89,911,0.089,0.911
1251608346945368064,0,58,58,0,1.0,0.0
1049394448843575298,1,65,10,55,0.15384615384615385,0.8461538461538461
3301894404,0,265,265,0,1.0,0.0
710299428884615169,1,1000,120,880,0.12,0.88
440220457,0,10,10,0,1.0,0.0
17053052,1,1000,219,781,0.219,0.781
1491952013973856256,0,6,6,0,1.0,0.0
2160937697,1,991,84,907,0.08476286579212916,0.9152371342078708
1457077958460444678,0,3,3,0,1.0,0.0
571136154,1,1000,5,995,0.005,0.995
27941945,0,101,101,0,1.0,0.0
32187305,1,68,13,55,0.19117647058823528,0.8088235294117647
443289384,0,481,441,40,0.9168399168399168,0.08316008316008316
2407857146,1,63,8,55,0.12698412698412698,0.873015873015873
996285530,0,306,306,0,1.0,0.0
831990219616485376,1,147,6,141,0.04081632653061224,0.9591836734693877
1046350201,0,1000,997,3,0.997,0.003
778316621546872832,1,133,11,122,0.08270676691729323,0.9172932330827067
46033765,0,1000,970,30,0.97,0.03
1244290737379979267,1,50,2,48,0.04,0.96
1537570226,0,264,205,59,0.7765151515151515,0.22348484848484848
42597316,1,353,24,329,0.0679886685552408,0.9320113314447592
1316776949969301507,0,211,211,0,1.0,0.0
345153655,1,1000,24,976,0.024,0.976
1156660708911788032,0,79,78,1,0.9873417721518988,0.012658227848101266
20120790,1,1000,69,931,0.069,0.931
2901996619,0,105,105,0,1.0,0.0
2862566319,1,94,5,89,0.05319148936170213,0.9468085106382979
938434071646035969,0,1000,980,20,0.98,0.02
2718146586,1,110,10,100,0.09090909090909091,0.9090909090909091
572279838,0,709,705,4,0.9943582510578279,0.005641748942172073
1480176007340515336,1,73,7,66,0.0958904109589041,0.9041095890410958
3024210924,0,44,44,0,1.0,0.0
1514688788345364490,1,112,26,86,0.23214285714285715,0.7678571428571429
1319817655965155328,0,24,23,1,0.9583333333333334,0.041666666666666664
747944981105500160,1,534,69,465,0.12921348314606743,0.8707865168539326
2575371022,0,162,162,0,1.0,0.0
1102748268,0,506,502,4,0.9920948616600791,0.007905138339920948
1421726309068115972,1,151,17,134,0.11258278145695365,0.8874172185430463
1439632697496903695,0,231,201,30,0.8701298701298701,0.12987012987012986
830249093729492993,1,1000,196,804,0.196,0.804
889649579276328961,0,201,200,1,0.9950248756218906,0.004975124378109453
1132061559918874625,1,230,58,172,0.25217391304347825,0.7478260869565218
846179392971771905,0,230,192,38,0.8347826086956521,0.16521739130434782
44367753,1,92,15,77,0.16304347826086957,0.8369565217391305
215724938,0,498,494,4,0.9919678714859438,0.008032128514056224
44217554,1,163,13,150,0.07975460122699386,0.9202453987730062
1072912486117052418,0,1000,993,7,0.993,0.007
25246476,1,201,21,180,0.1044776119402985,0.8955223880597015
375670355,0,123,123,0,1.0,0.0
334188306,1,1000,47,953,0.047,0.953
70204787,0,443,443,0,1.0,0.0
4914863053,1,1000,136,864,0.136,0.864
58501825,0,448,443,5,0.9888392857142857,0.011160714285714286
917491423514992641,1,102,45,57,0.4411764705882353,0.5588235294117647
234064297,0,400,400,0,1.0,0.0
855113923925872641,1,218,26,192,0.11926605504587157,0.8807339449541285
17852081,0,105,104,1,0.9904761904761905,0.009523809523809525
742941958381940736,1,89,12,77,0.1348314606741573,0.8651685393258427
1004544808248074243,0,1000,993,7,0.993,0.007
97781259,0,593,593,0,1.0,0.0
727569985,1,104,6,98,0.057692307692307696,0.9423076923076923
20554914,0,1000,999,1,0.999,0.001
1852471056,1,189,14,175,0.07407407407407407,0.9259259259259259
967254474,0,138,135,3,0.9782608695652174,0.021739130434782608
120905636,1,1000,76,924,0.076,0.924
362462684,0,80,78,2,0.975,0.025
311222715,1,158,4,154,0.02531645569620253,0.9746835443037974
25630708,0,56,55,1,0.9821428571428571,0.017857142857142856
325279631,1,248,26,222,0.10483870967741936,0.8951612903225806
72106237,0,1000,923,77,0.923,0.077
1240292254662696960,1,697,73,624,0.10473457675753228,0.8952654232424677
1468469749512216586,0,232,198,34,0.853448275862069,0.14655172413793102
1170863666742403075,1,95,26,69,0.2736842105263158,0.7263157894736842
20273732,0,132,132,0,1.0,0.0
473618205,1,348,51,297,0.14655172413793102,0.853448275862069
1540596460181508097,0,113,113,0,1.0,0.0
1374407534698659851,1,19,3,16,0.15789473684210525,0.8421052631578947
1103066617624358912,0,303,262,41,0.8646864686468647,0.1353135313531353
1499791089670184970,1,613,208,405,0.33931484502446985,0.6606851549755302
180544287,0,930,923,7,0.9924731182795699,0.007526881720430108
46716559,1,1000,64,936,0.064,0.936
4297849032,0,115,114,1,0.991304347826087,0.008695652173913044
3092566626,1,451,44,407,0.0975609756097561,0.9024390243902439
1136470837798809602,0,28,27,1,0.9642857142857143,0.03571428571428571
311397992,1,1000,62,938,0.062,0.938
1025469372335185920,0,31,31,0,1.0,0.0
17450745,1,408,12,396,0.029411764705882353,0.9705882352941176
307492917,0,796,775,21,0.9736180904522613,0.026381909547738693
1090643256189308935,1,64,21,43,0.328125,0.671875
877136143384555520,0,545,541,4,0.9926605504587156,0.007339449541284404
339452666,1,546,15,531,0.027472527472527472,0.9725274725274725
1167288220150894592,0,97,96,1,0.9896907216494846,0.010309278350515464
1272406706404888577,1,9,1,8,0.1111111111111111,0.8888888888888888
3098157781,0,231,230,1,0.9956709956709957,0.004329004329004329
820750194757238785,1,564,105,459,0.18617021276595744,0.8138297872340425
4047533055,0,3,3,0,1.0,0.0
1567074846,1,147,5,142,0.034013605442176874,0.9659863945578231
336158574,0,123,109,14,0.8861788617886179,0.11382113821138211
1532837222,1,80,20,60,0.25,0.75
1317793010,0,173,172,1,0.9942196531791907,0.005780346820809248
962949644,1,403,42,361,0.10421836228287841,0.8957816377171216
1020085921310543872,0,326,300,26,0.9202453987730062,0.07975460122699386
23211749,0,256,253,3,0.98828125,0.01171875
37069320,1,998,165,833,0.1653306613226453,0.8346693386773547
1041301835024236544,0,7,7,0,1.0,0.0
843651668629766146,1,673,153,520,0.22734026745913818,0.7726597325408618
1372957165359661056,0,5,5,0,1.0,0.0
1090023692732518400,1,175,44,131,0.25142857142857145,0.7485714285714286
972121365569404929,0,1000,992,8,0.992,0.008
747636363797889029,1,325,103,222,0.3169230769230769,0.683076923076923
3154705580,0,463,463,0,1.0,0.0
807727862,1,175,30,145,0.17142857142857143,0.8285714285714286
1299136755917094914,0,328,328,0,1.0,0.0
336101429,1,212,9,203,0.04245283018867924,0.9575471698113207
3181087830,0,116,112,4,0.9655172413793104,0.034482758620689655
2366304396,1,119,4,115,0.03361344537815126,0.9663865546218487
247473383,0,1000,997,3,0.997,0.003
121248535,1,1000,33,967,0.033,0.967
1383606924478795778,0,197,196,1,0.9949238578680203,0.005076142131979695
1391193635031556096,1,56,12,44,0.21428571428571427,0.7857142857142857
87740443,0,158,158,0,1.0,0.0
51959139,1,715,61,654,0.08531468531468532,0.9146853146853147
1003494144050900993,0,1000,999,1,0.999,0.001
462248572,1,73,1,72,0.0136986301369863,0.9863013698630136
728909036301602816,0,100,94,6,0.94,0.06
2305730396,1,1000,32,968,0.032,0.968
3416612907,0,209,209,0,1.0,0.0
21603919,1,107,3,104,0.028037383177570093,0.9719626168224299
763900480112254976,0,634,632,2,0.9968454258675079,0.0031545741324921135
963509299468156928,1,87,6,81,0.06896551724137931,0.9310344827586207
928273056,0,686,665,21,0.9693877551020408,0.030612244897959183
1329066899192377344,1,40,7,33,0.175,0.825
2434003005,0,275,218,57,0.7927272727272727,0.20727272727272728
52714853,0,316,306,10,0.9683544303797469,0.03164556962025317
1184678646679650305,1,8,2,6,0.25,0.75
329814602,0,365,359,6,0.9835616438356164,0.01643835616438356
925710506,1,116,15,101,0.12931034482758622,0.8706896551724138
240366906,0,983,956,27,0.9725330620549338,0.027466937945066123
1202678232895672320,1,586,21,565,0.03583617747440273,0.9641638225255973
70975371,0,939,936,3,0.9968051118210862,0.003194888178913738
1164349255361974273,1,100,4,96,0.04,0.96
946885694131142656,0,37,34,3,0.918918918918919,0.08108108108108109
160801446,0,329,295,34,0.8966565349544073,0.1033434650455927
9896342,1,624,37,587,0.05929487179487179,0.9407051282051282
35626241,0,32,32,0,1.0,0.0
906995467443167233,1,112,6,106,0.05357142857142857,0.9464285714285714
1425119943809503235,0,10,10,0,1.0,0.0
4092739228,1,1000,304,696,0.304,0.696
95217336,1,677,5,672,0.007385524372230428,0.9926144756277696
103217322,0,373,365,8,0.9785522788203753,0.021447721179624665
975801493990330368,1,193,38,155,0.19689119170984457,0.8031088082901554
1237524633726980096,0,970,965,5,0.9948453608247423,0.005154639175257732
2699954779,1,144,35,109,0.24305555555555555,0.7569444444444444
62352126,0,756,749,7,0.9907407407407407,0.009259259259259259
4435733653,1,57,8,49,0.14035087719298245,0.8596491228070176
51521652,0,1000,793,207,0.793,0.207
834729566,1,299,11,288,0.03678929765886288,0.9632107023411371
1519523741839118336,0,63,63,0,1.0,0.0
1414733364834275331,1,1000,19,981,0.019,0.981
185444064,0,694,633,61,0.9121037463976945,0.08789625360230548
1297588222432870400,0,310,308,2,0.9935483870967742,0.0064516129032258064
1499212334807535618,1,79,2,77,0.02531645569620253,0.9746835443037974
14329764,0,1000,792,208,0.792,0.208
1344487015874777089,1,110,36,74,0.32727272727272727,0.6727272727272727
63808526,0,579,572,7,0.9879101899827288,0.012089810017271158
3285892411,1,24,2,22,0.08333333333333333,0.9166666666666666
16729308,0,1000,922,78,0.922,0.078
4662655696,1,128,38,90,0.296875,0.703125
230166150,0,474,472,2,0.9957805907172996,0.004219409282700422
930940143854407680,1,169,46,123,0.27218934911242604,0.727810650887574
176982823,0,424,416,8,0.9811320754716981,0.018867924528301886
209924674,1,775,123,652,0.15870967741935485,0.8412903225806452
3543023959,1,121,8,113,0.06611570247933884,0.9338842975206612
1098270488495837184,0,332,330,2,0.9939759036144579,0.006024096385542169
62202488,1,497,43,454,0.08651911468812877,0.9134808853118712
158469409,0,1000,979,21,0.979,0.021
1267454541844426757,1,71,18,53,0.2535211267605634,0.7464788732394366
3176508822,0,88,88,0,1.0,0.0
706736184,1,1000,227,773,0.227,0.773
776601558247104513,0,28,27,1,0.9642857142857143,0.03571428571428571
350357527,1,123,4,119,0.032520325203252036,0.967479674796748
34575967,0,1000,986,14,0.986,0.014
1458310764,1,286,13,273,0.045454545454545456,0.9545454545454546
369202556,0,387,387,0,1.0,0.0
2917940886,1,367,30,337,0.08174386920980926,0.9182561307901907
550549513,0,69,61,8,0.8840579710144928,0.11594202898550725
1130217759051264002,1,1000,68,932,0.068,0.932
1217305897703096320,0,178,159,19,0.8932584269662921,0.10674157303370786
15152509,1,526,156,370,0.2965779467680608,0.7034220532319392
5866192,0,1000,967,33,0.967,0.033
113394459,1,699,71,628,0.10157367668097282,0.8984263233190272
1333275027534475265,0,25,25,0,1.0,0.0
811916168743133184,1,2,0,2,0.0,1.0
1187749620,0,449,449,0,1.0,0.0
821134719823839232,1,35,5,30,0.14285714285714285,0.8571428571428571
417834756,0,255,255,0,1.0,0.0
19300461,1,1000,322,678,0.322,0.678
357215540,0,328,327,1,0.9969512195121951,0.003048780487804878
886220915561951232,1,1000,51,949,0.051,0.949
124250681,0,212,212,0,1.0,0.0
748326916747202561,1,483,72,411,0.14906832298136646,0.8509316770186336
854352522294722560,0,10,10,0,1.0,0.0
995138283440091136,1,214,32,182,0.14953271028037382,0.8504672897196262
606654182,0,446,439,7,0.984304932735426,0.01569506726457399
2847002746,1,174,66,108,0.3793103448275862,0.6206896551724138
463520620,0,1000,1000,0,1.0,0.0
694598454685732865,1,1000,129,871,0.129,0.871
38948761,0,230,230,0,1.0,0.0
1131035347889131520,1,30,2,28,0.06666666666666667,0.9333333333333333
525804194,0,446,446,0,1.0,0.0
1082814059207147520,1,725,32,693,0.044137931034482755,0.9558620689655173
769374418489466880,0,92,92,0,1.0,0.0
974314688606502912,1,120,23,97,0.19166666666666668,0.8083333333333333
1107803991063347200,0,70,60,10,0.8571428571428571,0.14285714285714285
5622042,1,1000,96,904,0.096,0.904
1420197930145918980,0,51,51,0,1.0,0.0
818959040797609984,1,1000,189,811,0.189,0.811
316538398,0,30,30,0,1.0,0.0
1402364444,1,222,21,201,0.0945945945945946,0.9054054054054054
281626432,0,830,823,7,0.9915662650602409,0.008433734939759036
1938608077,1,1000,104,896,0.104,0.896
922173030998204418,0,83,83,0,1.0,0.0
372062990,1,439,25,414,0.05694760820045558,0.9430523917995444
1482320251111018496,0,1,1,0,1.0,0.0
1399964946163814400,1,87,15,72,0.1724137931034483,0.8275862068965517
291676299,0,204,194,10,0.9509803921568627,0.049019607843137254
1274804095077847040,1,5,3,2,0.6,0.4
1708622587,0,1000,999,1,0.999,0.001
87299157,1,358,21,337,0.05865921787709497,0.9413407821229051
1322190541518479362,0,141,139,2,0.9858156028368794,0.014184397163120567
898638517412044801,1,338,79,259,0.23372781065088757,0.7662721893491125
82699265,0,35,35,0,1.0,0.0
2526253910,1,21,3,18,0.14285714285714285,0.8571428571428571
778002890690404352,0,25,25,0,1.0,0.0
58855056,1,1000,273,727,0.273,0.727
1485756385224581121,0,39,39,0,1.0,0.0
951278678524289024,1,400,47,353,0.1175,0.8825
935571792,0,8,8,0,1.0,0.0
61676088,1,1000,130,870,0.13,0.87
340161453,0,477,477,0,1.0,0.0
394394885,1,520,34,486,0.06538461538461539,0.9346153846153846
886057422040821760,0,18,18,0,1.0,0.0
3026341577,1,1000,168,832,0.168,0.832
567731594,0,398,387,11,0.9723618090452262,0.02763819095477387
816937234050011136,1,240,51,189,0.2125,0.7875
1205083012397973504,0,54,54,0,1.0,0.0
845213982,0,1000,987,13,0.987,0.013
1362252857794248707,1,53,11,42,0.20754716981132076,0.7924528301886793
1422742435088699403,0,1,1,0,1.0,0.0
716288931407339520,1,67,6,61,0.08955223880597014,0.9104477611940298
837311115063353344,0,5,5,0,1.0,0.0
791042927438860288,1,241,67,174,0.27800829875518673,0.7219917012448133
1039190950092800002,0,89,87,2,0.9775280898876404,0.02247191011235955
4780375574,1,117,6,111,0.05128205128205128,0.9487179487179487
15986651,0,542,541,1,0.9981549815498155,0.0018450184501845018
45752282,1,566,168,398,0.2968197879858657,0.7031802120141343
2335242415,0,37,37,0,1.0,0.0
1296543056540377091,1,200,34,166,0.17,0.83
1121148515139276800,0,6,6,0,1.0,0.0
1251317878269161473,1,466,40,426,0.08583690987124463,0.9141630901287554
34608824,0,56,50,6,0.8928571428571429,0.10714285714285714
928368325159030784,1,154,7,147,0.045454545454545456,0.9545454545454546
950660967188361216,0,32,31,1,0.96875,0.03125
265092981,1,80,15,65,0.1875,0.8125
378136527,0,121,119,2,0.9834710743801653,0.01652892561983471
8345942,1,276,16,260,0.057971014492753624,0.9420289855072463
3224251411,0,22,22,0,1.0,0.0
1336775319152447497,1,999,149,850,0.14914914914914915,0.8508508508508509
626081006,0,1000,999,1,0.999,0.001
815424628470464512,1,1000,195,805,0.195,0.805
4692705631,0,131,127,4,0.9694656488549618,0.030534351145038167
1666623781,1,698,29,669,0.04154727793696275,0.9584527220630372
2372061613,0,472,461,11,0.9766949152542372,0.023305084745762712
1139617611128496128,1,29,2,27,0.06896551724137931,0.9310344827586207
125036987,0,18,18,0,1.0,0.0
605759242,1,126,33,93,0.2619047619047619,0.7380952380952381
244826432,0,24,24,0,1.0,0.0
2246251727,1,253,38,215,0.15019762845849802,0.849802371541502
2898913183,0,357,357,0,1.0,0.0
1070457487357292545,1,498,87,411,0.1746987951807229,0.8253012048192772
348678953,0,810,797,13,0.9839506172839506,0.016049382716049384
20609077,1,1000,189,811,0.189,0.811
455378088,0,654,651,3,0.9954128440366973,0.0045871559633027525
1063529640051048448,1,107,3,104,0.028037383177570093,0.9719626168224299
28342873,0,78,77,1,0.9871794871794872,0.01282051282051282
1409597383923675144,1,77,19,58,0.24675324675324675,0.7532467532467533
29251751,0,42,42,0,1.0,0.0
92368087,1,238,79,159,0.3319327731092437,0.6680672268907563
2411646966,0,202,202,0,1.0,0.0
1168356638413197319,0,31,31,0,1.0,0.0
467618973,1,1000,21,979,0.021,0.979
1235066616812982274,0,120,118,2,0.9833333333333333,0.016666666666666666
2371233554,1,253,6,247,0.023715415019762844,0.9762845849802372
1275108356374462464,0,137,137,0,1.0,0.0
1486465780698992645,1,300,19,281,0.06333333333333334,0.9366666666666666
21207220,0,1000,995,5,0.995,0.005
935629584258740224,1,68,4,64,0.058823529411764705,0.9411764705882353
1249413917006163968,0,333,324,9,0.972972972972973,0.02702702702702703
1266391799309971457,1,592,82,510,0.13851351351351351,0.8614864864864865
358376751,0,1000,992,8,0.992,0.008
1266853042055454724,1,884,239,645,0.2703619909502262,0.7296380090497737
1003305521917628416,1,600,116,484,0.19333333333333333,0.8066666666666666
1266401445529767936,0,320,320,0,1.0,0.0
78786012,1,392,12,380,0.030612244897959183,0.9693877551020408
841099666569728000,1,215,30,185,0.13953488372093023,0.8604651162790697
3050523164,0,1000,996,4,0.996,0.004
1249304741731016704,1,390,45,345,0.11538461538461539,0.8846153846153846
1251212746399666176,0,23,17,6,0.7391304347826086,0.2608695652173913
335412281,1,1000,16,984,0.016,0.984
1127771774735851520,0,529,528,1,0.998109640831758,0.001890359168241966
1917741493,1,179,11,168,0.061452513966480445,0.9385474860335196
890132470359830528,0,131,127,4,0.9694656488549618,0.030534351145038167
914917859171622913,1,189,11,178,0.0582010582010582,0.9417989417989417
3439359729,0,91,91,0,1.0,0.0
1535795692312350720,1,1000,25,975,0.025,0.975
250257186,0,532,532,0,1.0,0.0
2843464942,1,47,14,33,0.2978723404255319,0.7021276595744681
2200095909,0,881,881,0,1.0,0.0
229881320,1,467,18,449,0.03854389721627409,0.961456102783726
566843285,1,1000,150,850,0.15,0.85
753442012364435456,0,1000,972,28,0.972,0.028
601115112,1,406,42,364,0.10344827586206896,0.896551724137931
1514286172830273538,0,128,128,0,1.0,0.0
50017046,0,90,81,9,0.9,0.1
959893681716146176,1,190,45,145,0.23684210526315788,0.7631578947368421
906690188096675840,0,117,117,0,1.0,0.0
264535636,1,206,17,189,0.0825242718446602,0.9174757281553398
1189745351349157888,0,149,142,7,0.9530201342281879,0.04697986577181208
44891958,1,248,15,233,0.06048387096774194,0.9395161290322581
1017248805681582080,0,69,63,6,0.9130434782608695,0.08695652173913043
21912925,1,1000,45,955,0.045,0.955
20193955,0,869,866,3,0.996547756041427,0.0034522439585730723
1849659979,1,207,41,166,0.19806763285024154,0.8019323671497585
1021171831,1,1000,23,977,0.023,0.977
38497898,0,1000,721,279,0.721,0.279
25214147,1,207,19,188,0.09178743961352658,0.9082125603864735
277191189,1,138,26,112,0.18840579710144928,0.8115942028985508
34357804,0,1000,999,1,0.999,0.001
1173636825392570368,1,69,16,53,0.2318840579710145,0.7681159420289855
1418366481847361537,0,106,105,1,0.9905660377358491,0.009433962264150943
2246252053,1,21,3,18,0.14285714285714285,0.8571428571428571
4417852239,0,1000,1000,0,1.0,0.0
1431798070442930178,1,5,0,5,0.0,1.0
1514756082962468869,0,18,18,0,1.0,0.0
1899334434,1,662,105,557,0.15861027190332327,0.8413897280966768
273649970,1,243,11,232,0.04526748971193416,0.9547325102880658
1015766030818381824,0,19,18,1,0.9473684210526315,0.05263157894736842
958921686,1,118,11,107,0.09322033898305085,0.9067796610169492
896623646621544448,0,359,357,2,0.9944289693593314,0.005571030640668524
25754604,1,108,6,102,0.05555555555555555,0.9444444444444444
292540917,0,1000,970,30,0.97,0.03
2897225732,1,364,32,332,0.08791208791208792,0.9120879120879121
734810371563868160,0,867,866,1,0.9988465974625144,0.0011534025374855825
168865473,1,163,4,159,0.024539877300613498,0.9754601226993865
309812679,0,556,544,12,0.9784172661870504,0.02158273381294964
1051957165,1,679,2,677,0.0029455081001472753,0.9970544918998527
370473153,0,673,673,0,1.0,0.0
1115776434730143744,1,49,17,32,0.3469387755102041,0.6530612244897959
3301138873,0,304,303,1,0.9967105263157895,0.003289473684210526
21943626,1,479,16,463,0.033402922755741124,0.9665970772442589
1098617428270030848,0,39,39,0,1.0,0.0
562229807,1,163,20,143,0.12269938650306748,0.8773006134969326
590091868,0,91,90,1,0.989010989010989,0.01098901098901099
21710578,1,1000,140,860,0.14,0.86
155316858,0,265,261,4,0.9849056603773585,0.01509433962264151
1050810019980042240,1,187,35,152,0.18716577540106952,0.8128342245989305
1326785802769223688,0,9,9,0,1.0,0.0
102573707,1,775,32,743,0.04129032258064516,0.9587096774193549
35999100,0,306,301,5,0.9836601307189542,0.016339869281045753
797677220579790848,1,115,7,108,0.06086956521739131,0.9391304347826087
838290131522048000,0,1000,985,15,0.985,0.015
973701839723089921,1,32,0,32,0.0,1.0
1151598462548492288,0,17,17,0,1.0,0.0
1164455828,1,592,11,581,0.018581081081081082,0.981418918918919
3232968361,0,1000,999,1,0.999,0.001
2709873426,1,102,10,92,0.09803921568627451,0.9019607843137255
418215227,0,75,68,7,0.9066666666666666,0.09333333333333334
1066225044,1,379,10,369,0.026385224274406333,0.9736147757255936
1118721728551763970,0,9,9,0,1.0,0.0
1375644388957773825,1,26,4,22,0.15384615384615385,0.8461538461538461
44611963,0,232,210,22,0.9051724137931034,0.09482758620689655
17587886,1,1000,145,855,0.145,0.855
2953873948,0,1000,1000,0,1.0,0.0
41473768,1,293,7,286,0.023890784982935155,0.9761092150170648
3034532994,1,718,128,590,0.17827298050139276,0.8217270194986073
1475151977537490944,0,1,1,0,1.0,0.0
1155732576126078976,1,469,26,443,0.05543710021321962,0.9445628997867804
260170357,0,14,14,0,1.0,0.0
1141045667995033602,1,26,0,26,0.0,1.0
1146049895398334464,0,1000,990,10,0.99,0.01
1323507338,1,177,15,162,0.0847457627118644,0.9152542372881356
112187332,1,352,48,304,0.13636363636363635,0.8636363636363636
270243903,0,173,173,0,1.0,0.0
2386385402,1,367,65,302,0.1771117166212534,0.8228882833787466
3314101500,0,269,269,0,1.0,0.0
1255007466,1,98,9,89,0.09183673469387756,0.9081632653061225
1500824638481666056,0,128,123,5,0.9609375,0.0390625
188779914,1,1000,92,908,0.092,0.908
44210606,0,458,457,1,0.9978165938864629,0.002183406113537118
71163726,1,341,6,335,0.017595307917888565,0.9824046920821115
604853644,0,1000,1000,0,1.0,0.0
348528056,1,387,26,361,0.06718346253229975,0.9328165374677002
3101409199,0,510,504,6,0.9882352941176471,0.011764705882352941
874374352862674945,1,1000,130,870,0.13,0.87
59325665,0,1000,991,9,0.991,0.009
34631947,1,250,23,227,0.092,0.908
326990267,0,448,445,3,0.9933035714285714,0.006696428571428571
1131007144835338241,1,45,7,38,0.15555555555555556,0.8444444444444444
1153015329548853248,0,19,19,0,1.0,0.0
19640038,1,1000,202,798,0.202,0.798
42999159,0,361,346,15,0.9584487534626038,0.04155124653739612
1250398423,1,995,382,613,0.38391959798994973,0.6160804020100502
1286809667801292800,0,135,123,12,0.9111111111111111,0.08888888888888889
60006082,1,148,20,128,0.13513513513513514,0.8648648648648649
1422723486863314944,0,36,36,0,1.0,0.0
6387362,1,1000,91,909,0.091,0.909
66413491,0,1000,893,107,0.893,0.107
18791202,1,650,85,565,0.13076923076923078,0.8692307692307693
339423850,0,1000,993,7,0.993,0.007
1003080776,1,331,26,305,0.07854984894259819,0.9214501510574018
1490018789580328962,0,18,18,0,1.0,0.0
8919062,1,1000,42,958,0.042,0.958
349949033,0,1000,969,31,0.969,0.031
1106000310701568000,1,252,34,218,0.1349206349206349,0.8650793650793651
1431725934,0,1000,994,6,0.994,0.006
1249185344903434240,1,88,14,74,0.1590909090909091,0.8409090909090909
968561356893962241,0,261,215,46,0.8237547892720306,0.17624521072796934
14739161,1,661,124,537,0.1875945537065053,0.8124054462934948
3100040166,0,303,303,0,1.0,0.0
874686572880330753,1,166,38,128,0.2289156626506024,0.7710843373493976
1511433832062459916,0,121,121,0,1.0,0.0
824655849851195394,1,1000,63,937,0.063,0.937
110233471,0,756,753,3,0.996031746031746,0.003968253968253968
4440085065,1,622,123,499,0.1977491961414791,0.8022508038585209
888521536243630085,0,1000,989,11,0.989,0.011
808122967016095744,1,801,64,737,0.07990012484394507,0.920099875156055
826483024460083202,0,100,95,5,0.95,0.05
4274906653,1,299,14,285,0.046822742474916385,0.9531772575250836
787736793990955008,0,1000,997,3,0.997,0.003
1144115377359638529,1,54,2,52,0.037037037037037035,0.9629629629629629
1101897831021895681,0,228,226,2,0.9912280701754386,0.008771929824561403
23686354,1,494,47,447,0.0951417004048583,0.9048582995951417
1047947710144372736,0,176,162,14,0.9204545454545454,0.07954545454545454
427881022,1,31,1,30,0.03225806451612903,0.967741935483871
3414067546,0,929,924,5,0.9946178686759957,0.005382131324004306
6267972,1,1000,214,786,0.214,0.786
1317559711,0,350,345,5,0.9857142857142858,0.014285714285714285
1074806783515000832,1,790,58,732,0.07341772151898734,0.9265822784810127
1446496452168065024,0,3,2,1,0.6666666666666666,0.3333333333333333
14062056,1,68,4,64,0.058823529411764705,0.9411764705882353
1180173324,0,366,366,0,1.0,0.0
1161329049169518592,1,1000,168,832,0.168,0.832
1336691686219583488,0,19,19,0,1.0,0.0
19571938,1,1000,131,869,0.131,0.869
174481579,0,566,562,4,0.9929328621908127,0.007067137809187279
4827299335,1,360,58,302,0.16111111111111112,0.8388888888888889
916737912443719680,0,504,475,29,0.9424603174603174,0.057539682539682536
1965875340,1,273,32,241,0.11721611721611722,0.8827838827838828
365239890,0,37,36,1,0.972972972972973,0.02702702702702703
276126821,0,340,340,0,1.0,0.0
1072981773741682690,1,105,8,97,0.0761904761904762,0.9238095238095239
931616823275114497,0,55,55,0,1.0,0.0
2521858614,1,155,26,129,0.16774193548387098,0.832258064516129
1250061601325154314,0,34,34,0,1.0,0.0
16064239,0,199,199,0,1.0,0.0
839499609873473536,1,358,43,315,0.12011173184357542,0.8798882681564246
1104468931727761409,0,83,75,8,0.9036144578313253,0.0963855421686747
20246644,1,610,35,575,0.05737704918032787,0.9426229508196722
1485456814162460673,0,1,1,0,1.0,0.0
305892967,1,254,67,187,0.2637795275590551,0.7362204724409449
139894605,0,743,736,7,0.990578734858681,0.009421265141318977
19095832,1,139,28,111,0.2014388489208633,0.7985611510791367
1282241941577572353,0,3,3,0,1.0,0.0
262538880,1,1000,107,893,0.107,0.893
938941014542290945,0,92,87,5,0.9456521739130435,0.05434782608695652
2195235553,1,35,1,34,0.02857142857142857,0.9714285714285714
155420684,0,163,161,2,0.9877300613496932,0.012269938650306749
40130147,1,1000,79,921,0.079,0.921
18914199,0,1000,984,16,0.984,0.016
57731989,1,218,23,195,0.10550458715596331,0.8944954128440367
1407055801517178880,0,182,181,1,0.9945054945054945,0.005494505494505495
908865058330963969,1,599,198,401,0.330550918196995,0.669449081803005
473436441,0,1000,1000,0,1.0,0.0
1049455826824355840,1,30,1,29,0.03333333333333333,0.9666666666666667
158401394,0,222,222,0,1.0,0.0
373039958,1,499,71,428,0.14228456913827656,0.8577154308617234
2663513336,0,1000,954,46,0.954,0.046
703818379883212800,1,337,9,328,0.026706231454005934,0.973293768545994
270672893,0,894,894,0,1.0,0.0
777822636,1,522,35,487,0.06704980842911877,0.9329501915708812
1264763034758787072,0,41,41,0,1.0,0.0
2576338980,1,102,21,81,0.20588235294117646,0.7941176470588235
1075525793680424961,0,225,219,6,0.9733333333333334,0.02666666666666667
4925031651,1,212,25,187,0.1179245283018868,0.8820754716981132
2970769151,0,378,364,14,0.9629629629629629,0.037037037037037035
1101625758936518657,1,846,63,783,0.07446808510638298,0.925531914893617
404245577,0,1000,896,104,0.896,0.104
389723251,0,472,456,16,0.9661016949152542,0.03389830508474576
346918263,0,11,11,0,1.0,0.0
33224552,1,89,3,86,0.033707865168539325,0.9662921348314607
1277621646212435968,0,1000,988,12,0.988,0.012
2452861434,1,1000,145,855,0.145,0.855
1103778263661510657,0,701,697,4,0.9942938659058488,0.005706134094151213
4253921553,1,180,40,140,0.2222222222222222,0.7777777777777778
1406393642609168385,0,643,643,0,1.0,0.0
2539820911,1,323,22,301,0.06811145510835913,0.9318885448916409
726507267265167360,0,111,110,1,0.990990990990991,0.009009009009009009
40606194,1,128,7,121,0.0546875,0.9453125
2583176187,0,731,726,5,0.9931600547195623,0.006839945280437756
30931131,1,314,26,288,0.08280254777070063,0.9171974522292994
1458730468052856833,0,43,43,0,1.0,0.0
1363357904,1,469,64,405,0.13646055437100213,0.8635394456289979
1450108543,0,239,236,3,0.9874476987447699,0.012552301255230125
131323626,1,693,138,555,0.19913419913419914,0.8008658008658008
1529534429248487424,0,108,87,21,0.8055555555555556,0.19444444444444445
1021686677235032064,1,1000,61,939,0.061,0.939
335822230,0,714,714,0,1.0,0.0
13821862,1,1000,105,895,0.105,0.895
723948266098806786,0,737,737,0,1.0,0.0
326900125,1,540,203,337,0.37592592592592594,0.6240740740740741
1113293494368362496,0,34,33,1,0.9705882352941176,0.029411764705882353
1540546779753730048,1,1,1,0,1.0,0.0
188739977,0,348,321,27,0.9224137931034483,0.07758620689655173
367340368,1,117,4,113,0.03418803418803419,0.9658119658119658
68639073,0,689,685,4,0.9941944847605225,0.005805515239477504
77595696,1,1000,174,826,0.174,0.826
408715471,0,1000,987,13,0.987,0.013
371827928,1,409,22,387,0.05378973105134474,0.9462102689486552
91237064,0,1000,998,2,0.998,0.002
1680956198,1,141,23,118,0.16312056737588654,0.8368794326241135
1268784583027437569,0,275,273,2,0.9927272727272727,0.007272727272727273
252217660,1,1000,159,841,0.159,0.841
127958980,0,845,843,2,0.9976331360946745,0.002366863905325444
47280018,1,1000,373,627,0.373,0.627
257000542,0,1000,1000,0,1.0,0.0
1052994516,1,1000,104,896,0.104,0.896
784812728980471808,0,58,56,2,0.9655172413793104,0.034482758620689655
3660595040,1,200,18,182,0.09,0.91
1013495549809582080,0,479,479,0,1.0,0.0
1067628401672937473,1,76,5,71,0.06578947368421052,0.9342105263157895
958707768105537537,0,55,54,1,0.9818181818181818,0.01818181818181818
1069645585844711425,1,106,36,70,0.33962264150943394,0.660377358490566
752532675869577216,1,300,33,267,0.11,0.89
852209101421596677,0,131,131,0,1.0,0.0
792058290,1,1000,8,992,0.008,0.992
702139172698529793,0,66,66,0,1.0,0.0
2908689969,1,479,13,466,0.027139874739039668,0.9728601252609603
884596017466920965,0,856,849,7,0.991822429906542,0.008177570093457943
441666574,1,1000,57,943,0.057,0.943
1078459987414999041,0,50,50,0,1.0,0.0
850774867494481921,1,378,53,325,0.1402116402116402,0.8597883597883598
200932077,0,26,26,0,1.0,0.0
1947239336,0,32,32,0,1.0,0.0
1412510681639890946,1,113,21,92,0.18584070796460178,0.8141592920353983
1216792751527718917,0,24,17,7,0.7083333333333334,0.2916666666666667
471319801,1,902,63,839,0.06984478935698447,0.9301552106430155
1258401020,0,514,506,8,0.9844357976653697,0.01556420233463035
740963819904585728,1,1000,178,822,0.178,0.822
30943270,0,142,141,1,0.9929577464788732,0.007042253521126761
814560111419150337,1,1000,23,977,0.023,0.977
1164228238765428736,0,72,72,0,1.0,0.0
43968807,1,183,6,177,0.03278688524590164,0.9672131147540983
2696029285,0,31,31,0,1.0,0.0
3363926531,1,193,60,133,0.31088082901554404,0.689119170984456
755271039886721024,0,79,73,6,0.9240506329113924,0.0759493670886076
48815641,1,1000,33,967,0.033,0.967
411703839,0,1000,922,78,0.922,0.078
930635299658588166,1,37,5,32,0.13513513513513514,0.8648648648648649
789815344974196736,0,900,900,0,1.0,0.0
346308893,1,155,10,145,0.06451612903225806,0.9354838709677419
18501983,0,1000,1000,0,1.0,0.0
106113476,1,417,97,320,0.23261390887290168,0.7673860911270983
799103462797611008,0,271,264,7,0.974169741697417,0.025830258302583026
14237961,1,1000,16,984,0.016,0.984
1519802080151678978,0,3,3,0,1.0,0.0
868525885107851264,1,38,4,34,0.10526315789473684,0.8947368421052632
1478958650752311296,0,79,79,0,1.0,0.0
18145841,1,1000,6,994,0.006,0.994
4802906838,0,369,369,0,1.0,0.0
548603845,1,839,40,799,0.04767580452920143,0.9523241954707986
102881721,0,608,608,0,1.0,0.0
841468338358345728,1,82,28,54,0.34146341463414637,0.6585365853658537
1481362944843649029,0,121,116,5,0.9586776859504132,0.04132231404958678
24302161,1,1000,121,879,0.121,0.879
745356254944575489,0,11,11,0,1.0,0.0
57473419,1,91,17,74,0.18681318681318682,0.8131868131868132
1286329213,0,546,539,7,0.9871794871794872,0.01282051282051282
2417407964,1,1000,127,873,0.127,0.873
2287678147,0,674,674,0,1.0,0.0
2438834748,1,685,81,604,0.11824817518248175,0.8817518248175182
1488802053443194880,0,7,6,1,0.8571428571428571,0.14285714285714285
2364644035,1,1000,27,973,0.027,0.973
811824151,0,1000,993,7,0.993,0.007
19501704,1,160,19,141,0.11875,0.88125
1146912451562287104,0,25,25,0,1.0,0.0
1333605434712842240,1,1000,95,905,0.095,0.905
79876756,0,1000,1000,0,1.0,0.0
907399367769968640,1,1000,72,928,0.072,0.928
913723072431058945,0,27,27,0,1.0,0.0
7611732,0,58,57,1,0.9827586206896551,0.017241379310344827
780761609010450432,1,97,12,85,0.12371134020618557,0.8762886597938144
1024773452761387008,0,101,101,0,1.0,0.0
184686818,1,1000,161,839,0.161,0.839
1175875205941682183,0,5,5,0,1.0,0.0
286515573,1,206,24,182,0.11650485436893204,0.883495145631068
3094850974,0,199,199,0,1.0,0.0
2690906671,1,137,15,122,0.10948905109489052,0.8905109489051095
1973443550,0,864,863,1,0.9988425925925926,0.0011574074074074073
451231808,1,182,18,164,0.0989010989010989,0.9010989010989011
1245654430269112324,0,24,24,0,1.0,0.0
337283151,0,1000,998,2,0.998,0.002
353306876,1,541,45,496,0.08317929759704251,0.9168207024029574
1604461927,0,809,807,2,0.9975278121137207,0.002472187886279357
285774462,1,360,45,315,0.125,0.875
4177644740,0,477,477,0,1.0,0.0
1101874302,1,396,34,362,0.08585858585858586,0.9141414141414141
1316790478659112963,0,9,9,0,1.0,0.0
959625879877046272,1,154,48,106,0.3116883116883117,0.6883116883116883
1016718177919819777,0,1000,969,31,0.969,0.031
1320002778618540035,1,10,2,8,0.2,0.8
13107182,0,1000,939,61,0.939,0.061
172226857,1,411,9,402,0.021897810218978103,0.9781021897810219
1595935236,0,1000,992,8,0.992,0.008
339374000,0,62,61,1,0.9838709677419355,0.016129032258064516
1184234046286651393,1,739,111,628,0.15020297699594046,0.8497970230040596
18235461,0,58,58,0,1.0,0.0
175676767,1,73,3,70,0.0410958904109589,0.958904109589041
53792892,0,376,376,0,1.0,0.0
1468510226,1,1000,57,943,0.057,0.943
1223234924666392576,0,67,67,0,1.0,0.0
623266216,0,1000,861,139,0.861,0.139
45056908,1,1000,258,742,0.258,0.742
3807300976,0,333,329,4,0.987987987987988,0.012012012012012012
2140251,1,1000,76,924,0.076,0.924
45450662,0,736,735,1,0.998641304347826,0.001358695652173913
2690688900,1,1000,33,967,0.033,0.967
1254832215156051969,0,426,422,4,0.9906103286384976,0.009389671361502348
848738246787907584,1,12,3,9,0.25,0.75
1113955600352927749,0,117,112,5,0.9572649572649573,0.042735042735042736
3318385595,1,1000,188,812,0.188,0.812
176521356,0,861,861,0,1.0,0.0
1267130183645122561,1,276,46,230,0.16666666666666666,0.8333333333333334
970682035017744384,0,29,26,3,0.896551724137931,0.10344827586206896
816480052418379776,1,111,13,98,0.11711711711711711,0.8828828828828829
68029876,0,59,59,0,1.0,0.0
48196491,1,724,4,720,0.0055248618784530384,0.994475138121547
104597849,0,1000,862,138,0.862,0.138
26041957,1,1000,0,1000,0.0,1.0
37830054,0,289,287,2,0.9930795847750865,0.006920415224913495
348933514,1,1000,138,862,0.138,0.862
1157712759435550720,0,41,41,0,1.0,0.0
1099836611565666304,1,275,10,265,0.03636363636363636,0.9636363636363636
34069028,0,1000,988,12,0.988,0.012
16337833,1,1000,88,912,0.088,0.912
918109545599258624,0,81,81,0,1.0,0.0
48194591,1,182,24,158,0.13186813186813187,0.8681318681318682
3361002287,0,144,144,0,1.0,0.0
21439879,1,387,8,379,0.020671834625323,0.979328165374677
3951714072,0,641,624,17,0.9734789391575663,0.0265210608424337
1474180775473909760,1,1,0,1,0.0,1.0
969541191242080257,0,429,400,29,0.9324009324009324,0.0675990675990676
1351030202252587012,1,1000,342,658,0.342,0.658
57349688,0,419,419,0,1.0,0.0
857356663225032705,1,114,4,110,0.03508771929824561,0.9649122807017544
1461724967511465992,0,8,8,0,1.0,0.0
4779601004,1,788,16,772,0.02030456852791878,0.9796954314720813
1265428625517502464,0,153,152,1,0.9934640522875817,0.006535947712418301
258225731,1,58,7,51,0.1206896551724138,0.8793103448275862
1346879267569868800,0,34,34,0,1.0,0.0
755599413024874497,1,215,67,148,0.3116279069767442,0.6883720930232559
21176324,0,1000,973,27,0.973,0.027
1231263670207795201,1,1000,171,829,0.171,0.829
718516022,1,762,12,750,0.015748031496062992,0.984251968503937
1025110274746003456,0,34,34,0,1.0,0.0
25200500,1,563,98,465,0.17406749555950266,0.8259325044404974
1174600821654339584,0,253,250,3,0.9881422924901185,0.011857707509881422
584021791,1,199,16,183,0.08040201005025126,0.9195979899497487
935755883195314176,0,141,131,10,0.9290780141843972,0.07092198581560284
416108687,1,1000,174,826,0.174,0.826
427603599,0,43,42,1,0.9767441860465116,0.023255813953488372
860651239,1,124,13,111,0.10483870967741936,0.8951612903225806
1120149957229498368,0,23,23,0,1.0,0.0
287957396,1,564,23,541,0.040780141843971635,0.9592198581560284
1446855336808226818,0,49,49,0,1.0,0.0
1361162553204871169,0,3,3,0,1.0,0.0
325928879,1,718,92,626,0.12813370473537605,0.871866295264624
245175831,0,1000,985,15,0.985,0.015
4850097967,1,271,19,252,0.07011070110701106,0.9298892988929889
47985815,0,17,17,0,1.0,0.0
47451193,1,565,22,543,0.03893805309734513,0.9610619469026549
979262060528848896,0,132,130,2,0.9848484848484849,0.015151515151515152
2978567142,1,713,74,639,0.10378681626928471,0.8962131837307152
5825822,0,1000,1000,0,1.0,0.0
26928554,1,447,14,433,0.03131991051454139,0.9686800894854586
41694127,0,1000,992,8,0.992,0.008
847282416939024387,1,104,10,94,0.09615384615384616,0.9038461538461539
1182662877741813761,0,87,83,4,0.9540229885057471,0.04597701149425287
1191763642263339009,1,996,297,699,0.29819277108433734,0.7018072289156626
1297666668907368455,0,141,141,0,1.0,0.0
1408051736,1,106,4,102,0.03773584905660377,0.9622641509433962
1415775360042639366,0,97,97,0,1.0,0.0
128078056,1,244,1,243,0.004098360655737705,0.9959016393442623
1056784302627786753,0,51,50,1,0.9803921568627451,0.0196078431372549
344793070,1,641,135,506,0.21060842433697347,0.7893915756630265
840030752,0,766,752,14,0.9817232375979112,0.018276762402088774
14895518,1,1000,240,760,0.24,0.76
335769801,0,38,38,0,1.0,0.0
1424287476,1,484,160,324,0.3305785123966942,0.6694214876033058
3303291496,0,1000,978,22,0.978,0.022
162283,1,1000,45,955,0.045,0.955
1360575841533648897,0,8,8,0,1.0,0.0
822312182276730880,1,43,12,31,0.27906976744186046,0.7209302325581395
1297359266991476736,0,393,331,62,0.8422391857506362,0.15776081424936386
630751819,1,930,100,830,0.10752688172043011,0.8924731182795699
1368668324276617217,0,398,317,81,0.7964824120603015,0.20351758793969849
45232771,1,1000,21,979,0.021,0.979
1338589535496773635,0,1,1,0,1.0,0.0
900091142162620420,1,23,3,20,0.13043478260869565,0.8695652173913043
1096981422,0,270,270,0,1.0,0.0
16941415,1,156,8,148,0.05128205128205128,0.9487179487179487
74889010,0,228,200,28,0.8771929824561403,0.12280701754385964
1115310561670070273,1,352,62,290,0.17613636363636365,0.8238636363636364
1271977359370080257,0,708,691,17,0.9759887005649718,0.02401129943502825
70685221,1,343,44,299,0.1282798833819242,0.8717201166180758
1457082059067904000,0,2,2,0,1.0,0.0
711367501448421377,1,310,39,271,0.12580645161290321,0.8741935483870967
377102424,0,134,131,3,0.9776119402985075,0.022388059701492536
964716820522524673,1,239,58,181,0.24267782426778242,0.7573221757322176
1450345690345791490,0,141,138,3,0.9787234042553191,0.02127659574468085
306309871,1,439,7,432,0.015945330296127564,0.9840546697038725
1219332806343647234,0,95,95,0,1.0,0.0
422054741,1,156,5,151,0.03205128205128205,0.967948717948718
15540014,0,33,33,0,1.0,0.0
145000333,1,197,9,188,0.04568527918781726,0.9543147208121827
729865202599137280,1,63,9,54,0.14285714285714285,0.8571428571428571
1489301873588940804,0,877,875,2,0.9977194982896237,0.002280501710376283
1472309117574430731,1,1000,235,765,0.235,0.765
826963593539133440,0,1000,991,9,0.991,0.009
1490676294,1,239,13,226,0.05439330543933055,0.9456066945606695
2426524795,0,1000,992,8,0.992,0.008
2696116208,1,716,30,686,0.04189944134078212,0.9581005586592178
2751067845,0,32,32,0,1.0,0.0
1231947013387735040,1,167,10,157,0.059880239520958084,0.9401197604790419
707507985828810752,0,9,9,0,1.0,0.0
851181970596003840,0,290,290,0,1.0,0.0
521009116,1,334,82,252,0.24550898203592814,0.7544910179640718
1523292183683641345,0,31,31,0,1.0,0.0
3087814102,1,735,217,518,0.29523809523809524,0.7047619047619048
1333757631480037382,0,23,23,0,1.0,0.0
314869687,1,1000,54,946,0.054,0.946
806955176649170944,0,956,925,31,0.9675732217573222,0.032426778242677826
1106327403507404800,1,41,3,38,0.07317073170731707,0.926829268292683
1487979442819399681,0,28,28,0,1.0,0.0
411529113,1,324,0,324,0.0,1.0
363464368,0,253,253,0,1.0,0.0
608824236,1,314,36,278,0.11464968152866242,0.8853503184713376
1521751028000976896,0,8,8,0,1.0,0.0
36997181,1,480,5,475,0.010416666666666666,0.9895833333333334
2300476525,0,1000,999,1,0.999,0.001
753737629439500288,1,144,48,96,0.3333333333333333,0.6666666666666666
967356530214387712,0,1000,969,31,0.969,0.031
981453649,1,317,97,220,0.305993690851735,0.694006309148265
541299475,0,89,87,2,0.9775280898876404,0.02247191011235955
1423634096,1,17,1,16,0.058823529411764705,0.9411764705882353
2400989222,0,207,203,4,0.9806763285024155,0.01932367149758454
706273,1,748,123,625,0.16443850267379678,0.8355614973262032
23404555,0,434,430,4,0.9907834101382489,0.009216589861751152
304192742,1,405,32,373,0.07901234567901234,0.9209876543209876
1374363617215320068,0,213,210,3,0.9859154929577465,0.014084507042253521
1275551040415424514,1,36,4,32,0.1111111111111111,0.8888888888888888
19792089,0,1000,991,9,0.991,0.009
15064584,1,160,6,154,0.0375,0.9625
1699279848,0,25,25,0,1.0,0.0
1470224765000597513,1,267,42,225,0.15730337078651685,0.8426966292134831
4651078940,0,182,181,1,0.9945054945054945,0.005494505494505495
7541162,1,1000,16,984,0.016,0.984
77329461,0,1000,997,3,0.997,0.003
2632812881,1,266,65,201,0.24436090225563908,0.7556390977443609
967641675207122944,0,78,74,4,0.9487179487179487,0.05128205128205128
6511442,1,573,25,548,0.04363001745200698,0.956369982547993
1228732965787619329,0,117,116,1,0.9914529914529915,0.008547008547008548
365627935,1,31,0,31,0.0,1.0
1123999987027914755,0,17,17,0,1.0,0.0
787437577368313856,1,185,23,162,0.12432432432432433,0.8756756756756757
2875418044,0,1000,922,78,0.922,0.078
1122709100,1,1000,254,746,0.254,0.746
419106979,0,153,153,0,1.0,0.0
811650088099610624,1,46,15,31,0.32608695652173914,0.6739130434782609
744137881,0,770,768,2,0.9974025974025974,0.0025974025974025974
1277590030895153154,1,917,163,754,0.1777535441657579,0.822246455834242
730558685399920645,0,206,203,3,0.9854368932038835,0.014563106796116505
3283055780,1,663,8,655,0.012066365007541479,0.9879336349924586
1177078845272469504,0,349,344,5,0.9856733524355301,0.014326647564469915
29807603,1,297,19,278,0.06397306397306397,0.936026936026936
923257756991320065,0,135,134,1,0.9925925925925926,0.007407407407407408
848728733028679680,1,688,273,415,0.39680232558139533,0.6031976744186046
1360822699170357248,0,700,700,0,1.0,0.0
71046318,1,146,4,142,0.0273972602739726,0.9726027397260274
1174350110,0,342,338,4,0.9883040935672515,0.011695906432748537
3432836807,1,71,17,54,0.23943661971830985,0.7605633802816901
295993319,0,668,666,2,0.9970059880239521,0.0029940119760479044
292639223,1,261,24,237,0.09195402298850575,0.9080459770114943
1414592175623610371,0,9,9,0,1.0,0.0
1191882140587372545,1,822,55,767,0.06690997566909976,0.9330900243309003
796126969410781184,0,171,171,0,1.0,0.0
3236601577,1,1000,84,916,0.084,0.916
1354124056304508928,0,30,26,4,0.8666666666666667,0.13333333333333333
856606909377294336,1,213,28,185,0.13145539906103287,0.8685446009389671
922061528312025088,0,121,121,0,1.0,0.0
983732426919817217,1,919,98,821,0.10663764961915125,0.8933623503808488
1012126158866059264,0,1000,994,6,0.994,0.006
1278190767874465792,1,168,44,124,0.2619047619047619,0.7380952380952381
1015834761263288320,0,17,17,0,1.0,0.0
935423377,1,296,7,289,0.02364864864864865,0.9763513513513513
1420430006581305344,0,15,15,0,1.0,0.0
452753642,1,1000,38,962,0.038,0.962
2209722252,0,774,612,162,0.7906976744186046,0.20930232558139536
1467003898019856385,1,52,1,51,0.019230769230769232,0.9807692307692307
3994185867,0,1,1,0,1.0,0.0
977067466021945344,1,54,8,46,0.14814814814814814,0.8518518518518519
102879353,0,1000,939,61,0.939,0.061
788819019512090624,1,223,56,167,0.25112107623318386,0.7488789237668162
847570305166041092,0,24,23,1,0.9583333333333334,0.041666666666666664
1440371013313720320,0,1000,996,4,0.996,0.004
723134300,1,1000,149,851,0.149,0.851
1359669257714466818,0,52,48,4,0.9230769230769231,0.07692307692307693
1035532043957006338,1,39,1,38,0.02564102564102564,0.9743589743589743
19147275,0,1000,967,33,0.967,0.033
1309734876631805952,1,75,5,70,0.06666666666666667,0.9333333333333333
853352766311460865,0,52,52,0,1.0,0.0
1552107157,1,1000,239,761,0.239,0.761
1064771569,0,533,524,9,0.9831144465290806,0.016885553470919325
1914785293,1,27,0,27,0.0,1.0
952530883847757824,0,139,139,0,1.0,0.0
930945758865567744,1,11,2,9,0.18181818181818182,0.8181818181818182
1471239301342056450,0,248,248,0,1.0,0.0
914926015964696577,1,34,3,31,0.08823529411764706,0.9117647058823529
2853729140,0,220,220,0,1.0,0.0
963532033044762626,1,143,13,130,0.09090909090909091,0.9090909090909091
3434950059,0,190,188,2,0.9894736842105263,0.010526315789473684
1219328634235867147,1,14,2,12,0.14285714285714285,0.8571428571428571
3074335020,0,17,12,5,0.7058823529411765,0.29411764705882354
1309990206523703297,1,159,35,124,0.22012578616352202,0.779874213836478
32697732,0,18,18,0,1.0,0.0
202758875,1,87,7,80,0.08045977011494253,0.9195402298850575
1098363975811641344,0,115,115,0,1.0,0.0
1152623841916723201,1,87,17,70,0.19540229885057472,0.8045977011494253
2442477528,0,130,130,0,1.0,0.0
16713899,1,298,14,284,0.04697986577181208,0.9530201342281879
1335465379,0,297,297,0,1.0,0.0
1356907652,1,1000,28,972,0.028,0.972
97863745,0,877,877,0,1.0,0.0
14478837,1,1000,111,889,0.111,0.889
1178362866077962240,0,137,135,2,0.9854014598540146,0.014598540145985401
1416471216358035460,1,179,13,166,0.07262569832402235,0.9273743016759777
55444270,0,11,11,0,1.0,0.0
197509165,1,48,1,47,0.020833333333333332,0.9791666666666666
248978641,0,1000,997,3,0.997,0.003
404084431,1,487,15,472,0.030800821355236138,0.9691991786447639
264286728,0,1000,970,30,0.97,0.03
103607140,1,1000,76,924,0.076,0.924
27918230,0,1000,992,8,0.992,0.008
2612044386,1,1000,99,901,0.099,0.901
199781963,0,1000,1000,0,1.0,0.0
3287847476,1,70,7,63,0.1,0.9
716362405,0,1000,996,4,0.996,0.004
808179811428528128,1,119,11,108,0.09243697478991597,0.907563025210084
732400653432020993,0,263,263,0,1.0,0.0
1198405576168001536,1,63,15,48,0.23809523809523808,0.7619047619047619
27963518,0,54,53,1,0.9814814814814815,0.018518518518518517
1147716981723992065,1,13,4,9,0.3076923076923077,0.6923076923076923
1078171047487262720,0,121,119,2,0.9834710743801653,0.01652892561983471
610414602,1,697,66,631,0.09469153515064563,0.9053084648493543
1360371639645597701,0,60,60,0,1.0,0.0
1311098698953363458,1,7,2,5,0.2857142857142857,0.7142857142857143
1361143256109772807,1,1000,33,967,0.033,0.967
833766372261916673,0,311,311,0,1.0,0.0
399218426,1,293,29,264,0.09897610921501707,0.9010238907849829
1367323793690152962,0,123,118,5,0.959349593495935,0.04065040650406504
79021613,1,114,16,98,0.14035087719298245,0.8596491228070176
1300970264809943042,0,100,95,5,0.95,0.05
822905985769545729,1,1000,180,820,0.18,0.82
14185335,0,148,147,1,0.9932432432432432,0.006756756756756757
69905221,1,34,9,25,0.2647058823529412,0.7352941176470589
961391504555106304,0,41,41,0,1.0,0.0
1884766800,1,121,12,109,0.09917355371900827,0.9008264462809917
875881328889049089,1,1000,3,997,0.003,0.997
14983367,0,264,258,6,0.9772727272727273,0.022727272727272728
1330921255,1,52,14,38,0.2692307692307692,0.7307692307692307
408180479,0,865,864,1,0.9988439306358381,0.0011560693641618498
896909050662629376,1,509,38,471,0.07465618860510806,0.925343811394892
3233551572,0,260,253,7,0.9730769230769231,0.026923076923076925
2279913036,1,147,7,140,0.047619047619047616,0.9523809523809523
761676223,0,1000,997,3,0.997,0.003
272574958,1,367,5,362,0.013623978201634877,0.9863760217983651
1527378887071907840,0,23,23,0,1.0,0.0
870748591979204609,1,1000,43,957,0.043,0.957
519111388,0,996,989,7,0.9929718875502008,0.007028112449799197
88847729,1,548,62,486,0.11313868613138686,0.8868613138686131
71023858,0,365,363,2,0.9945205479452055,0.005479452054794521
328725698,1,139,33,106,0.23741007194244604,0.762589928057554
1329224054197411846,0,3,3,0,1.0,0.0
4433734579,1,29,1,28,0.034482758620689655,0.9655172413793104
1503871486456733698,0,10,10,0,1.0,0.0
833539730935537665,1,128,15,113,0.1171875,0.8828125
1099888864561385473,0,91,71,20,0.7802197802197802,0.21978021978021978
271522272,1,379,21,358,0.055408970976253295,0.9445910290237467
552675557,0,1000,1000,0,1.0,0.0
1029416055154925569,1,1000,335,665,0.335,0.665
1498303594696790024,0,2,2,0,1.0,0.0
1324119217050963968,1,27,7,20,0.25925925925925924,0.7407407407407407
1122655888651825152,0,70,70,0,1.0,0.0
769312525108203520,1,134,9,125,0.06716417910447761,0.9328358208955224
366476665,0,343,328,15,0.956268221574344,0.043731778425655975
2986478342,0,436,429,7,0.9839449541284404,0.016055045871559634
235263667,1,1000,121,879,0.121,0.879
1451836927317970955,0,181,180,1,0.994475138121547,0.0055248618784530384
2475952630,1,402,69,333,0.17164179104477612,0.8283582089552238
1223665158687547393,0,10,10,0,1.0,0.0
1092986682494906368,1,71,13,58,0.18309859154929578,0.8169014084507042
156129468,0,758,757,1,0.9986807387862797,0.0013192612137203166
1372009391080271872,1,74,11,63,0.14864864864864866,0.8513513513513513
1382224179483832321,0,299,289,10,0.9665551839464883,0.033444816053511704
4441032407,1,344,66,278,0.19186046511627908,0.8081395348837209
381611882,0,75,73,2,0.9733333333333334,0.02666666666666667
14646103,1,65,0,65,0.0,1.0
222193688,0,1000,954,46,0.954,0.046
1183459603440377858,1,96,20,76,0.20833333333333334,0.7916666666666666
246411776,0,134,134,0,1.0,0.0
24232582,1,326,38,288,0.1165644171779141,0.8834355828220859
144076572,0,830,803,27,0.9674698795180723,0.03253012048192771
1121415885602938881,1,1000,86,914,0.086,0.914
1488879778908225536,0,152,152,0,1.0,0.0
24732885,1,119,19,100,0.15966386554621848,0.8403361344537815
15400189,0,1000,984,16,0.984,0.016
1175181627519098881,1,79,15,64,0.189873417721519,0.810126582278481
380872347,0,33,32,1,0.9696969696969697,0.030303030303030304
953716138889895936,1,149,9,140,0.06040268456375839,0.9395973154362416
1432273710770180096,0,173,173,0,1.0,0.0
3103302618,1,555,84,471,0.15135135135135136,0.8486486486486486
2393551254,0,1000,991,9,0.991,0.009
883938088694763521,1,344,21,323,0.061046511627906974,0.938953488372093
985717568,0,228,226,2,0.9912280701754386,0.008771929824561403
1069877709285650432,1,502,17,485,0.03386454183266932,0.9661354581673307
1193580717004992514,0,212,208,4,0.9811320754716981,0.018867924528301886
959928966172770304,1,179,48,131,0.2681564245810056,0.7318435754189944
770649406987128836,0,206,205,1,0.9951456310679612,0.0048543689320388345
3168260390,1,165,39,126,0.23636363636363636,0.7636363636363637
2812478197,0,141,138,3,0.9787234042553191,0.02127659574468085
1317312816,1,1000,180,820,0.18,0.82
25454657,1,1000,53,947,0.053,0.947
1075135518592155648,0,98,98,0,1.0,0.0
32217281,1,571,117,454,0.20490367775831875,0.7950963222416813
2644245765,0,1000,998,2,0.998,0.002
389218761,1,79,2,77,0.02531645569620253,0.9746835443037974
144657378,0,98,98,0,1.0,0.0
1041861664315006976,0,183,182,1,0.994535519125683,0.00546448087431694
1161437025536552971,1,1000,282,718,0.282,0.718
1413770415273558018,0,210,210,0,1.0,0.0
1032009933712236545,1,234,101,133,0.43162393162393164,0.5683760683760684
1264721996090421250,0,141,138,3,0.9787234042553191,0.02127659574468085
3311168042,1,1000,44,956,0.044,0.956
1849799744,0,265,261,4,0.9849056603773585,0.01509433962264151
1232555260511735808,1,1000,1,999,0.001,0.999
720821527545942016,0,18,18,0,1.0,0.0
4846609896,1,245,15,230,0.061224489795918366,0.9387755102040817
41147564,0,25,25,0,1.0,0.0
90819148,1,151,16,135,0.10596026490066225,0.8940397350993378
1148254719225339905,0,39,39,0,1.0,0.0
1418069097162493962,1,1,0,1,0.0,1.0
1414285582822346753,0,1,1,0,1.0,0.0
733026588,1,232,7,225,0.03017241379310345,0.9698275862068966
191719807,0,629,629,0,1.0,0.0
1075033938,1,601,52,549,0.08652246256239601,0.913477537437604
462933902,0,1000,991,9,0.991,0.009
209195579,0,447,447,0,1.0,0.0
133568376,1,1000,69,931,0.069,0.931
1149360707252686848,0,4,4,0,1.0,0.0
609044750,1,1000,27,973,0.027,0.973
1425594949534470144,0,1000,889,111,0.889,0.111
2323112275,0,68,66,2,0.9705882352941176,0.029411764705882353
1392060183946354690,1,171,69,102,0.40350877192982454,0.5964912280701754
303145438,0,1000,1000,0,1.0,0.0
768633002733830144,1,56,7,49,0.125,0.875
585376893,0,24,24,0,1.0,0.0
846124629320183812,1,503,46,457,0.09145129224652088,0.9085487077534792
180141933,0,1000,997,3,0.997,0.003
3163858636,1,704,16,688,0.022727272727272728,0.9772727272727273
1881426486,0,54,54,0,1.0,0.0
358306333,1,103,1,102,0.009708737864077669,0.9902912621359223
160588499,0,1000,991,9,0.991,0.009
1332829916946194436,1,487,90,397,0.18480492813141683,0.8151950718685832
1220032226307510272,0,356,355,1,0.9971910112359551,0.0028089887640449437
15201878,1,328,30,298,0.09146341463414634,0.9085365853658537
326887090,0,438,438,0,1.0,0.0
1071981517,0,1000,976,24,0.976,0.024
1946966479,1,1000,219,781,0.219,0.781
847635944559607810,0,342,320,22,0.935672514619883,0.06432748538011696
4416318795,1,134,18,116,0.13432835820895522,0.8656716417910447
24767619,0,1000,998,2,0.998,0.002
1198420436335439872,1,34,2,32,0.058823529411764705,0.9411764705882353
1429445035,0,74,74,0,1.0,0.0
518120695,1,433,21,412,0.04849884526558892,0.9515011547344111
1208792785190555648,0,33,32,1,0.9696969696969697,0.030303030303030304
1321197646627938305,1,1000,49,951,0.049,0.951
1360658544316579843,0,35,35,0,1.0,0.0
412617437,1,769,25,744,0.032509752925877766,0.9674902470741222
377100439,0,294,293,1,0.9965986394557823,0.003401360544217687
1446221136581337097,1,109,19,90,0.1743119266055046,0.8256880733944955
1009233834167107586,0,22,22,0,1.0,0.0
859080194,1,1000,178,822,0.178,0.822
537308160,0,74,74,0,1.0,0.0
1365784589223022595,1,232,46,186,0.19827586206896552,0.8017241379310345
1420482963041656839,0,80,77,3,0.9625,0.0375
2756874069,1,141,16,125,0.11347517730496454,0.8865248226950354
606075778,0,831,826,5,0.9939831528279182,0.006016847172081829
2760004827,1,391,81,310,0.2071611253196931,0.7928388746803069
3058707560,0,845,844,1,0.9988165680473373,0.001183431952662722
857707674619842560,1,318,22,296,0.06918238993710692,0.9308176100628931
2837863167,0,47,47,0,1.0,0.0
1375982931659780097,1,1000,86,914,0.086,0.914
773424114539388928,0,92,92,0,1.0,0.0
1400530871417982981,1,172,12,160,0.06976744186046512,0.9302325581395349
837709829837893633,0,168,167,1,0.9940476190476191,0.005952380952380952
1275632428477022213,0,1000,999,1,0.999,0.001
94679669,1,200,58,142,0.29,0.71
2170252097,0,1000,821,179,0.821,0.179
798885382871990272,1,76,5,71,0.06578947368421052,0.9342105263157895
845800461244350464,0,62,61,1,0.9838709677419355,0.016129032258064516
14339282,1,1000,111,889,0.111,0.889
746073482413244416,0,23,23,0,1.0,0.0
1392046338783825921,1,28,4,24,0.14285714285714285,0.8571428571428571
744535962928185344,1,26,8,18,0.3076923076923077,0.6923076923076923
733075966180904960,0,1000,998,2,0.998,0.002
947366271577919488,1,151,48,103,0.31788079470198677,0.6821192052980133
139549874,0,1000,990,10,0.99,0.01
35573652,1,1000,129,871,0.129,0.871
1001265133404991488,0,350,350,0,1.0,0.0
248268391,1,356,12,344,0.033707865168539325,0.9662921348314607
1463601626510467083,0,376,373,3,0.9920212765957447,0.007978723404255319
556062634,1,1000,282,718,0.282,0.718
1414841022228705281,0,1000,998,2,0.998,0.002
1349865410,1,472,71,401,0.1504237288135593,0.8495762711864406
249246828,0,157,157,0,1.0,0.0
918880607802818561,1,76,10,66,0.13157894736842105,0.868421052631579
2721822830,0,1000,993,7,0.993,0.007
1008868773250650112,1,612,120,492,0.19607843137254902,0.803921568627451
421562907,0,297,296,1,0.9966329966329966,0.003367003367003367
52253262,1,1000,210,790,0.21,0.79
1296987408290975745,0,102,102,0,1.0,0.0
3160383094,1,849,74,775,0.08716136631330977,0.9128386336866903
328098648,0,527,524,3,0.9943074003795066,0.0056925996204933585
48755968,1,1000,110,890,0.11,0.89
2741781257,0,9,9,0,1.0,0.0
20347305,1,1000,32,968,0.032,0.968
1433878980881440769,0,199,185,14,0.9296482412060302,0.07035175879396985
211630159,1,382,20,362,0.05235602094240838,0.9476439790575916
25359709,0,1000,956,44,0.956,0.044
1399410253138116611,1,31,4,27,0.12903225806451613,0.8709677419354839
193157677,0,152,152,0,1.0,0.0
13106122,1,54,6,48,0.1111111111111111,0.8888888888888888
3239248071,0,96,93,3,0.96875,0.03125
2310975900,1,1000,336,664,0.336,0.664
1025493480104239110,0,372,372,0,1.0,0.0
1018567315078701059,1,1000,40,960,0.04,0.96
916123412,0,37,35,2,0.9459459459459459,0.05405405405405406
2915124620,1,53,7,46,0.1320754716981132,0.8679245283018868
3282646831,0,1000,959,41,0.959,0.041
18576411,1,247,3,244,0.012145748987854251,0.9878542510121457
536857227,0,162,162,0,1.0,0.0
951795130847113216,1,908,103,805,0.11343612334801761,0.8865638766519823
1141383535435177986,0,246,244,2,0.991869918699187,0.008130081300813009
398335857,1,301,2,299,0.006644518272425249,0.9933554817275747
470660858,0,245,245,0,1.0,0.0
352891706,1,131,17,114,0.1297709923664122,0.8702290076335878
2210011,0,35,34,1,0.9714285714285714,0.02857142857142857
2957053068,1,111,1,110,0.009009009009009009,0.990990990990991
1472304164579512322,0,66,58,8,0.8787878787878788,0.12121212121212122
19255951,1,250,4,246,0.016,0.984
710030656,0,379,374,5,0.9868073878627969,0.013192612137203167
915413352,1,333,68,265,0.2042042042042042,0.7957957957957958
121041898,0,240,240,0,1.0,0.0
1141532908500504576,1,183,14,169,0.07650273224043716,0.9234972677595629
974579537924177925,0,162,147,15,0.9074074074074074,0.09259259259259259
3782631859,1,461,96,365,0.20824295010845986,0.7917570498915402
1303713173279662080,0,117,117,0,1.0,0.0
2843889471,1,511,13,498,0.025440313111545987,0.974559686888454
1051924000048369666,0,522,522,0,1.0,0.0
1181735694072459264,1,1000,90,910,0.09,0.91
1708249718,0,250,248,2,0.992,0.008
1090396411332415489,1,1000,75,925,0.075,0.925
1063985383543853057,0,36,36,0,1.0,0.0
403850625,1,134,12,122,0.08955223880597014,0.9104477611940298
1067716422850228224,0,1000,981,19,0.981,0.019
755512531477671936,1,396,3,393,0.007575757575757576,0.9924242424242424
153278670,0,1000,1000,0,1.0,0.0
1285233271,1,451,112,339,0.24833702882483372,0.7516629711751663
2987580557,0,121,121,0,1.0,0.0
15587189,1,1000,175,825,0.175,0.825
1215378686293237760,0,851,831,20,0.9764982373678026,0.023501762632197415
1166642642,1,593,23,570,0.0387858347386172,0.9612141652613828
329211022,0,628,623,5,0.9920382165605095,0.007961783439490446
1453547299645308932,1,291,18,273,0.061855670103092786,0.9381443298969072
2932952097,0,228,226,2,0.9912280701754386,0.008771929824561403
270099062,1,1000,87,913,0.087,0.913
705746928487829504,0,436,433,3,0.9931192660550459,0.006880733944954129
1191195211139100673,1,259,49,210,0.1891891891891892,0.8108108108108109
1026033385972674560,0,56,55,1,0.9821428571428571,0.017857142857142856
1444779122769555458,1,20,2,18,0.1,0.9
1435714459520094216,0,27,27,0,1.0,0.0
1071628447,1,312,51,261,0.16346153846153846,0.8365384615384616
1381430448870486019,0,300,300,0,1.0,0.0
74455893,1,1000,118,882,0.118,0.882
1474168223440334854,0,31,30,1,0.967741935483871,0.03225806451612903
2830894887,1,260,9,251,0.03461538461538462,0.9653846153846154
985893116115906560,0,220,215,5,0.9772727272727273,0.022727272727272728
31401922,1,918,74,844,0.08061002178649238,0.9193899782135077
310569316,0,1000,993,7,0.993,0.007
397439443,1,300,16,284,0.05333333333333334,0.9466666666666667
151298269,0,138,138,0,1.0,0.0
1198539864,1,135,21,114,0.15555555555555556,0.8444444444444444
111070720,0,35,35,0,1.0,0.0
1373455952784064514,1,263,38,225,0.1444866920152091,0.8555133079847909
854383866416701440,1,388,13,375,0.03350515463917526,0.9664948453608248
1220201592395309056,0,27,26,1,0.9629629629629629,0.037037037037037035
1349490280358035458,1,69,17,52,0.2463768115942029,0.7536231884057971
19198445,0,868,830,38,0.956221198156682,0.04377880184331797
31420632,0,1000,937,63,0.937,0.063
1607742422,1,81,10,71,0.12345679012345678,0.8765432098765432
711621665747243008,1,170,14,156,0.08235294117647059,0.9176470588235294
1270754947,0,104,104,0,1.0,0.0
2441128721,0,397,397,0,1.0,0.0
1202337409851174917,1,18,3,15,0.16666666666666666,0.8333333333333334
42322690,0,467,455,12,0.974304068522484,0.02569593147751606
758941334388342784,0,261,261,0,1.0,0.0
25136703,1,1000,71,929,0.071,0.929
1351982698072600579,0,119,119,0,1.0,0.0
3222690600,1,294,3,291,0.01020408163265306,0.9897959183673469
806252422473596929,0,48,45,3,0.9375,0.0625
134606701,1,1000,51,949,0.051,0.949
84937882,0,163,158,5,0.9693251533742331,0.03067484662576687
3297599815,1,643,278,365,0.432348367029549,0.567651632970451
1208609852328689664,0,13,13,0,1.0,0.0
745396234513416192,1,283,61,222,0.21554770318021202,0.784452296819788
2638886309,0,190,188,2,0.9894736842105263,0.010526315789473684
398775308,1,331,12,319,0.03625377643504532,0.9637462235649547
3093963872,0,367,351,16,0.9564032697547684,0.043596730245231606
2220247130,1,247,87,160,0.3522267206477733,0.6477732793522267
1409776016,0,1000,998,2,0.998,0.002
43816876,1,1000,4,996,0.004,0.996
2896428492,0,127,127,0,1.0,0.0
1208895377052712960,1,1000,123,877,0.123,0.877
48817854,0,1000,898,102,0.898,0.102
806632114510823424,1,230,35,195,0.15217391304347827,0.8478260869565217
1321948262828486656,0,476,474,2,0.9957983193277311,0.004201680672268907
2703375752,1,875,160,715,0.18285714285714286,0.8171428571428572
196462049,0,213,213,0,1.0,0.0
796558864875474946,1,19,6,13,0.3157894736842105,0.6842105263157895
722915182968770560,0,129,129,0,1.0,0.0
1184075826,1,967,172,795,0.1778697001034126,0.8221302998965874
1405142929547710467,0,31,30,1,0.967741935483871,0.03225806451612903
285835222,1,869,113,756,0.13003452243958574,0.8699654775604143
73212058,0,598,597,1,0.9983277591973244,0.0016722408026755853
2685148677,1,1000,142,858,0.142,0.858
74542219,0,257,256,1,0.9961089494163424,0.0038910505836575876
883460654006497280,1,787,102,685,0.12960609911054638,0.8703939008894537
971123887407796225,0,1000,968,32,0.968,0.032
1032065002147069953,1,85,13,72,0.15294117647058825,0.8470588235294118
858545082932183040,0,153,142,11,0.9281045751633987,0.0718954248366013
234828848,1,1000,83,917,0.083,0.917
718273321,0,17,17,0,1.0,0.0
1397762849141821440,1,6,1,5,0.16666666666666666,0.8333333333333334
276792669,0,1000,991,9,0.991,0.009
589399108,1,1000,37,963,0.037,0.963
25417708,0,1000,996,4,0.996,0.004
3353804427,1,218,14,204,0.06422018348623854,0.9357798165137615
1411434741056688128,0,956,956,0,1.0,0.0
2332082161,1,140,6,134,0.04285714285714286,0.9571428571428572
22780747,0,205,205,0,1.0,0.0
879340211641212929,1,47,12,35,0.2553191489361702,0.7446808510638298
24400241,0,63,63,0,1.0,0.0
467642034,0,428,426,2,0.9953271028037384,0.004672897196261682
51823235,1,1000,69,931,0.069,0.931
1029774007372001282,0,232,230,2,0.9913793103448276,0.008620689655172414
17934033,1,1000,102,898,0.102,0.898
1074663225126518789,0,415,407,8,0.980722891566265,0.01927710843373494
950449006529757184,1,3,0,3,0.0,1.0
1483478411616083971,0,26,23,3,0.8846153846153846,0.11538461538461539
545510935,1,120,14,106,0.11666666666666667,0.8833333333333333
1334288454457372676,0,1000,992,8,0.992,0.008
18638800,1,1000,20,980,0.02,0.98
54807100,0,147,146,1,0.9931972789115646,0.006802721088435374
824477350582554624,1,303,15,288,0.04950495049504951,0.9504950495049505
743888430833111040,0,1000,996,4,0.996,0.004
1293645965182808065,1,305,44,261,0.14426229508196722,0.8557377049180328
3272139810,0,165,162,3,0.9818181818181818,0.01818181818181818
942097618036973568,1,14,0,14,0.0,1.0
1206659659521757184,0,189,189,0,1.0,0.0
3401433005,1,80,12,68,0.15,0.85
2211339463,1,234,43,191,0.18376068376068377,0.8162393162393162
1151294464805093376,0,833,816,17,0.9795918367346939,0.02040816326530612
1351006613742772231,1,6,1,5,0.16666666666666666,0.8333333333333334
3023263550,0,223,216,7,0.968609865470852,0.03139013452914798
48083479,1,117,14,103,0.11965811965811966,0.8803418803418803
553996253,0,196,194,2,0.9897959183673469,0.01020408163265306
1335147522,1,199,21,178,0.10552763819095477,0.8944723618090452
1386098146883870723,0,56,49,7,0.875,0.125
49573194,1,360,41,319,0.11388888888888889,0.8861111111111111
340437646,0,1000,999,1,0.999,0.001
896545630322966529,1,236,65,171,0.2754237288135593,0.7245762711864406
2997480391,0,709,659,50,0.9294781382228491,0.07052186177715092
92179256,1,234,30,204,0.1282051282051282,0.8717948717948718
75686436,0,1000,1000,0,1.0,0.0
2463571912,1,328,13,315,0.039634146341463415,0.9603658536585366
178040388,0,959,958,1,0.9989572471324296,0.0010427528675703858
869082696,0,627,625,2,0.9968102073365231,0.003189792663476874
76291066,1,1000,22,978,0.022,0.978
1375957022,1,52,4,48,0.07692307692307693,0.9230769230769231
1272345261512237056,0,43,42,1,0.9767441860465116,0.023255813953488372
15846067,1,1000,17,983,0.017,0.983
1045285652240244737,0,2,2,0,1.0,0.0
1016856979606732800,1,118,15,103,0.1271186440677966,0.8728813559322034
1046989292676026371,0,27,27,0,1.0,0.0
242458225,1,433,52,381,0.12009237875288684,0.8799076212471132
772583664618049536,0,160,158,2,0.9875,0.0125
40379462,1,293,11,282,0.03754266211604096,0.962457337883959
52135684,0,547,539,8,0.9853747714808044,0.014625228519195612
324449092,1,97,5,92,0.05154639175257732,0.9484536082474226
1443682020203409414,0,54,54,0,1.0,0.0
1027053409336143872,1,166,32,134,0.1927710843373494,0.8072289156626506
41013188,0,172,164,8,0.9534883720930233,0.046511627906976744
10209292,1,1000,159,841,0.159,0.841
2244048403,0,63,63,0,1.0,0.0
1166687268297482240,1,1000,27,973,0.027,0.973
449234512,0,1000,953,47,0.953,0.047
374084739,1,333,13,320,0.03903903903903904,0.960960960960961
1469755184947605504,0,131,130,1,0.9923664122137404,0.007633587786259542
2861800411,1,20,3,17,0.15,0.85
410324298,0,111,111,0,1.0,0.0
215165884,1,83,5,78,0.060240963855421686,0.9397590361445783
1209019747595169792,0,136,133,3,0.9779411764705882,0.022058823529411766
393704810,1,845,29,816,0.03431952662721893,0.9656804733727811
1524465080888270850,0,3,3,0,1.0,0.0
1530557625015730176,1,55,3,52,0.05454545454545454,0.9454545454545454
2955983229,0,317,317,0,1.0,0.0
964884396,1,113,10,103,0.08849557522123894,0.911504424778761
1208671544572104706,0,494,492,2,0.9959514170040485,0.004048582995951417
411224489,1,1000,48,952,0.048,0.952
2940117918,0,50,50,0,1.0,0.0
1304406110728859651,1,233,43,190,0.18454935622317598,0.8154506437768241
157134498,0,12,12,0,1.0,0.0
14704214,1,303,40,263,0.132013201320132,0.8679867986798679
1449761371080507399,0,21,21,0,1.0,0.0
165497426,1,737,74,663,0.10040705563093623,0.8995929443690638
938052830203584512,0,6,6,0,1.0,0.0
328355182,1,495,41,454,0.08282828282828283,0.9171717171717172
119808978,0,135,135,0,1.0,0.0
3224535373,1,186,28,158,0.15053763440860216,0.8494623655913979
1507419867057643526,0,37,36,1,0.972972972972973,0.02702702702702703
70572593,1,51,14,37,0.27450980392156865,0.7254901960784313
44324797,0,592,584,8,0.9864864864864865,0.013513513513513514
1282447307212877825,0,29,27,2,0.9310344827586207,0.06896551724137931
1389284445908213760,1,264,37,227,0.14015151515151514,0.8598484848484849
1027022100,0,80,77,3,0.9625,0.0375
1511562293305303066,1,480,2,478,0.004166666666666667,0.9958333333333333
1184167657131708416,0,378,362,16,0.9576719576719577,0.042328042328042326
4368745395,1,246,9,237,0.036585365853658534,0.9634146341463414
48721738,0,371,371,0,1.0,0.0
3158200735,1,82,7,75,0.08536585365853659,0.9146341463414634
35605691,0,198,198,0,1.0,0.0
1376738284643049472,1,8,1,7,0.125,0.875
1279819279446216706,0,705,704,1,0.9985815602836879,0.0014184397163120568
2316574699,1,400,62,338,0.155,0.845
1481232934200049666,0,909,909,0,1.0,0.0
22648354,1,1000,26,974,0.026,0.974
3385203887,0,241,238,3,0.9875518672199171,0.012448132780082987
3015379612,1,759,119,640,0.15678524374176547,0.8432147562582345
89032577,0,20,20,0,1.0,0.0
1074558472371531776,1,142,52,90,0.36619718309859156,0.6338028169014085
55611364,0,191,189,2,0.9895287958115183,0.010471204188481676
178358955,1,139,24,115,0.17266187050359713,0.8273381294964028
2626053802,0,411,387,24,0.9416058394160584,0.058394160583941604
2542268318,1,1000,141,859,0.141,0.859
1340780523493343233,0,607,595,12,0.9802306425041186,0.019769357495881382
3367642104,1,15,1,14,0.06666666666666667,0.9333333333333333
585864618,0,1000,999,1,0.999,0.001
1174674976756178950,1,1000,137,863,0.137,0.863
45148454,0,10,9,1,0.9,0.1
1020368618608103425,1,112,17,95,0.15178571428571427,0.8482142857142857
471635610,0,200,188,12,0.94,0.06
4877266271,1,1000,121,879,0.121,0.879
794979120434348032,0,56,56,0,1.0,0.0
822333050,1,187,61,126,0.32620320855614976,0.6737967914438503
1380520768195416064,0,61,61,0,1.0,0.0
1295100647755440137,1,34,5,29,0.14705882352941177,0.8529411764705882
4698026371,0,317,282,35,0.889589905362776,0.11041009463722397
1179566851774283777,1,112,21,91,0.1875,0.8125
938222210216493056,0,172,171,1,0.9941860465116279,0.005813953488372093
930898277268164609,1,268,64,204,0.23880597014925373,0.7611940298507462
725442900574654464,0,952,924,28,0.9705882352941176,0.029411764705882353
3886916594,1,193,17,176,0.08808290155440414,0.9119170984455959
924414257013420032,0,18,18,0,1.0,0.0
1141458691,1,788,130,658,0.1649746192893401,0.8350253807106599
733907910,0,250,250,0,1.0,0.0
41707447,1,703,23,680,0.032716927453769556,0.9672830725462305
760729379152551936,0,77,76,1,0.987012987012987,0.012987012987012988
1187361048996634624,1,1000,183,817,0.183,0.817
869523132431945728,0,1000,980,20,0.98,0.02
532264892,1,1000,24,976,0.024,0.976
1435621563571662863,0,259,255,4,0.9845559845559846,0.015444015444015444
1138898276399439872,1,1000,58,942,0.058,0.942
502382414,0,141,134,7,0.950354609929078,0.04964539007092199
14412416,1,363,12,351,0.03305785123966942,0.9669421487603306
378269649,0,408,397,11,0.9730392156862745,0.02696078431372549
26646731,1,1000,83,917,0.083,0.917
17365337,0,1000,999,1,0.999,0.001
40437518,1,1000,114,886,0.114,0.886
1359136386738192390,0,81,81,0,1.0,0.0
1592343325,1,81,3,78,0.037037037037037035,0.9629629629629629
1103870173793026049,0,30,30,0,1.0,0.0
883054110160941056,1,31,2,29,0.06451612903225806,0.9354838709677419
851201192,0,44,44,0,1.0,0.0
248154991,1,332,9,323,0.02710843373493976,0.9728915662650602
14055342,1,620,59,561,0.09516129032258064,0.9048387096774193
981372618,0,328,323,5,0.9847560975609756,0.01524390243902439
4701419046,0,173,169,4,0.976878612716763,0.023121387283236993
252882099,0,79,79,0,1.0,0.0
24241717,1,238,18,220,0.07563025210084033,0.9243697478991597
1213147087438614530,0,40,40,0,1.0,0.0
1341192368360452097,1,69,4,65,0.057971014492753624,0.9420289855072463
1477502258346696704,0,62,62,0,1.0,0.0
716348555972243456,1,130,21,109,0.16153846153846155,0.8384615384615385
2985912825,0,111,111,0,1.0,0.0
1535672028241461248,1,23,5,18,0.21739130434782608,0.782608695652174
3327839948,0,135,132,3,0.9777777777777777,0.022222222222222223
37565282,1,972,41,931,0.04218106995884774,0.9578189300411523
1281806000433926146,0,37,34,3,0.918918918918919,0.08108108108108109
1332579144056647680,1,47,11,36,0.23404255319148937,0.7659574468085106
702675152107147264,0,479,477,2,0.9958246346555324,0.0041753653444676405
792199928370135042,1,320,14,306,0.04375,0.95625
2550748015,0,169,166,3,0.9822485207100592,0.01775147928994083
1104520910755643392,1,1000,115,885,0.115,0.885
549518859,0,38,38,0,1.0,0.0
9855852,1,96,8,88,0.08333333333333333,0.9166666666666666
771796814685167616,0,369,356,13,0.964769647696477,0.03523035230352303
1491426211918057474,1,2,0,2,0.0,1.0
597016455,0,124,124,0,1.0,0.0
2450220686,1,1000,20,980,0.02,0.98
1156322815655731201,0,22,22,0,1.0,0.0
1299912001150480384,1,1000,391,609,0.391,0.609
745394122253438977,0,1000,1000,0,1.0,0.0
466145501,1,80,4,76,0.05,0.95
396373312,0,705,705,0,1.0,0.0
299437413,1,259,3,256,0.011583011583011582,0.9884169884169884
1090191913,0,1000,998,2,0.998,0.002
741054379,1,124,5,119,0.04032258064516129,0.9596774193548387
1165359211586433024,0,147,143,4,0.9727891156462585,0.027210884353741496
1517888350526611459,1,12,0,12,0.0,1.0
4152212896,1,92,22,70,0.2391304347826087,0.7608695652173914
309821793,0,521,520,1,0.9980806142034548,0.0019193857965451055
1478261442,1,1000,213,787,0.213,0.787
2649999283,0,72,69,3,0.9583333333333334,0.041666666666666664
1134891507960336384,0,1000,988,12,0.988,0.012
819472874,1,180,3,177,0.016666666666666666,0.9833333333333333
995607845188976640,0,145,144,1,0.993103448275862,0.006896551724137931
28621496,1,1000,54,946,0.054,0.946
1273837927265701890,0,1000,993,7,0.993,0.007
1500114395300614147,1,1000,68,932,0.068,0.932
91491226,0,34,34,0,1.0,0.0
1053769378645323778,1,912,207,705,0.22697368421052633,0.7730263157894737
1378090047405187084,0,11,11,0,1.0,0.0
769800767670587392,1,136,5,131,0.03676470588235294,0.9632352941176471
1329222601164664832,0,18,16,2,0.8888888888888888,0.1111111111111111
21549310,0,1000,965,35,0.965,0.035
56141616,1,947,110,837,0.11615628299894404,0.883843717001056
3047898654,0,30,28,2,0.9333333333333333,0.06666666666666667
14335999,1,232,26,206,0.11206896551724138,0.8879310344827587
16474531,0,1000,1000,0,1.0,0.0
844951159819390977,1,429,44,385,0.10256410256410256,0.8974358974358975
461188559,0,331,331,0,1.0,0.0
1059920391198662656,1,47,2,45,0.0425531914893617,0.9574468085106383
2345794178,1,1000,212,788,0.212,0.788
955956638287982594,0,30,30,0,1.0,0.0
1636575878,1,150,31,119,0.20666666666666667,0.7933333333333333
37754631,0,645,645,0,1.0,0.0
552445101,1,752,132,620,0.17553191489361702,0.824468085106383
1048432561062666240,0,72,72,0,1.0,0.0
469110552,1,1000,195,805,0.195,0.805
44330248,0,50,48,2,0.96,0.04
926943404381978624,1,1000,244,756,0.244,0.756
525823437,0,737,737,0,1.0,0.0
782466257517883392,1,1000,68,932,0.068,0.932
994970278865219584,0,7,6,1,0.8571428571428571,0.14285714285714285
31170916,0,120,116,4,0.9666666666666667,0.03333333333333333
1287744518146727936,1,1000,307,693,0.307,0.693
1282429808962670594,0,55,54,1,0.9818181818181818,0.01818181818181818
72354175,1,1000,11,989,0.011,0.989
1340179413741293568,0,74,72,2,0.972972972972973,0.02702702702702703
3388197292,1,46,2,44,0.043478260869565216,0.9565217391304348
1518637073602908163,0,232,232,0,1.0,0.0
1315425127,1,418,31,387,0.07416267942583732,0.9258373205741627
299653057,0,1000,1000,0,1.0,0.0
1047240991898525698,1,144,13,131,0.09027777777777778,0.9097222222222222
1203806117450715137,0,13,10,3,0.7692307692307693,0.23076923076923078
974107446892412928,1,35,6,29,0.17142857142857143,0.8285714285714286
2780077309,0,45,42,3,0.9333333333333333,0.06666666666666667
919609621450510336,1,128,33,95,0.2578125,0.7421875
540143075,0,40,36,4,0.9,0.1
1000502091876585474,1,731,167,564,0.22845417236662108,0.771545827633379
1941782497,0,186,186,0,1.0,0.0
2942323808,1,688,220,468,0.31976744186046513,0.6802325581395349
2200011817,0,565,563,2,0.9964601769911504,0.0035398230088495575
390497990,1,876,156,720,0.1780821917808219,0.821917808219178
1009552813335154688,0,1000,969,31,0.969,0.031
1592274824,1,230,4,226,0.017391304347826087,0.9826086956521739
2677196249,0,127,127,0,1.0,0.0
25299512,1,201,42,159,0.208955223880597,0.7910447761194029
1187155940627214337,0,71,64,7,0.9014084507042254,0.09859154929577464
206706535,1,181,8,173,0.04419889502762431,0.9558011049723757
1381833399674015750,0,24,24,0,1.0,0.0
88294759,1,219,23,196,0.1050228310502283,0.8949771689497716
883949929361620992,0,5,5,0,1.0,0.0
374314199,1,462,38,424,0.08225108225108226,0.9177489177489178
400432839,0,1000,977,23,0.977,0.023
509296321,1,618,45,573,0.07281553398058252,0.9271844660194175
1482583022750900227,0,42,40,2,0.9523809523809523,0.047619047619047616
33008607,1,1000,210,790,0.21,0.79
119131827,0,296,292,4,0.9864864864864865,0.013513513513513514
156560059,1,634,82,552,0.12933753943217666,0.8706624605678234
1354093859312193538,0,1000,969,31,0.969,0.031
3394040259,1,210,11,199,0.05238095238095238,0.9476190476190476
546820570,0,1000,972,28,0.972,0.028
1341002445107785728,1,140,11,129,0.07857142857142857,0.9214285714285714
173029441,0,122,119,3,0.9754098360655737,0.02459016393442623
1517036697044889600,1,6,2,4,0.3333333333333333,0.6666666666666666
17223760,0,162,158,4,0.9753086419753086,0.024691358024691357
2149903372,1,1000,58,942,0.058,0.942
4053908782,0,509,509,0,1.0,0.0
757985401,1,472,9,463,0.019067796610169493,0.9809322033898306
2272376857,0,261,253,8,0.9693486590038314,0.03065134099616858
586124437,1,100,11,89,0.11,0.89
1138549968292241411,0,1000,998,2,0.998,0.002
1215704082691784705,1,288,49,239,0.1701388888888889,0.8298611111111112
1214732582644076544,0,290,290,0,1.0,0.0
805855727994609665,1,223,16,207,0.07174887892376682,0.9282511210762332
473473828,0,148,145,3,0.9797297297297297,0.02027027027027027
763303679029936128,1,293,4,289,0.013651877133105802,0.9863481228668942
1308121155111473152,1,19,3,16,0.15789473684210525,0.8421052631578947
246899367,0,610,610,0,1.0,0.0
614015683,1,1000,133,867,0.133,0.867
1424190206379536399,0,1000,989,11,0.989,0.011
788600202613624833,1,217,13,204,0.059907834101382486,0.9400921658986175
67695741,0,1000,807,193,0.807,0.193
458710729,1,296,13,283,0.04391891891891892,0.956081081081081
1027701836,0,205,204,1,0.9951219512195122,0.004878048780487805
946840436,1,945,106,839,0.11216931216931217,0.8878306878306879
1325563737537875968,0,170,170,0,1.0,0.0
1490330425,1,1000,71,929,0.071,0.929
30391215,0,299,295,4,0.9866220735785953,0.013377926421404682
3402058720,1,533,28,505,0.0525328330206379,0.9474671669793621
1422673820075298821,0,2,2,0,1.0,0.0
255679214,1,321,65,256,0.20249221183800623,0.7975077881619937
259842434,0,75,74,1,0.9866666666666667,0.013333333333333334
785302031246307329,1,37,4,33,0.10810810810810811,0.8918918918918919
3194829535,0,591,577,14,0.9763113367174281,0.023688663282571912
1444585266,1,1000,43,957,0.043,0.957
1518923839778050048,0,777,777,0,1.0,0.0
1666387688,1,240,6,234,0.025,0.975
1390183635597205506,0,331,331,0,1.0,0.0
28843462,1,313,25,288,0.07987220447284345,0.9201277955271565
1235735344546381826,0,64,63,1,0.984375,0.015625
1336919644389695488,1,64,4,60,0.0625,0.9375
2574377266,0,295,288,7,0.976271186440678,0.023728813559322035
879780440072220673,0,816,813,3,0.9963235294117647,0.003676470588235294
1480468536,1,722,112,610,0.15512465373961218,0.8448753462603878
824068486175555584,0,54,54,0,1.0,0.0
225242162,1,109,13,96,0.11926605504587157,0.8807339449541285
1115416866,1,105,4,101,0.0380952380952381,0.9619047619047619
66727747,0,144,141,3,0.9791666666666666,0.020833333333333332
21090638,1,67,3,64,0.04477611940298507,0.9552238805970149
318063776,0,7,7,0,1.0,0.0
600680173,1,13,1,12,0.07692307692307693,0.9230769230769231
1006634628445134848,0,1,1,0,1.0,0.0
260552915,1,445,20,425,0.0449438202247191,0.9550561797752809
1470854674362384386,0,7,6,1,0.8571428571428571,0.14285714285714285
3176970086,1,23,3,20,0.13043478260869565,0.8695652173913043
1085445764,0,941,938,3,0.9968119022316685,0.003188097768331562
98448194,1,66,19,47,0.2878787878787879,0.7121212121212122
27066764,0,335,320,15,0.9552238805970149,0.04477611940298507
4816236257,0,316,301,15,0.9525316455696202,0.04746835443037975
135186754,0,354,345,9,0.9745762711864406,0.025423728813559324
1007106934795796480,1,20,3,17,0.15,0.85
1364380157365084160,0,136,135,1,0.9926470588235294,0.007352941176470588
269124457,1,280,14,266,0.05,0.95
22517014,0,412,376,36,0.912621359223301,0.08737864077669903
793996208008232960,1,117,20,97,0.17094017094017094,0.8290598290598291
1108783796781019136,0,37,37,0,1.0,0.0
41030933,1,1000,120,880,0.12,0.88
61338649,0,557,557,0,1.0,0.0
749426847188942849,1,33,2,31,0.06060606060606061,0.9393939393939394
1136692059740487680,0,83,82,1,0.9879518072289156,0.012048192771084338
959540528,1,51,1,50,0.0196078431372549,0.9803921568627451
1123223739074617344,0,241,241,0,1.0,0.0
3347619411,1,1000,26,974,0.026,0.974
61750017,0,167,156,11,0.9341317365269461,0.0658682634730539
2248410098,1,1000,213,787,0.213,0.787
1039857212,0,329,328,1,0.9969604863221885,0.00303951367781155
1053892176,1,205,2,203,0.00975609756097561,0.9902439024390244
59931488,0,1000,977,23,0.977,0.023
19473934,1,620,56,564,0.09032258064516129,0.9096774193548387
2429333618,0,1000,998,2,0.998,0.002
1332589110,1,45,2,43,0.044444444444444446,0.9555555555555556
123062306,0,76,76,0,1.0,0.0
1380162244051398667,1,4,1,3,0.25,0.75
4832231295,0,464,463,1,0.9978448275862069,0.0021551724137931034
14423880,1,432,20,412,0.046296296296296294,0.9537037037037037
1439009481602572288,0,1,1,0,1.0,0.0
312463534,1,537,17,520,0.03165735567970205,0.9683426443202979
177847205,0,337,337,0,1.0,0.0
29740055,1,69,6,63,0.08695652173913043,0.9130434782608695
1379998713783988225,0,54,49,5,0.9074074074074074,0.09259259259259259
1053370877818003461,1,428,76,352,0.17757009345794392,0.822429906542056
720014853465739264,0,17,17,0,1.0,0.0
537195552,1,58,11,47,0.1896551724137931,0.8103448275862069
1441968216062844939,0,1000,1000,0,1.0,0.0
32725598,1,126,27,99,0.21428571428571427,0.7857142857142857
42814950,0,14,14,0,1.0,0.0
832705508435832832,1,75,29,46,0.38666666666666666,0.6133333333333333
174952216,0,517,516,1,0.9980657640232108,0.0019342359767891683
1094045636071108608,1,26,6,20,0.23076923076923078,0.7692307692307693
707126315,0,307,305,2,0.993485342019544,0.006514657980456026
902271531648245760,1,485,146,339,0.30103092783505153,0.6989690721649484
883730883580116994,0,189,188,1,0.9947089947089947,0.005291005291005291
130910269,1,183,22,161,0.12021857923497267,0.8797814207650273
2908160787,0,39,39,0,1.0,0.0
313440515,1,137,0,137,0.0,1.0
361188491,0,1000,1000,0,1.0,0.0
1043298731301462016,1,1000,175,825,0.175,0.825
3300993501,0,1000,944,56,0.944,0.056
1077362988129107968,1,305,97,208,0.3180327868852459,0.6819672131147541
965011608,0,1000,974,26,0.974,0.026
822987724747669505,1,171,9,162,0.05263157894736842,0.9473684210526315
114358677,0,1000,992,8,0.992,0.008
970184090744967168,1,43,15,28,0.3488372093023256,0.6511627906976745
1447756850326380547,0,42,42,0,1.0,0.0
438018606,0,1000,944,56,0.944,0.056
1244463825799139330,1,585,1,584,0.0017094017094017094,0.9982905982905983
1520409076223512578,0,4,4,0,1.0,0.0
2293831064,1,121,28,93,0.23140495867768596,0.768595041322314
1352559960270401537,0,15,15,0,1.0,0.0
1380090306947768324,1,48,12,36,0.25,0.75
949419604962508800,0,341,341,0,1.0,0.0
1288117431739674624,1,419,58,361,0.13842482100238662,0.8615751789976134
2450521644,0,61,61,0,1.0,0.0
1063655693239152641,0,138,136,2,0.9855072463768116,0.014492753623188406
756570307129999360,1,85,20,65,0.23529411764705882,0.7647058823529411
637192902,0,526,525,1,0.9980988593155894,0.0019011406844106464
758403576758726656,1,167,23,144,0.1377245508982036,0.8622754491017964
1419995718442393602,0,4,4,0,1.0,0.0
3025917544,1,592,21,571,0.03547297297297297,0.964527027027027
932796807779930112,0,30,29,1,0.9666666666666667,0.03333333333333333
2766706047,1,196,11,185,0.05612244897959184,0.9438775510204082
2340676608,0,517,516,1,0.9980657640232108,0.0019342359767891683
1326693806432006145,1,1000,217,783,0.217,0.783
229666516,0,1000,991,9,0.991,0.009
91033548,1,160,2,158,0.0125,0.9875
1395012630029295617,0,414,408,6,0.9855072463768116,0.014492753623188406
395154936,1,1000,96,904,0.096,0.904
815981368136126464,0,1000,1000,0,1.0,0.0
886407296204406785,1,123,15,108,0.12195121951219512,0.8780487804878049
745456126213271552,0,4,4,0,1.0,0.0
197417525,1,1000,7,993,0.007,0.993
877911161353719809,1,98,4,94,0.04081632653061224,0.9591836734693877
221546551,0,1000,845,155,0.845,0.155
1325325601675284485,1,151,6,145,0.039735099337748346,0.9602649006622517
1462638239207075840,0,20,20,0,1.0,0.0
1486916255823147011,1,127,25,102,0.1968503937007874,0.8031496062992126
1431363990496624642,0,31,27,4,0.8709677419354839,0.12903225806451613
1425100962100826120,1,24,1,23,0.041666666666666664,0.9583333333333334
1509345638382817286,0,79,78,1,0.9873417721518988,0.012658227848101266
1219776592437751808,0,307,306,1,0.996742671009772,0.003257328990228013
21984954,1,129,23,106,0.17829457364341086,0.8217054263565892
1351778486080446467,0,15,14,1,0.9333333333333333,0.06666666666666667
1351953041293885442,1,28,1,27,0.03571428571428571,0.9642857142857143
954565407549005824,0,61,61,0,1.0,0.0
1248047996425490433,1,115,13,102,0.11304347826086956,0.8869565217391304
98505436,0,1000,996,4,0.996,0.004
1273741784,1,79,13,66,0.16455696202531644,0.8354430379746836
138264983,0,1000,935,65,0.935,0.065
870300721,1,659,38,621,0.057663125948406675,0.9423368740515933
150114465,0,132,130,2,0.9848484848484849,0.015151515151515152
834554660568526850,1,463,85,378,0.183585313174946,0.816414686825054
3154569355,0,280,280,0,1.0,0.0
1445593072042082304,1,727,38,689,0.052269601100412656,0.9477303988995873
897860639267442693,0,491,484,7,0.9857433808553971,0.014256619144602852
193524095,1,1000,113,887,0.113,0.887
87067280,0,1000,922,78,0.922,0.078
1439509105,1,274,17,257,0.06204379562043796,0.9379562043795621
852545841625571328,0,130,129,1,0.9923076923076923,0.007692307692307693
1037518064236081157,1,1000,291,709,0.291,0.709
735677513095991298,0,237,237,0,1.0,0.0
3307246382,1,1000,16,984,0.016,0.984
618781928,0,1000,998,2,0.998,0.002
864887350890971137,1,60,19,41,0.31666666666666665,0.6833333333333333
29751232,0,153,153,0,1.0,0.0
114968194,1,595,3,592,0.005042016806722689,0.9949579831932773
733562060,0,21,21,0,1.0,0.0
1197524444975181824,1,121,13,108,0.10743801652892562,0.8925619834710744
912577673515405312,0,68,68,0,1.0,0.0
289472262,1,105,22,83,0.20952380952380953,0.7904761904761904
69331923,0,840,839,1,0.9988095238095238,0.0011904761904761906
255709664,1,143,12,131,0.08391608391608392,0.916083916083916
88643880,0,73,73,0,1.0,0.0
16155720,1,370,14,356,0.03783783783783784,0.9621621621621622
737884344,0,148,148,0,1.0,0.0
2490389263,1,204,18,186,0.08823529411764706,0.9117647058823529
1497946958505426949,0,62,59,3,0.9516129032258065,0.04838709677419355
1105888562489290753,1,807,162,645,0.20074349442379183,0.7992565055762082
4426395673,0,28,28,0,1.0,0.0
4669610827,1,964,104,860,0.1078838174273859,0.8921161825726142
957465683276812288,0,25,25,0,1.0,0.0
246103223,1,277,34,243,0.12274368231046931,0.8772563176895307
244972130,0,73,68,5,0.9315068493150684,0.0684931506849315
934940261435703296,1,19,1,18,0.05263157894736842,0.9473684210526315
837991587313397760,0,334,329,5,0.9850299401197605,0.014970059880239521
2742969477,1,101,10,91,0.09900990099009901,0.900990099009901
83446173,0,1000,995,5,0.995,0.005
2313404349,1,469,52,417,0.11087420042643924,0.8891257995735607
1311409867706511360,0,16,16,0,1.0,0.0
735921457864146944,1,1000,32,968,0.032,0.968
437002374,0,1000,996,4,0.996,0.004
823236472505503744,1,308,113,195,0.36688311688311687,0.6331168831168831
1319503347435581440,0,62,62,0,1.0,0.0
24142250,1,244,1,243,0.004098360655737705,0.9959016393442623
1355158603,0,426,424,2,0.9953051643192489,0.004694835680751174
2718974062,1,94,9,85,0.09574468085106383,0.9042553191489362
1336018270688862208,0,1000,995,5,0.995,0.005
2494275290,1,1000,254,746,0.254,0.746
4350258985,0,34,34,0,1.0,0.0
1216863437940314117,1,669,77,592,0.11509715994020926,0.8849028400597907
164325716,0,946,737,209,0.7790697674418605,0.22093023255813954
1476759019557900291,1,105,8,97,0.0761904761904762,0.9238095238095239
140019372,0,412,412,0,1.0,0.0
1094643346763640832,1,42,7,35,0.16666666666666666,0.8333333333333334
244516137,0,575,559,16,0.9721739130434782,0.02782608695652174
1019666356998983685,1,185,61,124,0.32972972972972975,0.6702702702702703
1068966400042127360,0,240,219,21,0.9125,0.0875
103423283,1,1000,170,830,0.17,0.83
1538690173487161346,0,41,41,0,1.0,0.0
1430229401850028036,1,491,98,393,0.19959266802443992,0.8004073319755601
364703737,1,1000,46,954,0.046,0.954
1514684412742488064,0,2,2,0,1.0,0.0
866107556971782144,1,40,6,34,0.15,0.85
377728970,0,437,428,9,0.9794050343249427,0.020594965675057208
158046199,1,164,25,139,0.1524390243902439,0.8475609756097561
867209785,0,80,79,1,0.9875,0.0125
78623,1,1000,123,877,0.123,0.877
1166470264273559552,0,139,137,2,0.9856115107913669,0.014388489208633094
591982786,1,81,5,76,0.06172839506172839,0.9382716049382716
2300739988,0,516,516,0,1.0,0.0
293771414,1,1000,167,833,0.167,0.833
1345295949753626624,0,9,9,0,1.0,0.0
18196459,1,1000,147,853,0.147,0.853
1462542402292535303,0,32,32,0,1.0,0.0
1074614380195602433,1,1000,47,953,0.047,0.953
1461874214605148160,0,700,700,0,1.0,0.0
396798222,1,547,9,538,0.016453382084095063,0.9835466179159049
493726593,0,936,898,38,0.9594017094017094,0.0405982905982906
129417060,1,448,152,296,0.3392857142857143,0.6607142857142857
1402511912,0,190,190,0,1.0,0.0
2432678228,1,484,16,468,0.03305785123966942,0.9669421487603306
32196661,0,632,597,35,0.944620253164557,0.055379746835443035
82422855,1,92,9,83,0.09782608695652174,0.9021739130434783
997237051958345728,0,1000,865,135,0.865,0.135
1607515633,1,242,3,239,0.012396694214876033,0.987603305785124
556123511,0,281,281,0,1.0,0.0
123607412,1,1000,179,821,0.179,0.821
1104413221765726210,0,125,118,7,0.944,0.056
794807555474108416,1,103,22,81,0.21359223300970873,0.7864077669902912
1487439722242846726,0,57,57,0,1.0,0.0
2336111948,1,176,12,164,0.06818181818181818,0.9318181818181818
876853015,0,39,38,1,0.9743589743589743,0.02564102564102564
31275345,1,226,31,195,0.13716814159292035,0.8628318584070797
931159010,0,327,325,2,0.9938837920489296,0.0061162079510703364
879547294235987968,1,70,6,64,0.08571428571428572,0.9142857142857143
1462486657706323969,0,46,40,6,0.8695652173913043,0.13043478260869565
265605524,1,1000,29,971,0.029,0.971
3470996717,0,156,142,14,0.9102564102564102,0.08974358974358974
16280541,1,1000,172,828,0.172,0.828
1408005088388386820,0,102,102,0,1.0,0.0
822172784583385088,1,192,19,173,0.09895833333333333,0.9010416666666666
940288145706356736,0,1000,955,45,0.955,0.045
1482485605212643329,1,256,65,191,0.25390625,0.74609375
3794843963,0,3,3,0,1.0,0.0
517287513,1,46,9,37,0.1956521739130435,0.8043478260869565
166531421,0,1000,999,1,0.999,0.001
1324503747792457730,1,125,12,113,0.096,0.904
505745237,0,551,530,21,0.9618874773139746,0.038112522686025406
326285632,1,243,20,223,0.0823045267489712,0.9176954732510288
2296754276,1,651,11,640,0.016897081413210446,0.9831029185867896
4806477240,0,138,132,6,0.9565217391304348,0.043478260869565216
55421242,1,16,1,15,0.0625,0.9375
1078841191444156418,0,323,322,1,0.9969040247678018,0.0030959752321981426
1223686457526751232,1,14,0,14,0.0,1.0
765258478801780737,1,1000,87,913,0.087,0.913
18916926,0,1000,939,61,0.939,0.061
2555206219,1,1000,29,971,0.029,0.971
1531731287353999362,0,16,16,0,1.0,0.0
2770807898,1,57,10,47,0.17543859649122806,0.8245614035087719
1353438472233746432,0,2,2,0,1.0,0.0
962745065536765952,1,1000,90,910,0.09,0.91
1289638948491472897,0,1000,904,96,0.904,0.096
603033449,1,243,20,223,0.0823045267489712,0.9176954732510288
1447310045214134274,0,56,56,0,1.0,0.0
3086017236,1,293,7,286,0.023890784982935155,0.9761092150170648
1037799886106722304,0,17,15,2,0.8823529411764706,0.11764705882352941
1100575543995568129,1,90,30,60,0.3333333333333333,0.6666666666666666
1289367426958790656,0,777,777,0,1.0,0.0
45063353,1,272,14,258,0.051470588235294115,0.9485294117647058
469844119,0,391,390,1,0.9974424552429667,0.0025575447570332483
1299474538732892160,1,1000,63,937,0.063,0.937
777294260844400640,0,380,352,28,0.9263157894736842,0.07368421052631578
24101610,1,192,5,187,0.026041666666666668,0.9739583333333334
802509596,0,293,293,0,1.0,0.0
36126602,1,1000,124,876,0.124,0.876
3380895670,0,1000,997,3,0.997,0.003
1293019697768783872,1,26,7,19,0.2692307692307692,0.7307692307692307
1419799376701100036,1,1000,24,976,0.024,0.976
716785147316543490,0,1000,987,13,0.987,0.013
2655496710,1,1000,307,693,0.307,0.693
2246205727,0,291,286,5,0.9828178694158075,0.01718213058419244
262996958,1,1000,180,820,0.18,0.82
1404660862355447809,0,9,8,1,0.8888888888888888,0.1111111111111111
2363293842,1,269,18,251,0.06691449814126393,0.9330855018587361
1381858625325391878,0,881,877,4,0.9954597048808173,0.004540295119182747
21060685,1,1000,249,751,0.249,0.751
211433291,0,80,80,0,1.0,0.0
917439449008664577,1,509,129,380,0.25343811394891946,0.7465618860510805
1069943074254716928,0,1000,1000,0,1.0,0.0
32813997,1,408,77,331,0.18872549019607843,0.8112745098039216
1606714190,0,1000,995,5,0.995,0.005
1453138083055013891,1,74,25,49,0.33783783783783783,0.6621621621621622
701884200,0,1000,984,16,0.984,0.016
188193654,1,1000,205,795,0.205,0.795
3307041196,0,347,342,5,0.9855907780979827,0.01440922190201729
1392092368782827523,1,48,0,48,0.0,1.0
836249946210844672,0,55,54,1,0.9818181818181818,0.01818181818181818
1066881966300168194,1,162,45,117,0.2777777777777778,0.7222222222222222
214342546,0,127,127,0,1.0,0.0
314890751,1,480,48,432,0.1,0.9
2664626390,0,149,123,26,0.825503355704698,0.174496644295302
18650327,1,393,31,362,0.07888040712468193,0.9211195928753181
2633237722,0,652,647,5,0.9923312883435583,0.007668711656441718
1308109776442793985,1,59,13,46,0.22033898305084745,0.7796610169491526
1001209073445064704,0,1000,998,2,0.998,0.002
1016758244822470656,1,187,30,157,0.16042780748663102,0.839572192513369
47455951,0,120,117,3,0.975,0.025
913280330588725248,1,726,194,532,0.26721763085399447,0.7327823691460055
535086509,0,777,769,8,0.9897039897039897,0.010296010296010296
3130156839,1,791,217,574,0.2743362831858407,0.7256637168141593
2249368062,0,9,9,0,1.0,0.0
1445988785343188992,1,313,17,296,0.054313099041533544,0.9456869009584664
1437170614347894785,0,498,488,10,0.9799196787148594,0.020080321285140562
865900092410253312,0,186,186,0,1.0,0.0
1360140055,1,46,2,44,0.043478260869565216,0.9565217391304348
1196559779595993088,0,73,73,0,1.0,0.0
1378937721897447429,1,1000,104,896,0.104,0.896
1442134110986661893,0,2,2,0,1.0,0.0
811110250757689344,1,337,7,330,0.020771513353115726,0.9792284866468842
844479864610705408,0,1,1,0,1.0,0.0
43553,1,1000,29,971,0.029,0.971
62650861,0,1000,993,7,0.993,0.007
2428054106,1,869,286,583,0.3291139240506329,0.6708860759493671
584355369,0,127,126,1,0.9921259842519685,0.007874015748031496
16500734,1,1000,68,932,0.068,0.932
449431322,0,81,81,0,1.0,0.0
25929701,1,683,161,522,0.23572474377745242,0.7642752562225475
1218049436602920961,0,172,170,2,0.9883720930232558,0.011627906976744186
1427958418715803653,1,41,8,33,0.1951219512195122,0.8048780487804879
1481781000594022402,0,7,7,0,1.0,0.0
1105939062899331072,1,756,122,634,0.16137566137566137,0.8386243386243386
1091501787033546753,0,1000,829,171,0.829,0.171
1029551846657015809,1,6,0,6,0.0,1.0
3343529475,0,539,534,5,0.9907235621521335,0.00927643784786642
1001279841063223296,1,155,47,108,0.3032258064516129,0.6967741935483871
1328582993657606146,1,35,6,29,0.17142857142857143,0.8285714285714286
229468912,0,49,49,0,1.0,0.0
90052523,1,627,28,599,0.044657097288676235,0.9553429027113237
190584819,0,1000,997,3,0.997,0.003
1056152730,1,1000,61,939,0.061,0.939
75029786,0,1000,998,2,0.998,0.002
1357071324296982529,1,44,11,33,0.25,0.75
1002202995654905856,0,1000,994,6,0.994,0.006
506586613,1,641,59,582,0.09204368174726989,0.9079563182527302
781113886699323392,0,189,182,7,0.9629629629629629,0.037037037037037035
742881871592194048,1,202,15,187,0.07425742574257425,0.9257425742574258
55588534,0,3,3,0,1.0,0.0
1455235971998306305,1,79,24,55,0.3037974683544304,0.6962025316455697
52595639,0,350,350,0,1.0,0.0
904444429,1,3,0,3,0.0,1.0
1266540668819832833,0,1000,996,4,0.996,0.004
1069752065763635200,1,392,84,308,0.21428571428571427,0.7857142857142857
481821651,0,1000,994,6,0.994,0.006
1347320464457293827,1,534,123,411,0.2303370786516854,0.7696629213483146
2555872094,0,297,244,53,0.8215488215488216,0.17845117845117844
1287786455637557248,1,1000,253,747,0.253,0.747
3230133906,0,898,898,0,1.0,0.0
2437637562,1,170,3,167,0.01764705882352941,0.9823529411764705
1400738817900892161,0,27,27,0,1.0,0.0
1488739128732569600,1,138,13,125,0.09420289855072464,0.9057971014492754
1159906344230674432,0,1000,998,2,0.998,0.002
993814932293550080,1,464,41,423,0.08836206896551724,0.9116379310344828
166380978,0,386,385,1,0.9974093264248705,0.0025906735751295338
1098752668649091072,1,456,12,444,0.02631578947368421,0.9736842105263158
185156163,0,95,95,0,1.0,0.0
1254175787219025922,1,339,111,228,0.3274336283185841,0.672566371681416
725054169070092288,0,59,58,1,0.9830508474576272,0.01694915254237288
252925341,1,1000,24,976,0.024,0.976
133556137,1,56,4,52,0.07142857142857142,0.9285714285714286
237790522,0,200,199,1,0.995,0.005
1346907874203602944,1,610,33,577,0.054098360655737705,0.9459016393442623
1412007619,0,184,184,0,1.0,0.0
877309101465673730,1,69,11,58,0.15942028985507245,0.8405797101449275
2862640630,0,339,339,0,1.0,0.0
2353621648,1,484,33,451,0.06818181818181818,0.9318181818181818
1014607448,0,261,260,1,0.9961685823754789,0.0038314176245210726
31000687,1,233,38,195,0.1630901287553648,0.8369098712446352
2257559829,0,1000,999,1,0.999,0.001
95914593,1,381,15,366,0.03937007874015748,0.9606299212598425
770621672,0,22,22,0,1.0,0.0
21663430,1,614,73,541,0.11889250814332247,0.8811074918566775
966869595784208385,0,383,383,0,1.0,0.0
3267382981,1,599,98,501,0.1636060100166945,0.8363939899833055
1174566216314380288,0,1000,998,2,0.998,0.002
56189313,1,493,20,473,0.04056795131845842,0.9594320486815415
936177930,0,488,477,11,0.9774590163934426,0.022540983606557378
771499859597783040,1,755,112,643,0.14834437086092717,0.8516556291390729
1046423605,0,220,220,0,1.0,0.0
107942482,1,225,59,166,0.26222222222222225,0.7377777777777778
187927270,0,915,915,0,1.0,0.0
14209544,1,613,70,543,0.11419249592169657,0.8858075040783034
718096125492789249,0,639,635,4,0.9937402190923318,0.006259780907668232
1386515070461562889,1,126,30,96,0.23809523809523808,0.7619047619047619
269118991,0,644,644,0,1.0,0.0
1082114843128274945,1,1000,238,762,0.238,0.762
1520977788575961093,0,519,519,0,1.0,0.0
830163931054239744,1,228,13,215,0.05701754385964912,0.9429824561403509
1202793385,0,243,239,4,0.9835390946502057,0.01646090534979424
1231673507756507137,1,420,158,262,0.3761904761904762,0.6238095238095238
856314992425136128,0,15,15,0,1.0,0.0
14381110,1,1000,255,745,0.255,0.745
892782237489537024,0,35,35,0,1.0,0.0
223036361,1,187,7,180,0.0374331550802139,0.9625668449197861
52493307,0,51,51,0,1.0,0.0
1301367557384032263,1,19,0,19,0.0,1.0
758824314523168768,0,567,565,2,0.9964726631393298,0.003527336860670194
492430356,1,84,18,66,0.21428571428571427,0.7857142857142857
463491634,0,3,3,0,1.0,0.0
1507709294216900611,1,1000,13,987,0.013,0.987
1182797891653341184,0,44,44,0,1.0,0.0
3408889593,1,46,2,44,0.043478260869565216,0.9565217391304348
3008039364,0,67,67,0,1.0,0.0
1497038093202993160,1,228,12,216,0.05263157894736842,0.9473684210526315
1363446406023839752,0,25,24,1,0.96,0.04
17937954,1,1000,9,991,0.009,0.991
1408647711939694595,0,273,273,0,1.0,0.0
18237313,1,1000,167,833,0.167,0.833
1236397137920815106,0,1000,1000,0,1.0,0.0
1143619159424737280,1,189,19,170,0.10052910052910052,0.8994708994708994
1488195192444583936,0,3,3,0,1.0,0.0
805333310255661056,1,130,9,121,0.06923076923076923,0.9307692307692308
377184582,0,1000,906,94,0.906,0.094
2282960437,1,647,57,590,0.08809891808346214,0.9119010819165378
3193219064,0,131,129,2,0.9847328244274809,0.015267175572519083
288403039,1,570,102,468,0.17894736842105263,0.8210526315789474
831990188,0,82,82,0,1.0,0.0
279310254,1,207,12,195,0.057971014492753624,0.9420289855072463
1515086145092210689,0,34,34,0,1.0,0.0
2285821669,1,729,140,589,0.19204389574759945,0.8079561042524005
890065584,0,1000,1000,0,1.0,0.0
106446857,1,419,25,394,0.059665871121718374,0.9403341288782816
2241668664,1,448,77,371,0.171875,0.828125
1528715537697710080,0,41,41,0,1.0,0.0
9489862,1,534,38,496,0.07116104868913857,0.9288389513108615
843482382753660928,0,47,46,1,0.9787234042553191,0.02127659574468085
1322976606021804032,1,77,12,65,0.15584415584415584,0.8441558441558441
2962336827,0,1000,910,90,0.91,0.09
991150339058491392,1,1000,113,887,0.113,0.887
28481982,0,205,202,3,0.9853658536585366,0.014634146341463415
184573081,1,131,7,124,0.05343511450381679,0.9465648854961832
55544177,0,961,929,32,0.9667013527575442,0.03329864724245578
27707284,1,1000,90,910,0.09,0.91
126629571,0,1000,940,60,0.94,0.06
2847475915,0,2,2,0,1.0,0.0
1542285249979236352,1,10,2,8,0.2,0.8
924988338448281600,0,88,85,3,0.9659090909090909,0.03409090909090909
30137331,1,530,67,463,0.12641509433962264,0.8735849056603774
930044245,0,1000,998,2,0.998,0.002
606105830,1,515,10,505,0.019417475728155338,0.9805825242718447
1385817139194605574,0,61,61,0,1.0,0.0
578378352,1,53,0,53,0.0,1.0
2502798190,0,199,199,0,1.0,0.0
801128765543817216,1,243,96,147,0.3950617283950617,0.6049382716049383
1129583602193305600,0,204,204,0,1.0,0.0
1076618121476222979,1,1000,43,957,0.043,0.957
998258695699156992,1,43,11,32,0.2558139534883721,0.7441860465116279
1523850630,0,345,342,3,0.991304347826087,0.008695652173913044
904884710119272449,1,236,7,229,0.029661016949152543,0.9703389830508474
1161461512361467904,0,816,809,7,0.991421568627451,0.00857843137254902
815420460477382656,1,49,10,39,0.20408163265306123,0.7959183673469388
281785750,0,1000,999,1,0.999,0.001
872195339125743617,1,437,62,375,0.14187643020594964,0.8581235697940504
101670304,0,860,853,7,0.9918604651162791,0.00813953488372093
4800476090,1,1000,108,892,0.108,0.892
36206570,0,215,213,2,0.9906976744186047,0.009302325581395349
348843514,1,30,6,24,0.2,0.8
1185225818399621121,0,62,62,0,1.0,0.0
2610565793,0,95,92,3,0.968421052631579,0.031578947368421054
1273251883,1,175,9,166,0.05142857142857143,0.9485714285714286
1483964940163575810,0,14,14,0,1.0,0.0
1277036814205845511,1,1000,1,999,0.001,0.999
595505185,0,24,24,0,1.0,0.0
2648962468,1,233,27,206,0.11587982832618025,0.8841201716738197
36503640,0,361,359,2,0.9944598337950139,0.00554016620498615
817896431059025921,1,187,26,161,0.13903743315508021,0.8609625668449198
161839674,0,1000,862,138,0.862,0.138
1368812623454756866,1,2,0,2,0.0,1.0
720989342,0,128,126,2,0.984375,0.015625
1193179518,1,16,3,13,0.1875,0.8125
810169827763613696,1,1000,200,800,0.2,0.8
155051172,0,658,649,9,0.986322188449848,0.013677811550151976
818641657415372800,1,96,19,77,0.19791666666666666,0.8020833333333334
1212761223067922432,1,502,141,361,0.28087649402390436,0.7191235059760956
525000314,0,736,735,1,0.998641304347826,0.001358695652173913
1356304215182888961,1,64,3,61,0.046875,0.953125
30851629,0,597,596,1,0.998324958123953,0.0016750418760469012
394388968,1,279,6,273,0.021505376344086023,0.978494623655914
20518196,0,626,623,3,0.9952076677316294,0.004792332268370607
3299816249,1,114,11,103,0.09649122807017543,0.9035087719298246
3566501177,0,509,508,1,0.9980353634577603,0.0019646365422396855
731929641682763776,1,73,22,51,0.3013698630136986,0.6986301369863014
1263456350052417536,0,151,151,0,1.0,0.0
183476065,1,592,67,525,0.11317567567567567,0.8868243243243243
1519413438208004098,0,22,21,1,0.9545454545454546,0.045454545454545456
3637228109,1,699,88,611,0.12589413447782546,0.8741058655221745
722999324448149507,0,1000,877,123,0.877,0.123
1181792300676071424,1,273,8,265,0.029304029304029304,0.9706959706959707
1137908608170151936,0,233,233,0,1.0,0.0
1277388056828555264,1,435,57,378,0.1310344827586207,0.8689655172413793
540509454,0,187,186,1,0.9946524064171123,0.0053475935828877
12199652,1,1000,34,966,0.034,0.966
22937075,0,1000,956,44,0.956,0.044
84174589,1,536,38,498,0.0708955223880597,0.9291044776119403
2338845566,0,92,92,0,1.0,0.0
225849233,1,1000,251,749,0.251,0.749
1493357310,0,682,677,5,0.9926686217008798,0.007331378299120235
1319194739762032641,1,1000,8,992,0.008,0.992
432055313,0,1000,999,1,0.999,0.001
262648532,1,302,71,231,0.23509933774834438,0.7649006622516556
90464055,0,1000,996,4,0.996,0.004
375369516,1,590,7,583,0.011864406779661017,0.988135593220339
1079100120791216128,0,108,106,2,0.9814814814814815,0.018518518518518517
2614041522,1,1000,307,693,0.307,0.693
971083908099006464,0,798,798,0,1.0,0.0
1251166175511359488,1,1000,159,841,0.159,0.841
1252858521466449921,0,1000,987,13,0.987,0.013
1443003668081647619,1,3,0,3,0.0,1.0
2621255418,0,89,86,3,0.9662921348314607,0.033707865168539325
1480192343814848512,0,294,284,10,0.9659863945578231,0.034013605442176874
999628899658055680,1,735,126,609,0.17142857142857143,0.8285714285714286
260907249,0,1000,791,209,0.791,0.209
996557306471956480,0,1000,995,5,0.995,0.005
2149523275,1,553,119,434,0.21518987341772153,0.7848101265822784
903510249218367488,0,1000,997,3,0.997,0.003
1270446604319780864,1,105,29,76,0.2761904761904762,0.7238095238095238
1315053447973007360,0,91,91,0,1.0,0.0
109981562,1,1000,283,717,0.283,0.717
1072532802,0,30,30,0,1.0,0.0
2600837372,1,1000,172,828,0.172,0.828
941742440788168705,0,365,360,5,0.9863013698630136,0.0136986301369863
1264376846545825792,1,26,7,19,0.2692307692307692,0.7307692307692307
1520225552950571009,0,3,3,0,1.0,0.0
1283879112696791044,1,13,2,11,0.15384615384615385,0.8461538461538461
743917894245879809,0,80,77,3,0.9625,0.0375
1172346168212258817,1,367,152,215,0.4141689373297003,0.5858310626702997
1239716868186931201,0,223,223,0,1.0,0.0
1579128739,1,350,31,319,0.08857142857142856,0.9114285714285715
172361382,0,183,182,1,0.994535519125683,0.00546448087431694
15879406,1,316,53,263,0.16772151898734178,0.8322784810126582
49518443,0,472,469,3,0.9936440677966102,0.006355932203389831
2677654751,1,335,5,330,0.014925373134328358,0.9850746268656716
52587392,0,962,943,19,0.9802494802494802,0.01975051975051975
4889983191,1,214,50,164,0.2336448598130841,0.7663551401869159
1074160832,0,1000,964,36,0.964,0.036
1886895391,1,698,120,578,0.17191977077363896,0.828080229226361
1011570681027399680,0,113,112,1,0.9911504424778761,0.008849557522123894
1013543378989076486,1,95,27,68,0.28421052631578947,0.7157894736842105
1736105772,0,83,69,14,0.8313253012048193,0.1686746987951807
870317699720785921,1,1000,223,777,0.223,0.777
273152381,0,278,273,5,0.9820143884892086,0.017985611510791366
1095329931918073865,1,92,5,87,0.05434782608695652,0.9456521739130435
1394322503586258944,1,9,0,9,0.0,1.0
3145014375,0,1000,999,1,0.999,0.001
333704327,1,245,31,214,0.12653061224489795,0.8734693877551021
226733548,0,685,683,2,0.997080291970803,0.00291970802919708
22101264,1,342,74,268,0.21637426900584794,0.783625730994152
62682957,1,264,7,257,0.026515151515151516,0.9734848484848485
1106014515072827393,0,1000,990,10,0.99,0.01
22524601,1,122,21,101,0.1721311475409836,0.8278688524590164
733363787974115328,0,415,388,27,0.9349397590361446,0.06506024096385542
705288989184540672,1,176,23,153,0.13068181818181818,0.8693181818181818
146465012,0,90,90,0,1.0,0.0
791725129759797248,1,79,12,67,0.1518987341772152,0.8481012658227848
214182487,0,196,196,0,1.0,0.0
1288607595381624832,1,623,221,402,0.3547351524879615,0.6452648475120385
18974412,0,1000,989,11,0.989,0.011
3134561704,1,349,43,306,0.12320916905444126,0.8767908309455588
1446201774348591104,0,13,13,0,1.0,0.0
1410049284242878466,1,87,0,87,0.0,1.0
56787816,0,305,303,2,0.9934426229508196,0.006557377049180328
851260590655852544,1,634,86,548,0.13564668769716087,0.8643533123028391
959242264261246976,0,300,271,29,0.9033333333333333,0.09666666666666666
1154289577294618625,1,335,42,293,0.1253731343283582,0.8746268656716418
2830709302,0,63,57,6,0.9047619047619048,0.09523809523809523
2239817418,1,1000,175,825,0.175,0.825
742563173434163200,0,11,11,0,1.0,0.0
78923213,1,249,10,239,0.040160642570281124,0.9598393574297188
2802008751,0,52,49,3,0.9423076923076923,0.057692307692307696
739693616,1,485,32,453,0.06597938144329897,0.934020618556701
1427277185203777537,0,79,79,0,1.0,0.0
444048732,1,829,121,708,0.14595898673100122,0.8540410132689988
220298851,0,60,60,0,1.0,0.0
1138532176792887297,1,65,4,61,0.06153846153846154,0.9384615384615385
87516908,0,134,134,0,1.0,0.0
14080088,1,1000,83,917,0.083,0.917
1366221331944009732,0,14,12,2,0.8571428571428571,0.14285714285714285
853767878994034688,1,4,1,3,0.25,0.75
1537666843,0,462,460,2,0.9956709956709957,0.004329004329004329
1461136459793154060,1,22,11,11,0.5,0.5
3675794894,1,329,27,302,0.08206686930091185,0.9179331306990881
1070514381153128449,0,18,16,2,0.8888888888888888,0.1111111111111111
971497101703237633,0,5,5,0,1.0,0.0
1505631361989763074,1,20,4,16,0.2,0.8
110865448,0,104,96,8,0.9230769230769231,0.07692307692307693
1060751819255808000,1,260,15,245,0.057692307692307696,0.9423076923076923
1086168614657556481,0,200,200,0,1.0,0.0
1016537099082895360,1,43,5,38,0.11627906976744186,0.8837209302325582
79396782,0,402,400,2,0.9950248756218906,0.004975124378109453
773748193502851072,1,82,8,74,0.0975609756097561,0.9024390243902439
709832626522103808,0,55,54,1,0.9818181818181818,0.01818181818181818
3196957285,1,338,105,233,0.3106508875739645,0.6893491124260355
1479099693598527498,0,2,2,0,1.0,0.0
4880063379,1,31,6,25,0.1935483870967742,0.8064516129032258
722770160,0,265,263,2,0.9924528301886792,0.007547169811320755
1340732237965369345,1,517,53,464,0.10251450676982592,0.8974854932301741
708414237761150976,0,349,341,8,0.9770773638968482,0.022922636103151862
1445486421880422406,1,307,60,247,0.19543973941368079,0.8045602605863192
1422168403876401153,0,44,44,0,1.0,0.0
1129564593368571905,1,166,20,146,0.12048192771084337,0.8795180722891566
703498219,0,124,112,12,0.9032258064516129,0.0967741935483871
1111967147343921152,1,111,15,96,0.13513513513513514,0.8648648648648649
3201691203,0,1000,998,2,0.998,0.002
89859790,1,92,19,73,0.20652173913043478,0.7934782608695652
1115628960392474627,0,625,604,21,0.9664,0.0336
964705374929596416,1,584,118,466,0.20205479452054795,0.797945205479452
1316407374987624452,0,66,58,8,0.8787878787878788,0.12121212121212122
1424214285933178883,1,1,1,0,1.0,0.0
1367050984657158145,0,94,93,1,0.9893617021276596,0.010638297872340425
1427443457803620355,1,69,22,47,0.3188405797101449,0.6811594202898551
895146123207204864,0,53,35,18,0.660377358490566,0.33962264150943394
101969102,1,231,24,207,0.1038961038961039,0.8961038961038961
311820817,0,41,40,1,0.975609756097561,0.024390243902439025
1017400034999046144,1,1000,138,862,0.138,0.862
3119015534,0,847,846,1,0.9988193624557261,0.0011806375442739079
1128106028271149056,1,47,21,26,0.44680851063829785,0.5531914893617021
1524423337249804288,0,12,11,1,0.9166666666666666,0.08333333333333333
4616128875,1,138,8,130,0.057971014492753624,0.9420289855072463
24206787,0,178,176,2,0.9887640449438202,0.011235955056179775
1343031074,1,454,49,405,0.10792951541850221,0.8920704845814978
199998402,0,897,897,0,1.0,0.0
128960677,1,733,94,639,0.12824010914051842,0.8717598908594816
1409127770,0,400,386,14,0.965,0.035
1433975999117529089,1,44,2,42,0.045454545454545456,0.9545454545454546
984050035590656000,0,1000,1000,0,1.0,0.0
11055022,1,1000,300,700,0.3,0.7
1334194865639309312,0,688,654,34,0.9505813953488372,0.04941860465116279
746951560727502848,0,1000,1000,0,1.0,0.0
278318789,1,135,9,126,0.06666666666666667,0.9333333333333333
349532644,0,74,72,2,0.972972972972973,0.02702702702702703
19579115,1,1000,30,970,0.03,0.97
1024439515744817154,0,78,68,10,0.8717948717948718,0.1282051282051282
1194772794417930240,1,12,4,8,0.3333333333333333,0.6666666666666666
443634876,0,222,220,2,0.990990990990991,0.009009009009009009
30706280,1,354,19,335,0.05367231638418079,0.9463276836158192
177030133,0,1000,995,5,0.995,0.005
865047362854670336,1,22,5,17,0.22727272727272727,0.7727272727272727
46037479,0,88,88,0,1.0,0.0
3038088410,1,363,32,331,0.0881542699724518,0.9118457300275482
2428975327,0,185,181,4,0.9783783783783784,0.021621621621621623
1114571491436371968,1,34,6,28,0.17647058823529413,0.8235294117647058
634048745,0,254,254,0,1.0,0.0
3497247616,0,595,560,35,0.9411764705882353,0.058823529411764705
1400296602133221381,1,40,7,33,0.175,0.825
117567210,0,454,453,1,0.9977973568281938,0.0022026431718061676
1398195461853356034,1,498,87,411,0.1746987951807229,0.8253012048192772
3691061597,0,172,170,2,0.9883720930232558,0.011627906976744186
1079054446074699776,1,502,34,468,0.06772908366533864,0.9322709163346613
1615651704,0,309,249,60,0.8058252427184466,0.1941747572815534
64853637,1,582,31,551,0.05326460481099656,0.9467353951890034
1272961541957193733,0,7,7,0,1.0,0.0
184912823,1,239,7,232,0.029288702928870293,0.9707112970711297
1134452927240843264,0,37,34,3,0.918918918918919,0.08108108108108109
2765918296,1,171,32,139,0.1871345029239766,0.8128654970760234
16732751,1,591,6,585,0.01015228426395939,0.9898477157360406
30860992,0,389,389,0,1.0,0.0
3061957801,1,270,53,217,0.1962962962962963,0.8037037037037037
577211329,0,125,124,1,0.992,0.008
3131459369,1,55,3,52,0.05454545454545454,0.9454545454545454
13065092,0,1000,919,81,0.919,0.081
1253705319215063047,1,218,8,210,0.03669724770642202,0.963302752293578
890357861003415554,0,248,246,2,0.9919354838709677,0.008064516129032258
1043583691748978689,1,140,21,119,0.15,0.85
1474857240259616782,0,11,11,0,1.0,0.0
45291404,1,845,3,842,0.0035502958579881655,0.9964497041420118
1022674383305760768,0,106,94,12,0.8867924528301887,0.11320754716981132
3223418882,1,45,2,43,0.044444444444444446,0.9555555555555556
1250923403550261249,1,57,9,48,0.15789473684210525,0.8421052631578947
1062559068685000705,0,1000,1000,0,1.0,0.0
20630646,1,278,51,227,0.18345323741007194,0.8165467625899281
2962596152,0,184,179,5,0.9728260869565217,0.02717391304347826
3525963454,1,1000,96,904,0.096,0.904
33457232,0,1000,999,1,0.999,0.001
1404579395726057474,1,221,32,189,0.14479638009049775,0.8552036199095022
369608215,0,285,283,2,0.9929824561403509,0.007017543859649123
31120881,1,1000,104,896,0.104,0.896
1366560162270560257,0,69,55,14,0.7971014492753623,0.2028985507246377
877385671173967873,1,81,19,62,0.2345679012345679,0.7654320987654321
4444119375,0,76,73,3,0.9605263157894737,0.039473684210526314
2808964844,1,753,21,732,0.027888446215139442,0.9721115537848606
59127949,0,1000,1000,0,1.0,0.0
1227066016686960640,1,1000,221,779,0.221,0.779
840917275,0,342,342,0,1.0,0.0
1144325770925527040,1,16,3,13,0.1875,0.8125
1075199961866887173,0,330,327,3,0.990909090909091,0.00909090909090909
67545995,1,1000,110,890,0.11,0.89
755294263521513474,0,525,506,19,0.9638095238095238,0.03619047619047619
896486222,1,426,67,359,0.1572769953051643,0.8427230046948356
988369217199190018,0,1000,981,19,0.981,0.019
45060866,1,198,16,182,0.08080808080808081,0.9191919191919192
1050972781129728000,0,531,529,2,0.9962335216572504,0.003766478342749529
1288071626249052161,1,176,13,163,0.07386363636363637,0.9261363636363636
827161749312790528,0,1000,976,24,0.976,0.024
534852517,1,1000,44,956,0.044,0.956
270350258,1,39,6,33,0.15384615384615385,0.8461538461538461
122505745,0,175,168,7,0.96,0.04
1510108056251559939,1,468,48,420,0.10256410256410256,0.8974358974358975
1346049494,0,179,150,29,0.8379888268156425,0.16201117318435754
621347520,1,1000,146,854,0.146,0.854
1368397490718994433,0,192,192,0,1.0,0.0
1034911382515458048,1,65,18,47,0.27692307692307694,0.7230769230769231
1437147242905882628,0,5,5,0,1.0,0.0
1082029205787951106,1,1000,13,987,0.013,0.987
24801889,0,727,720,7,0.9903713892709766,0.009628610729023384
1300845014,1,600,29,571,0.04833333333333333,0.9516666666666667
288587181,0,187,187,0,1.0,0.0
1241104011941593090,1,3,1,2,0.3333333333333333,0.6666666666666666
12828802,0,1000,618,382,0.618,0.382
367585587,1,896,36,860,0.04017857142857143,0.9598214285714286
509830258,0,162,162,0,1.0,0.0
517876144,1,1000,347,653,0.347,0.653
767325816816603136,0,353,345,8,0.9773371104815864,0.0226628895184136
1039678926459682820,1,68,13,55,0.19117647058823528,0.8088235294117647
168896940,0,154,154,0,1.0,0.0
2408102220,1,180,17,163,0.09444444444444444,0.9055555555555556
1358880163593879553,0,1000,1000,0,1.0,0.0
773623655645450241,1,43,4,39,0.09302325581395349,0.9069767441860465
69193523,0,976,906,70,0.9282786885245902,0.07172131147540983
789218628860317696,1,79,20,59,0.25316455696202533,0.7468354430379747
36087452,0,691,667,24,0.9652677279305355,0.03473227206946455
780615768522174466,1,326,11,315,0.03374233128834356,0.9662576687116564
395766056,0,8,8,0,1.0,0.0
1496125289084211205,1,202,27,175,0.13366336633663367,0.8663366336633663
1327086468271984641,0,110,94,16,0.8545454545454545,0.14545454545454545
79867661,1,155,44,111,0.2838709677419355,0.7161290322580646
455164606,0,280,280,0,1.0,0.0
398944447,1,1000,137,863,0.137,0.863
1436025271950319640,0,17,17,0,1.0,0.0
361651092,1,1000,285,715,0.285,0.715
4852867871,0,1000,984,16,0.984,0.016
264883720,1,352,13,339,0.036931818181818184,0.9630681818181818
798257742498693120,0,467,453,14,0.9700214132762313,0.029978586723768737
3316152249,1,117,22,95,0.18803418803418803,0.811965811965812
2549427402,0,179,178,1,0.994413407821229,0.00558659217877095
822279769651875844,1,132,16,116,0.12121212121212122,0.8787878787878788
1116129992499507203,0,8,7,1,0.875,0.125
859890643207831552,1,65,2,63,0.03076923076923077,0.9692307692307692
1488055904222298112,0,37,37,0,1.0,0.0
2436391075,1,90,10,80,0.1111111111111111,0.8888888888888888
3183438757,0,1000,992,8,0.992,0.008
1497971460941307905,1,15,7,8,0.4666666666666667,0.5333333333333333
99137026,0,642,632,10,0.9844236760124611,0.01557632398753894
2991853735,1,1000,150,850,0.15,0.85
713087063252418560,0,1000,968,32,0.968,0.032
2983656216,1,148,8,140,0.05405405405405406,0.9459459459459459
1217925596501741570,0,3,3,0,1.0,0.0
34845864,1,63,6,57,0.09523809523809523,0.9047619047619048
586327672,0,474,472,2,0.9957805907172996,0.004219409282700422
1164311881655435265,1,375,100,275,0.26666666666666666,0.7333333333333333
1206780888,0,1000,998,2,0.998,0.002
1359390169284050951,1,445,159,286,0.35730337078651686,0.6426966292134831
2811601148,1,1000,115,885,0.115,0.885
2707705039,0,1000,997,3,0.997,0.003
865287242910244864,1,1000,202,798,0.202,0.798
1214269222802452481,0,657,651,6,0.9908675799086758,0.0091324200913242
2923882942,1,310,19,291,0.06129032258064516,0.9387096774193548
1425073994496188419,0,1000,993,7,0.993,0.007
2586767797,1,259,5,254,0.019305019305019305,0.9806949806949807
29067521,0,529,526,3,0.994328922495274,0.005671077504725898
1299229060644601856,1,914,350,564,0.38293216630196936,0.6170678336980306
14933969,0,1000,1000,0,1.0,0.0
1031880697,1,262,13,249,0.04961832061068702,0.950381679389313
19408436,0,1000,997,3,0.997,0.003
3042581281,1,1000,424,576,0.424,0.576
18213663,0,57,57,0,1.0,0.0
322361283,1,48,5,43,0.10416666666666667,0.8958333333333334
3351321466,0,55,48,7,0.8727272727272727,0.12727272727272726
796004301160251393,1,36,0,36,0.0,1.0
4733817754,0,97,93,4,0.9587628865979382,0.041237113402061855
4778856154,1,390,84,306,0.2153846153846154,0.7846153846153846
1399229462751985666,0,1000,998,2,0.998,0.002
1319820919934754819,1,29,3,26,0.10344827586206896,0.896551724137931
2720287164,0,925,923,2,0.9978378378378379,0.002162162162162162
212236717,1,415,18,397,0.043373493975903614,0.9566265060240964
1482086278912872449,0,540,540,0,1.0,0.0
1444016354,0,490,486,4,0.9918367346938776,0.00816326530612245
122845949,1,349,61,288,0.17478510028653296,0.8252148997134671
1043549667705987073,0,17,17,0,1.0,0.0
1033134218904256513,1,1000,137,863,0.137,0.863
1441863231035691013,0,15,15,0,1.0,0.0
785853284263268352,1,1000,285,715,0.285,0.715
1473831145209012224,0,2,2,0,1.0,0.0
784149219741405184,1,16,4,12,0.25,0.75
1546651903,0,183,182,1,0.994535519125683,0.00546448087431694
304212656,1,385,30,355,0.07792207792207792,0.922077922077922
539586452,0,394,394,0,1.0,0.0
48179257,1,648,66,582,0.10185185185185185,0.8981481481481481
797913744604950529,0,291,290,1,0.9965635738831615,0.003436426116838488
3127819548,1,110,9,101,0.08181818181818182,0.9181818181818182
101830158,0,1000,994,6,0.994,0.006
34725841,1,93,3,90,0.03225806451612903,0.967741935483871
903321402954063872,0,180,177,3,0.9833333333333333,0.016666666666666666
751613880984481792,1,1000,318,682,0.318,0.682
2988993624,0,1000,997,3,0.997,0.003
25605616,1,1000,212,788,0.212,0.788
1392683518627663872,0,1000,992,8,0.992,0.008
976647882,1,581,118,463,0.20309810671256454,0.7969018932874354
18497525,1,574,32,542,0.05574912891986063,0.9442508710801394
795828957652209664,0,168,166,2,0.9880952380952381,0.011904761904761904
42441030,1,1000,199,801,0.199,0.801
1179066191442255875,0,189,188,1,0.9947089947089947,0.005291005291005291
943938592652627971,1,1000,96,904,0.096,0.904
2419470654,0,1000,910,90,0.91,0.09
1080575197,1,983,154,829,0.15666327568667346,0.8433367243133265
1360421890163171328,0,19,15,4,0.7894736842105263,0.21052631578947367
781495836526063616,1,49,12,37,0.24489795918367346,0.7551020408163265
3623120417,0,110,110,0,1.0,0.0
128744920,1,1000,55,945,0.055,0.945
543655922,1,88,5,83,0.056818181818181816,0.9431818181818182
2304711531,0,1000,836,164,0.836,0.164
2256728462,1,432,35,397,0.08101851851851852,0.9189814814814815
1400408260293787649,0,1000,989,11,0.989,0.011
464311025,0,420,405,15,0.9642857142857143,0.03571428571428571
826524343689736195,1,97,14,83,0.14432989690721648,0.8556701030927835
52862029,0,86,84,2,0.9767441860465116,0.023255813953488372
786207755019362304,1,419,140,279,0.3341288782816229,0.665871121718377
1107462940381323264,0,143,143,0,1.0,0.0
539450959,0,819,816,3,0.9963369963369964,0.003663003663003663
1478138137872371718,1,1000,79,921,0.079,0.921
1710868254,0,176,159,17,0.9034090909090909,0.09659090909090909
2858090194,1,681,57,624,0.08370044052863436,0.9162995594713657
3140744964,0,39,38,1,0.9743589743589743,0.02564102564102564
2908682638,1,1000,18,982,0.018,0.982
1603980288,0,1000,998,2,0.998,0.002
3318289351,1,110,4,106,0.03636363636363636,0.9636363636363636
1856966534,0,54,54,0,1.0,0.0
108494856,1,616,89,527,0.1444805194805195,0.8555194805194806
42119883,0,192,191,1,0.9947916666666666,0.005208333333333333
487940481,1,386,19,367,0.04922279792746114,0.9507772020725389
1157493944751710208,0,28,28,0,1.0,0.0
982715807691165696,1,127,2,125,0.015748031496062992,0.984251968503937
147863398,0,1000,995,5,0.995,0.005
1356409146371842048,1,1000,81,919,0.081,0.919
611995992,1,1000,44,956,0.044,0.956
1016121727888318464,0,25,25,0,1.0,0.0
1027781477461704704,1,36,3,33,0.08333333333333333,0.9166666666666666
17689841,0,1000,998,2,0.998,0.002
1265125754,0,46,46,0,1.0,0.0
2256076368,1,213,13,200,0.06103286384976526,0.9389671361502347
621935011,0,19,17,2,0.8947368421052632,0.10526315789473684
1471281667314786305,1,216,3,213,0.013888888888888888,0.9861111111111112
29883400,1,874,139,735,0.15903890160183065,0.8409610983981693
245209153,0,13,12,1,0.9230769230769231,0.07692307692307693
2416836415,1,1000,197,803,0.197,0.803
1510267036538130440,0,3,3,0,1.0,0.0
1029128317088292864,1,1000,148,852,0.148,0.852
704107960,0,54,53,1,0.9814814814814815,0.018518518518518517
1021529963520909317,1,188,43,145,0.22872340425531915,0.7712765957446809
1502137258761232394,0,158,141,17,0.8924050632911392,0.10759493670886076
213669901,1,228,5,223,0.021929824561403508,0.9780701754385965
2319334357,0,1000,995,5,0.995,0.005
91231752,1,269,84,185,0.31226765799256506,0.6877323420074349
386376771,0,1000,997,3,0.997,0.003
2640947983,1,912,169,743,0.18530701754385964,0.8146929824561403
1305229222718459910,0,29,29,0,1.0,0.0
2497316142,1,100,8,92,0.08,0.92
896577774382710785,0,111,110,1,0.990990990990991,0.009009009009009009
1237880532102348803,1,160,15,145,0.09375,0.90625
1076108556007546881,0,91,87,4,0.9560439560439561,0.04395604395604396
1292580860030484481,1,10,0,10,0.0,1.0
38967653,0,1000,1000,0,1.0,0.0
1064902784,1,561,20,541,0.035650623885918005,0.964349376114082
2254339148,0,456,452,4,0.9912280701754386,0.008771929824561403
1030997433176735744,1,23,2,21,0.08695652173913043,0.9130434782608695
1533129779804659713,0,121,117,4,0.9669421487603306,0.03305785123966942
2305588458,1,286,30,256,0.1048951048951049,0.8951048951048951
13566252,0,1000,993,7,0.993,0.007
1244938533027983360,1,108,17,91,0.1574074074074074,0.8425925925925926
956717980632715264,0,22,22,0,1.0,0.0
19096418,1,659,6,653,0.009104704097116844,0.9908952959028832
113249024,0,143,135,8,0.9440559440559441,0.055944055944055944
84406112,1,231,6,225,0.025974025974025976,0.974025974025974
86951360,0,1000,999,1,0.999,0.001
2538867074,1,109,11,98,0.10091743119266056,0.8990825688073395
2303772326,0,1000,994,6,0.994,0.006
2541898696,1,1000,284,716,0.284,0.716
1899045170,0,70,69,1,0.9857142857142858,0.014285714285714285
763227310623293442,1,58,4,54,0.06896551724137931,0.9310344827586207
235693849,0,72,69,3,0.9583333333333334,0.041666666666666664
826428874380701697,0,695,693,2,0.9971223021582734,0.0028776978417266188
1293638561141415936,1,296,56,240,0.1891891891891892,0.8108108108108109
184549459,0,19,19,0,1.0,0.0
1243963812396613632,1,1000,273,727,0.273,0.727
1460479154579644419,0,9,9,0,1.0,0.0
210301294,1,530,35,495,0.0660377358490566,0.9339622641509434
4893713640,0,70,70,0,1.0,0.0
2286503947,1,327,8,319,0.024464831804281346,0.9755351681957186
3316318602,0,191,191,0,1.0,0.0
85992199,1,1000,158,842,0.158,0.842
4078728615,0,17,17,0,1.0,0.0
741773959809671169,1,224,56,168,0.25,0.75
1334607534460690438,0,537,531,6,0.9888268156424581,0.0111731843575419
919747532284076032,1,128,43,85,0.3359375,0.6640625
2957727693,0,457,453,4,0.9912472647702407,0.0087527352297593
1468755560766091270,1,55,11,44,0.2,0.8
56801028,0,360,311,49,0.8638888888888889,0.1361111111111111
126407070,1,142,5,137,0.035211267605633804,0.9647887323943662
1381242142090162180,0,167,149,18,0.8922155688622755,0.10778443113772455
1470288529,1,953,17,936,0.017838405036726127,0.9821615949632738
532721113,0,486,486,0,1.0,0.0
1668352308,1,1000,13,987,0.013,0.987
1465416354178211852,0,33,33,0,1.0,0.0
3091405255,1,219,71,148,0.3242009132420091,0.6757990867579908
54791504,0,548,546,2,0.9963503649635036,0.0036496350364963502
2454862257,1,111,18,93,0.16216216216216217,0.8378378378378378
962608573439242240,0,31,31,0,1.0,0.0
2561978665,1,262,22,240,0.08396946564885496,0.916030534351145
1292418107483533312,0,22,22,0,1.0,0.0
1358648401374552064,1,4,0,4,0.0,1.0
1047582480654512128,0,66,55,11,0.8333333333333334,0.16666666666666666
4020276132,1,164,17,147,0.10365853658536585,0.8963414634146342
2789870986,1,374,90,284,0.24064171122994651,0.7593582887700535
1321744729298493441,0,185,183,2,0.9891891891891892,0.010810810810810811
2849529499,1,581,135,446,0.23235800344234078,0.7676419965576592
259553988,0,466,454,12,0.9742489270386266,0.02575107296137339
2495535905,1,291,28,263,0.09621993127147767,0.9037800687285223
22235564,0,523,522,1,0.9980879541108987,0.0019120458891013384
2246321760,1,199,21,178,0.10552763819095477,0.8944723618090452
3267708612,0,385,385,0,1.0,0.0
479159432,1,158,40,118,0.25316455696202533,0.7468354430379747
70574113,0,1000,956,44,0.956,0.044
47531813,1,372,41,331,0.11021505376344086,0.8897849462365591
2845495049,0,258,258,0,1.0,0.0
940063355598815260,1,128,22,106,0.171875,0.828125
1315750119061491715,0,348,314,34,0.9022988505747126,0.09770114942528736
796542539595653120,1,264,14,250,0.05303030303030303,0.946969696969697
16603149,0,1000,985,15,0.985,0.015
1223056286,1,950,319,631,0.3357894736842105,0.6642105263157895
1513993456892489731,0,73,73,0,1.0,0.0
16351579,1,1000,34,966,0.034,0.966
1455313262,0,31,31,0,1.0,0.0
75943173,1,364,4,360,0.01098901098901099,0.989010989010989
3073567553,0,502,499,3,0.9940239043824701,0.00597609561752988
1212270170615341056,1,1000,158,842,0.158,0.842
317599256,0,1000,998,2,0.998,0.002
314037246,1,57,3,54,0.05263157894736842,0.9473684210526315
1391857692638056453,0,14,14,0,1.0,0.0
155696650,1,273,38,235,0.1391941391941392,0.8608058608058609
1270589490214719492,0,31,26,5,0.8387096774193549,0.16129032258064516
34143128,1,483,30,453,0.062111801242236024,0.937888198757764
713711695982624769,0,26,26,0,1.0,0.0
1431285775807787022,1,66,21,45,0.3181818181818182,0.6818181818181818
1653497191,0,925,901,24,0.9740540540540541,0.025945945945945945
716161554434031617,1,140,31,109,0.22142857142857142,0.7785714285714286
1319293910,0,1000,983,17,0.983,0.017
24146921,1,128,9,119,0.0703125,0.9296875
45262519,0,39,39,0,1.0,0.0
1294694476254982144,1,58,7,51,0.1206896551724138,0.8793103448275862
26573290,0,42,42,0,1.0,0.0
1455605029109317635,1,41,5,36,0.12195121951219512,0.8780487804878049
133182308,0,138,137,1,0.9927536231884058,0.007246376811594203
28019009,1,66,10,56,0.15151515151515152,0.8484848484848485
21443681,0,1000,951,49,0.951,0.049
1134467518620426241,1,724,144,580,0.19889502762430938,0.8011049723756906
58885514,0,132,132,0,1.0,0.0
37503584,1,1000,51,949,0.051,0.949
482515146,1,322,6,316,0.018633540372670808,0.9813664596273292
36591628,0,236,236,0,1.0,0.0
1047270383626452992,1,157,6,151,0.03821656050955414,0.9617834394904459
462385539,0,154,154,0,1.0,0.0
572212474,1,688,7,681,0.010174418604651164,0.9898255813953488
187482938,0,187,187,0,1.0,0.0
1309198430674317315,1,1000,297,703,0.297,0.703
819100163616538624,0,55,55,0,1.0,0.0
1296123888,1,177,36,141,0.2033898305084746,0.7966101694915254
1702702206,0,647,625,22,0.9659969088098919,0.03400309119010819
1256346788648251392,1,206,4,202,0.019417475728155338,0.9805825242718447
3316206326,0,283,223,60,0.7879858657243817,0.21201413427561838
24644984,1,164,36,128,0.21951219512195122,0.7804878048780488
1283808984139468803,0,421,421,0,1.0,0.0
55068272,1,240,11,229,0.04583333333333333,0.9541666666666667
979775877943832576,0,30,30,0,1.0,0.0
808467933781430272,1,26,4,22,0.15384615384615385,0.8461538461538461
1333221718328897536,0,1000,967,33,0.967,0.033
1116534918199349250,1,96,27,69,0.28125,0.71875
14945741,0,196,182,14,0.9285714285714286,0.07142857142857142
1454588482035273734,1,6,2,4,0.3333333333333333,0.6666666666666666
2631881446,0,68,68,0,1.0,0.0
1455738990326341635,1,188,41,147,0.21808510638297873,0.7819148936170213
966801074,0,262,261,1,0.9961832061068703,0.003816793893129771
1107959472,1,968,53,915,0.05475206611570248,0.9452479338842975
1495686995321917443,0,56,54,2,0.9642857142857143,0.03571428571428571
1283582159564013569,1,11,0,11,0.0,1.0
1472700824585441287,0,1,1,0,1.0,0.0
918581820962279424,1,98,8,90,0.08163265306122448,0.9183673469387755
341429759,0,1000,1000,0,1.0,0.0
1356049516986699780,1,34,5,29,0.14705882352941177,0.8529411764705882
180140662,0,474,468,6,0.9873417721518988,0.012658227848101266
489065656,1,936,138,798,0.14743589743589744,0.8525641025641025
1290312128994455552,0,30,29,1,0.9666666666666667,0.03333333333333333
2871509211,0,1000,986,14,0.986,0.014
2059051,1,1000,169,831,0.169,0.831
25920023,0,64,64,0,1.0,0.0
1288797221014474752,1,195,7,188,0.035897435897435895,0.9641025641025641
1332741824956542983,0,1,1,0,1.0,0.0
47903325,1,370,95,275,0.25675675675675674,0.7432432432432432
1512554222545518592,0,56,36,20,0.6428571428571429,0.35714285714285715
135641336,1,169,9,160,0.05325443786982249,0.9467455621301775
2352511020,0,714,713,1,0.9985994397759104,0.0014005602240896359
1261049225225351168,1,241,37,204,0.15352697095435686,0.8464730290456431
1263383197603282944,0,57,54,3,0.9473684210526315,0.05263157894736842
1380603632656125953,1,9,0,9,0.0,1.0
838577665472802817,0,146,146,0,1.0,0.0
1265087226838474752,1,63,5,58,0.07936507936507936,0.9206349206349206
564387984,0,15,15,0,1.0,0.0
1257894323112181761,1,94,21,73,0.22340425531914893,0.776595744680851
1473803222175338498,0,27,27,0,1.0,0.0
297101944,1,1000,13,987,0.013,0.987
1175910911145627655,0,1000,996,4,0.996,0.004
1157821200795484160,1,104,12,92,0.11538461538461539,0.8846153846153846
983182413525372928,0,57,57,0,1.0,0.0
1121542236947144705,1,83,3,80,0.03614457831325301,0.963855421686747
852616088965742593,0,43,43,0,1.0,0.0
1289983006896279555,0,35,35,0,1.0,0.0
473908925,1,1000,33,967,0.033,0.967
1056925244,0,400,382,18,0.955,0.045
1285495448623411200,1,19,2,17,0.10526315789473684,0.8947368421052632
919598968119508992,0,196,192,4,0.9795918367346939,0.02040816326530612
2847720910,1,775,139,636,0.17935483870967742,0.8206451612903226
455008245,0,199,199,0,1.0,0.0
30092973,1,1000,18,982,0.018,0.982
1239583178211217412,0,5,5,0,1.0,0.0
161187717,1,128,1,127,0.0078125,0.9921875
35063449,0,127,118,9,0.9291338582677166,0.07086614173228346
885611139098447877,1,142,26,116,0.18309859154929578,0.8169014084507042
44019110,0,121,121,0,1.0,0.0
19215504,1,1000,196,804,0.196,0.804
1252029058000576514,0,47,47,0,1.0,0.0
4051211353,1,30,1,29,0.03333333333333333,0.9666666666666667
28052453,0,1000,997,3,0.997,0.003
586272062,1,253,8,245,0.03162055335968379,0.9683794466403162
334905588,0,199,199,0,1.0,0.0
1214051827282366465,1,845,259,586,0.30650887573964497,0.693491124260355
835291084595027968,0,286,285,1,0.9965034965034965,0.0034965034965034965
1282389684228968450,1,229,38,191,0.16593886462882096,0.834061135371179
1313688517915025409,0,1,1,0,1.0,0.0
720039056403345408,1,118,43,75,0.3644067796610169,0.635593220338983
2167599540,0,268,268,0,1.0,0.0
1126712677575737345,1,618,66,552,0.10679611650485436,0.8932038834951457
737450143,0,1000,983,17,0.983,0.017
1337104489484931074,1,825,147,678,0.1781818181818182,0.8218181818181818
3154775084,0,724,698,26,0.9640883977900553,0.03591160220994475
719173605968379904,1,136,26,110,0.19117647058823528,0.8088235294117647
2315977878,0,177,175,2,0.9887005649717514,0.011299435028248588
76250518,1,1000,94,906,0.094,0.906
518964840,0,240,238,2,0.9916666666666667,0.008333333333333333
18732335,1,256,21,235,0.08203125,0.91796875
1279504748614475776,0,16,16,0,1.0,0.0
1154841987528478723,1,100,6,94,0.06,0.94
25003462,0,243,235,8,0.9670781893004116,0.03292181069958848
1237203936278458369,1,91,36,55,0.3956043956043956,0.6043956043956044
1014713475984216066,0,153,153,0,1.0,0.0
261423058,1,134,35,99,0.26119402985074625,0.7388059701492538
39634976,0,139,139,0,1.0,0.0
1480000861078228993,1,102,30,72,0.29411764705882354,0.7058823529411765
1335561120401252353,0,1000,999,1,0.999,0.001
953390519735877632,1,420,76,344,0.18095238095238095,0.819047619047619
32334542,0,1000,998,2,0.998,0.002
1139229702999158784,1,141,25,116,0.1773049645390071,0.8226950354609929
1246636499447267328,0,1000,855,145,0.855,0.145
1445907500646248458,1,102,19,83,0.18627450980392157,0.8137254901960784
1411624968,0,631,609,22,0.96513470681458,0.03486529318541997
1522397171240239104,1,118,17,101,0.1440677966101695,0.8559322033898306
806280628836638720,0,199,194,5,0.9748743718592965,0.02512562814070352
57319502,1,656,78,578,0.11890243902439024,0.8810975609756098
902118651104514049,0,232,231,1,0.9956896551724138,0.004310344827586207
2170175008,1,561,3,558,0.0053475935828877,0.9946524064171123
1296953205667045376,0,283,237,46,0.8374558303886925,0.1625441696113074
2570014553,1,390,1,389,0.002564102564102564,0.9974358974358974
1528944661276024832,0,139,139,0,1.0,0.0
327133425,0,1000,1000,0,1.0,0.0
538739006,1,1000,99,901,0.099,0.901
962315581121691648,0,10,10,0,1.0,0.0
58396699,1,269,25,244,0.09293680297397769,0.9070631970260223
833950759,0,14,14,0,1.0,0.0
632584314,1,303,93,210,0.3069306930693069,0.693069306930693
1362848406939467778,0,8,8,0,1.0,0.0
464090347,0,82,82,0,1.0,0.0
716146797043777537,1,50,9,41,0.18,0.82
4848376714,0,1000,971,29,0.971,0.029
1917903499,1,502,77,425,0.15338645418326693,0.8466135458167331
438951477,0,71,71,0,1.0,0.0
778645682873774080,1,192,43,149,0.22395833333333334,0.7760416666666666
761460638384136193,0,360,355,5,0.9861111111111112,0.013888888888888888
1069379567729762305,1,52,11,41,0.21153846153846154,0.7884615384615384
1494370935243169799,0,27,27,0,1.0,0.0
1067510287836692480,1,204,59,145,0.28921568627450983,0.7107843137254902
1081933669,0,108,92,16,0.8518518518518519,0.14814814814814814
20316473,1,1000,26,974,0.026,0.974
1010678628915597312,0,898,863,35,0.9610244988864143,0.03897550111358575
1008498482431156224,1,33,5,28,0.15151515151515152,0.8484848484848485
2287054849,0,707,704,3,0.9957567185289957,0.004243281471004243
975775216633868290,1,121,22,99,0.18181818181818182,0.8181818181818182
348574440,0,1000,891,109,0.891,0.109
1074406507930882048,1,21,12,9,0.5714285714285714,0.42857142857142855
4435786752,0,83,83,0,1.0,0.0
773942922047852544,1,1000,172,828,0.172,0.828
1171477040828223488,0,37,37,0,1.0,0.0
169264082,1,479,13,466,0.027139874739039668,0.9728601252609603
1273417402974457863,0,1000,1000,0,1.0,0.0
22695131,1,333,12,321,0.036036036036036036,0.963963963963964
935967603234713601,0,19,19,0,1.0,0.0
104056037,1,1000,77,923,0.077,0.923
45070274,0,548,545,3,0.9945255474452555,0.005474452554744526
40772421,1,943,106,837,0.11240721102863202,0.887592788971368
263985777,0,33,31,2,0.9393939393939394,0.06060606060606061
35327616,1,163,7,156,0.04294478527607362,0.9570552147239264
125209823,0,175,174,1,0.9942857142857143,0.005714285714285714
1247608934057283586,1,193,54,139,0.27979274611398963,0.7202072538860104
1217465204507738116,0,128,128,0,1.0,0.0
4077925042,1,407,76,331,0.18673218673218672,0.8132678132678133
1186039511404437510,0,54,54,0,1.0,0.0
2653053512,1,470,9,461,0.019148936170212766,0.9808510638297873
1247329885426790410,0,26,21,5,0.8076923076923077,0.19230769230769232
1855596602,1,37,15,22,0.40540540540540543,0.5945945945945946
123125661,0,351,351,0,1.0,0.0
1316568895,1,234,6,228,0.02564102564102564,0.9743589743589743
309456014,0,502,460,42,0.9163346613545816,0.08366533864541832
474471009,1,76,16,60,0.21052631578947367,0.7894736842105263
4125235334,0,528,520,8,0.9848484848484849,0.015151515151515152
435318668,1,521,153,368,0.29366602687140114,0.7063339731285988
1494224422978400263,0,5,5,0,1.0,0.0
532577598,1,299,25,274,0.08361204013377926,0.9163879598662207
287927001,0,1000,993,7,0.993,0.007
1283839559323844609,0,1000,999,1,0.999,0.001
2739564201,1,183,17,166,0.09289617486338798,0.907103825136612
35824481,0,257,256,1,0.9961089494163424,0.0038910505836575876
861848324,1,80,18,62,0.225,0.775
204616994,0,1000,1000,0,1.0,0.0
748512944,1,59,4,55,0.06779661016949153,0.9322033898305084
912862741458644992,1,21,0,21,0.0,1.0
305195906,0,744,744,0,1.0,0.0
1161323840569597957,1,222,55,167,0.24774774774774774,0.7522522522522522
143893829,0,1000,965,35,0.965,0.035
77854316,1,466,14,452,0.030042918454935622,0.9699570815450643
1081266256555036672,0,74,72,2,0.972972972972973,0.02702702702702703
256248293,1,724,19,705,0.026243093922651933,0.9737569060773481
1902315853,0,72,72,0,1.0,0.0
4794188354,1,1000,9,991,0.009,0.991
934966576670949376,0,90,89,1,0.9888888888888889,0.011111111111111112
434283884,1,379,51,328,0.1345646437994723,0.8654353562005277
526005594,0,455,449,6,0.9868131868131869,0.013186813186813187
15302398,1,1000,177,823,0.177,0.823
1208677293821849600,1,43,6,37,0.13953488372093023,0.8604651162790697
1455247866864324610,0,73,73,0,1.0,0.0
797914284789415937,1,104,9,95,0.08653846153846154,0.9134615384615384
350410831,0,561,561,0,1.0,0.0
24123379,1,1000,292,708,0.292,0.708
2918420377,0,228,228,0,1.0,0.0
1277798690351177735,1,20,12,8,0.6,0.4
1061382029433061377,0,66,65,1,0.9848484848484849,0.015151515151515152
23498175,1,523,69,454,0.13193116634799235,0.8680688336520076
986957437101101056,0,1000,991,9,0.991,0.009
880301,1,480,30,450,0.0625,0.9375
3320451335,0,32,32,0,1.0,0.0
758549760,1,1000,22,978,0.022,0.978
1220764190387949568,0,105,105,0,1.0,0.0
1099832792509227008,1,258,62,196,0.24031007751937986,0.7596899224806202
495947316,0,401,383,18,0.9551122194513716,0.04488778054862843
1054233224380116994,1,555,66,489,0.11891891891891893,0.8810810810810811
393736478,0,1000,995,5,0.995,0.005
1421215816922640394,1,41,7,34,0.17073170731707318,0.8292682926829268
1517261518265593857,0,1,1,0,1.0,0.0
1143457363,1,1000,73,927,0.073,0.927
1408922822131417089,0,107,104,3,0.9719626168224299,0.028037383177570093
27185773,1,551,80,471,0.14519056261343014,0.8548094373865699
2912796223,0,12,12,0,1.0,0.0
759849780185104388,1,57,2,55,0.03508771929824561,0.9649122807017544
552513229,0,118,115,3,0.9745762711864406,0.025423728813559324
39550527,1,111,33,78,0.2972972972972973,0.7027027027027027
2367448934,1,473,46,427,0.09725158562367865,0.9027484143763214
446646378,0,2,2,0,1.0,0.0
791058326700384256,1,152,3,149,0.019736842105263157,0.9802631578947368
49184067,0,1000,1000,0,1.0,0.0
3819824841,1,1000,13,987,0.013,0.987
544022122,0,770,770,0,1.0,0.0
2415009792,1,50,2,48,0.04,0.96
1478426166902071301,0,39,33,6,0.8461538461538461,0.15384615384615385
24800747,1,1000,155,845,0.155,0.845
30455226,0,591,587,4,0.9932318104906938,0.00676818950930626
562319841,1,1000,242,758,0.242,0.758
738746170193936384,0,141,141,0,1.0,0.0
789289534886412288,1,470,61,409,0.12978723404255318,0.8702127659574468
62635193,0,730,729,1,0.9986301369863013,0.0013698630136986301
1388883833202880521,1,503,166,337,0.33001988071570576,0.6699801192842942
1126568262458855426,0,1000,995,5,0.995,0.005
2734432061,1,365,55,310,0.1506849315068493,0.8493150684931506
1443786508897456160,0,12,10,2,0.8333333333333334,0.16666666666666666
586054923,1,838,7,831,0.008353221957040573,0.9916467780429594
700943310,0,827,824,3,0.9963724304715841,0.0036275695284159614
1435459322633326597,1,327,54,273,0.1651376146788991,0.8348623853211009
2992586128,0,131,128,3,0.9770992366412213,0.022900763358778626
1326438258264469504,1,103,6,97,0.05825242718446602,0.941747572815534
3291841050,0,147,147,0,1.0,0.0
19555275,1,392,7,385,0.017857142857142856,0.9821428571428571
964697852361543680,1,144,34,110,0.2361111111111111,0.7638888888888888
1183438572789075970,0,14,14,0,1.0,0.0
3266120660,1,1000,20,980,0.02,0.98
2288928878,0,500,438,62,0.876,0.124
758029790024728577,1,29,3,26,0.10344827586206896,0.896551724137931
502510701,0,45,45,0,1.0,0.0
24182082,1,1000,160,840,0.16,0.84
19140505,0,430,428,2,0.9953488372093023,0.004651162790697674
1488133242,0,124,124,0,1.0,0.0
1481367197473673218,1,4,1,3,0.25,0.75
1172304448669880321,0,1000,978,22,0.978,0.022
1518217674681196547,1,6,3,3,0.5,0.5
1361027102477287427,0,860,860,0,1.0,0.0
1290256875175448576,1,1000,145,855,0.145,0.855
236245591,0,752,715,37,0.9507978723404256,0.04920212765957447
1238972243314708482,1,145,33,112,0.22758620689655173,0.7724137931034483
63098042,0,111,111,0,1.0,0.0
1072293537956487168,1,7,1,6,0.14285714285714285,0.8571428571428571
58920133,0,17,17,0,1.0,0.0
969772673604571136,1,184,7,177,0.03804347826086957,0.9619565217391305
1203562471996481536,0,37,37,0,1.0,0.0
340102536,1,452,66,386,0.14601769911504425,0.8539823008849557
1108585978783039488,0,209,209,0,1.0,0.0
1032042271926046721,1,113,8,105,0.07079646017699115,0.9292035398230089
972221456573714433,0,33,33,0,1.0,0.0
522292390,1,656,92,564,0.1402439024390244,0.8597560975609756
2566486723,0,1000,970,30,0.97,0.03
2480116573,1,95,22,73,0.23157894736842105,0.7684210526315789
1436535330711031808,0,1,1,0,1.0,0.0
18087961,1,1000,109,891,0.109,0.891
1124437787690901504,0,80,80,0,1.0,0.0
824288664301674496,1,1000,45,955,0.045,0.955
1225543870919958534,0,1000,989,11,0.989,0.011
1257891501784342535,1,35,7,28,0.2,0.8
226384428,0,1000,999,1,0.999,0.001
627069482,1,703,5,698,0.007112375533428165,0.9928876244665719
752034165336449024,0,1000,994,6,0.994,0.006
1154026104858054658,1,112,16,96,0.14285714285714285,0.8571428571428571
30275905,0,160,159,1,0.99375,0.00625
1525929023930609667,1,1000,22,978,0.022,0.978
547664896,0,854,853,1,0.9988290398126464,0.00117096018735363
998572754105520128,1,540,147,393,0.2722222222222222,0.7277777777777777
873038487523516416,0,3,3,0,1.0,0.0
1600790959,1,222,10,212,0.04504504504504504,0.954954954954955
931504814,0,131,130,1,0.9923664122137404,0.007633587786259542
23260503,1,1000,49,951,0.049,0.951
2590319545,0,496,494,2,0.9959677419354839,0.004032258064516129
982380454601883648,1,450,107,343,0.23777777777777778,0.7622222222222222
14996376,0,1000,963,37,0.963,0.037
2451251457,1,1000,19,981,0.019,0.981
1618198993,0,1000,959,41,0.959,0.041
154329435,0,27,27,0,1.0,0.0
123628473,1,90,0,90,0.0,1.0
448030236,0,1000,1000,0,1.0,0.0
277779173,1,66,7,59,0.10606060606060606,0.8939393939393939
49705112,0,192,190,2,0.9895833333333334,0.010416666666666666
1278938203194621954,1,97,6,91,0.061855670103092786,0.9381443298969072
1424539186061791234,0,7,7,0,1.0,0.0
1202805253231534081,1,9,3,6,0.3333333333333333,0.6666666666666666
2961061201,0,676,670,6,0.9911242603550295,0.008875739644970414
1182429803821051905,1,1000,221,779,0.221,0.779
3150743348,0,158,157,1,0.9936708860759493,0.006329113924050633
18753099,1,394,10,384,0.025380710659898477,0.9746192893401016
814156489820618753,0,496,465,31,0.9375,0.0625
4547678003,1,398,7,391,0.017587939698492462,0.9824120603015075
1103077306908790784,0,31,31,0,1.0,0.0
289148669,1,271,20,251,0.07380073800738007,0.9261992619926199
795038612828127232,0,58,57,1,0.9827586206896551,0.017241379310344827
167949531,1,1000,9,991,0.009,0.991
929828467,0,1000,997,3,0.997,0.003
1339687967665909760,1,435,48,387,0.1103448275862069,0.8896551724137931
1337067568545345539,0,11,11,0,1.0,0.0
1148411833042104320,1,688,211,477,0.3066860465116279,0.6933139534883721
801812944799563776,0,3,3,0,1.0,0.0
15421733,1,80,7,73,0.0875,0.9125
160518253,0,47,47,0,1.0,0.0
863670450,1,1000,99,901,0.099,0.901
82465753,0,67,67,0,1.0,0.0
1575603132,1,1000,242,758,0.242,0.758
184118055,0,559,557,2,0.9964221824686941,0.0035778175313059034
2187535951,1,125,17,108,0.136,0.864
1286289451375706112,0,1000,982,18,0.982,0.018
2947296641,1,181,7,174,0.03867403314917127,0.9613259668508287
137890616,0,1000,996,4,0.996,0.004
1510693166202109956,1,5,1,4,0.2,0.8
1440883874951745541,0,2,2,0,1.0,0.0
829490363706388480,1,1000,145,855,0.145,0.855
1082513699271667712,0,274,274,0,1.0,0.0
4069975937,1,418,132,286,0.3157894736842105,0.6842105263157895
1469423814425653249,0,1000,918,82,0.918,0.082
31319794,1,230,7,223,0.030434782608695653,0.9695652173913043
1382001494707240961,0,50,50,0,1.0,0.0
949001034847981573,1,80,7,73,0.0875,0.9125
1177253158743085056,0,172,163,9,0.9476744186046512,0.05232558139534884
16342660,1,490,16,474,0.0326530612244898,0.9673469387755103
797962091202232320,0,240,240,0,1.0,0.0
2594105851,1,105,30,75,0.2857142857142857,0.7142857142857143
4781813503,0,907,903,4,0.9955898566703418,0.004410143329658214
3299011141,1,641,54,587,0.0842433697347894,0.9157566302652106
883329166690668546,0,18,18,0,1.0,0.0
1419635610,1,79,17,62,0.21518987341772153,0.7848101265822784
2547683833,0,117,117,0,1.0,0.0
1413286640433381377,1,17,1,16,0.058823529411764705,0.9411764705882353
15223559,0,1000,993,7,0.993,0.007
3067154009,1,400,32,368,0.08,0.92
61285138,0,1000,983,17,0.983,0.017
31011405,1,473,5,468,0.010570824524312896,0.9894291754756871
1292953867609501697,0,543,451,92,0.8305709023941068,0.1694290976058932
74243960,1,1000,263,737,0.263,0.737
44816014,0,101,101,0,1.0,0.0
947726125165371392,1,73,6,67,0.0821917808219178,0.9178082191780822
848792562,0,271,250,21,0.922509225092251,0.07749077490774908
1411788099785478146,1,417,178,239,0.42685851318944845,0.5731414868105515
1516259424020545539,0,8,8,0,1.0,0.0
1152225154191319040,0,40,40,0,1.0,0.0
1445183254122975236,1,9,1,8,0.1111111111111111,0.8888888888888888
1119332916880977920,0,60,60,0,1.0,0.0
928023623759142912,0,1000,925,75,0.925,0.075
340469615,1,193,35,158,0.18134715025906736,0.8186528497409327
1332161797462351874,0,427,427,0,1.0,0.0
993197405049884672,1,65,16,49,0.24615384615384617,0.7538461538461538
37963507,0,69,67,2,0.9710144927536232,0.028985507246376812
65904982,1,302,24,278,0.07947019867549669,0.9205298013245033
487909779,0,1000,941,59,0.941,0.059
210936278,1,454,56,398,0.12334801762114538,0.8766519823788547
1154906268504604672,0,12,12,0,1.0,0.0
1119385625805770752,1,88,8,80,0.09090909090909091,0.9090909090909091
78413074,0,73,73,0,1.0,0.0
883400789208596481,1,622,32,590,0.05144694533762058,0.9485530546623794
266763546,0,881,860,21,0.9761634506242906,0.02383654937570942
1492282043161587714,1,20,3,17,0.15,0.85
1440067447122382849,0,419,419,0,1.0,0.0
73665172,1,86,1,85,0.011627906976744186,0.9883720930232558
632204672,0,94,94,0,1.0,0.0
44805298,1,516,16,500,0.031007751937984496,0.9689922480620154
1666697948,0,113,92,21,0.8141592920353983,0.18584070796460178
796760212602490881,1,203,53,150,0.26108374384236455,0.7389162561576355
1375787266799509508,0,7,7,0,1.0,0.0
2170966518,1,1000,33,967,0.033,0.967
36891429,0,675,674,1,0.9985185185185185,0.0014814814814814814
2988083423,1,204,6,198,0.029411764705882353,0.9705882352941176
1282529991910203392,0,1000,966,34,0.966,0.034
1526449283817676800,0,177,176,1,0.9943502824858758,0.005649717514124294
1259967506187354112,1,5,0,5,0.0,1.0
937407272816467968,0,122,122,0,1.0,0.0
11392382,1,83,12,71,0.14457831325301204,0.8554216867469879
1320906923865231366,0,66,56,10,0.8484848484848485,0.15151515151515152
2449006021,1,1000,252,748,0.252,0.748
1487076214019960836,0,8,8,0,1.0,0.0
1044653152400637952,1,765,101,664,0.13202614379084968,0.8679738562091504
937348258552209408,0,4,4,0,1.0,0.0
96861389,1,448,113,335,0.25223214285714285,0.7477678571428571
1005077113878253568,0,861,861,0,1.0,0.0
3286618128,1,337,73,264,0.2166172106824926,0.7833827893175074
3329523370,0,179,151,28,0.8435754189944135,0.1564245810055866
1512308531445190657,1,326,62,264,0.1901840490797546,0.8098159509202454
1052319682596880385,0,109,109,0,1.0,0.0
1270867094352076800,1,8,1,7,0.125,0.875
63584905,0,183,182,1,0.994535519125683,0.00546448087431694
1055250632796340224,1,1000,121,879,0.121,0.879
777293977045180416,0,179,177,2,0.9888268156424581,0.0111731843575419
993203387029172224,1,531,161,370,0.3032015065913371,0.696798493408663
60651826,0,69,69,0,1.0,0.0
1074489264866504707,1,1000,335,665,0.335,0.665
1265726104805007362,0,247,221,26,0.8947368421052632,0.10526315789473684
1175822117297938437,1,823,190,633,0.23086269744835966,0.7691373025516404
973996531144511489,0,276,227,49,0.822463768115942,0.17753623188405798
1262399773677686786,1,37,6,31,0.16216216216216217,0.8378378378378378
536388718,0,193,193,0,1.0,0.0
2513448559,1,1000,56,944,0.056,0.944
1423833314889134093,0,39,39,0,1.0,0.0
976874648347475969,1,88,2,86,0.022727272727272728,0.9772727272727273
3318151028,0,210,206,4,0.9809523809523809,0.01904761904761905
1003832285743976448,1,242,43,199,0.17768595041322313,0.8223140495867769
1180073343887843328,0,176,176,0,1.0,0.0
352741335,1,380,49,331,0.12894736842105264,0.8710526315789474
1052616318438928384,0,347,342,5,0.9855907780979827,0.01440922190201729
