user_id,has_pronouns,followers_sampled,raw_match,raw_non_match,percent_match,percent_non_match
2752191758,1,1000,196,804,0.196,0.804
63552612,0,218,218,0,1.0,0.0
1017116993009352706,1,377,11,366,0.029177718832891247,0.9708222811671088
414380402,0,556,554,2,0.9964028776978417,0.0035971223021582736
1863417217,1,64,2,62,0.03125,0.96875
289566257,0,323,323,0,1.0,0.0
992560107690037248,0,1000,967,33,0.967,0.033
122845949,1,1000,123,877,0.123,0.877
1085567757868060672,0,141,141,0,1.0,0.0
713172662487363584,1,193,10,183,0.05181347150259067,0.9481865284974094
1219345363837972481,0,535,520,15,0.9719626168224299,0.028037383177570093
895474609083961344,1,297,36,261,0.12121212121212122,0.8787878787878788
234154999,0,1000,975,25,0.975,0.025
4068532460,1,834,103,731,0.12350119904076738,0.8764988009592326
22387980,0,181,178,3,0.9834254143646409,0.016574585635359115
978101906638688258,1,891,85,806,0.09539842873176206,0.9046015712682379
115751968,0,997,863,134,0.8655967903711134,0.13440320962888666
1072610916301197317,1,193,30,163,0.15544041450777202,0.844559585492228
1339974555083960320,0,835,833,2,0.9976047904191617,0.0023952095808383233
456183100,1,759,46,713,0.06060606060606061,0.9393939393939394
1305181066991464448,0,118,118,0,1.0,0.0
2500234556,1,143,22,121,0.15384615384615385,0.8461538461538461
18868567,0,1000,725,275,0.725,0.275
17794400,1,1000,117,883,0.117,0.883
447885839,0,708,707,1,0.998587570621469,0.0014124293785310734
156753388,1,174,12,162,0.06896551724137931,0.9310344827586207
1371075313547964417,0,810,810,0,1.0,0.0
1393266763316400129,1,346,42,304,0.12138728323699421,0.8786127167630058
4694964168,0,941,936,5,0.9946865037194474,0.005313496280552604
1481544604088365058,1,394,99,295,0.2512690355329949,0.748730964467005
1254907154,0,1000,954,46,0.954,0.046
12754762,1,612,156,456,0.2549019607843137,0.7450980392156863
396887061,0,95,93,2,0.9789473684210527,0.021052631578947368
1206727316128223232,1,604,100,504,0.16556291390728478,0.8344370860927153
45995298,0,1000,940,60,0.94,0.06
1293178926278348800,1,275,101,174,0.36727272727272725,0.6327272727272727
497500337,0,1000,996,4,0.996,0.004
1006218115183759360,1,123,20,103,0.16260162601626016,0.8373983739837398
1450983720874168321,0,810,794,16,0.980246913580247,0.019753086419753086
71606159,1,692,148,544,0.2138728323699422,0.7861271676300579
1139073494485032962,0,287,286,1,0.9965156794425087,0.003484320557491289
289539354,1,1000,71,929,0.071,0.929
310136887,0,169,168,1,0.9940828402366864,0.005917159763313609
362895155,0,1000,968,32,0.968,0.032
3999883632,1,1000,126,874,0.126,0.874
809848256872247296,0,150,150,0,1.0,0.0
970760816432701446,0,268,264,4,0.9850746268656716,0.014925373134328358
1068497143999209472,1,1000,174,826,0.174,0.826
1296465836937318405,0,21,21,0,1.0,0.0
20061604,1,1000,133,867,0.133,0.867
251986342,0,734,721,13,0.9822888283378747,0.017711171662125342
973938329702907905,1,705,37,668,0.0524822695035461,0.9475177304964539
1205270442,0,1000,993,7,0.993,0.007
2882773429,1,1000,236,764,0.236,0.764
1097198227,0,173,169,4,0.976878612716763,0.023121387283236993
1163861179724267522,1,276,54,222,0.1956521739130435,0.8043478260869565
1401532158989176832,0,1000,976,24,0.976,0.024
57240630,1,1000,145,855,0.145,0.855
805097483424497664,0,245,245,0,1.0,0.0
4143763755,1,186,10,176,0.053763440860215055,0.946236559139785
733693554275442688,0,383,372,11,0.9712793733681462,0.028720626631853787
706575557937336322,1,580,73,507,0.12586206896551724,0.8741379310344828
1281301686498320384,0,371,370,1,0.9973045822102425,0.0026954177897574125
48986727,0,174,168,6,0.9655172413793104,0.034482758620689655
1423854980134576130,0,142,139,3,0.9788732394366197,0.02112676056338028
213485403,1,320,31,289,0.096875,0.903125
759668776686145536,0,396,384,12,0.9696969696969697,0.030303030303030304
2693478411,1,379,11,368,0.029023746701846966,0.9709762532981531
836448797668573185,0,34,33,1,0.9705882352941176,0.029411764705882353
32745490,1,204,19,185,0.09313725490196079,0.9068627450980392
1521894217903091712,0,559,558,1,0.998211091234347,0.0017889087656529517
377093787,1,346,14,332,0.04046242774566474,0.9595375722543352
1327122243223171073,0,280,272,8,0.9714285714285714,0.02857142857142857
38823,1,1000,156,844,0.156,0.844
705240144325046273,0,1000,973,27,0.973,0.027
54303070,1,181,11,170,0.06077348066298342,0.9392265193370166
1028070341116092417,0,151,151,0,1.0,0.0
2379282258,1,129,31,98,0.24031007751937986,0.7596899224806202
2566161081,0,305,305,0,1.0,0.0
2932894342,1,384,92,292,0.23958333333333334,0.7604166666666666
28930287,0,1000,985,15,0.985,0.015
1445831678136487947,1,26,4,22,0.15384615384615385,0.8461538461538461
4132184205,0,169,165,4,0.9763313609467456,0.023668639053254437
24402703,1,749,39,710,0.0520694259012016,0.9479305740987984
351418982,0,465,462,3,0.9935483870967742,0.0064516129032258064
711026693897453568,1,1000,58,942,0.058,0.942
947276270,1,1000,305,695,0.305,0.695
1150585214269362176,0,108,108,0,1.0,0.0
988982297314578432,1,117,12,105,0.10256410256410256,0.8974358974358975
539335143,0,638,636,2,0.9968652037617555,0.003134796238244514
2324927503,1,708,33,675,0.046610169491525424,0.9533898305084746
888752774468567040,0,299,289,10,0.9665551839464883,0.033444816053511704
1335368979695742976,1,476,127,349,0.2668067226890756,0.7331932773109243
182919193,0,1000,889,111,0.889,0.111
162103637,1,1000,54,946,0.054,0.946
1395197099319386118,0,45,45,0,1.0,0.0
2241485071,1,467,28,439,0.059957173447537475,0.9400428265524625
1298326840918999040,0,25,25,0,1.0,0.0
57731989,1,603,112,491,0.1857379767827529,0.814262023217247
1057363530935099398,0,347,347,0,1.0,0.0
721708324480135168,1,411,126,285,0.30656934306569344,0.6934306569343066
1337044551249301505,0,204,188,16,0.9215686274509803,0.0784313725490196
1099187461165465601,1,945,155,790,0.164021164021164,0.8359788359788359
15891995,0,1000,956,44,0.956,0.044
355990890,1,732,41,691,0.056010928961748634,0.9439890710382514
1173302084923510784,1,1000,175,825,0.175,0.825
192754873,0,701,649,52,0.9258202567760342,0.07417974322396577
1234297475378315265,1,113,34,79,0.3008849557522124,0.6991150442477876
1279051208318222338,0,153,152,1,0.9934640522875817,0.006535947712418301
138125551,1,1000,127,873,0.127,0.873
1097615312013443073,1,147,38,109,0.2585034013605442,0.7414965986394558
1220576561780281344,0,109,109,0,1.0,0.0
15384099,1,265,65,200,0.24528301886792453,0.7547169811320755
1014329312286158848,0,140,136,4,0.9714285714285714,0.02857142857142857
1229119914855845893,1,334,55,279,0.16467065868263472,0.8353293413173652
1517643511008567296,0,306,304,2,0.9934640522875817,0.006535947712418301
263962408,1,1000,123,877,0.123,0.877
1244689812,0,19,18,1,0.9473684210526315,0.05263157894736842
506531130,1,1000,17,983,0.017,0.983
796719483243130881,0,1000,965,35,0.965,0.035
1046281357075386369,1,313,16,297,0.051118210862619806,0.9488817891373802
475460686,0,659,656,3,0.9954476479514416,0.004552352048558422
866821697411756032,1,1000,161,839,0.161,0.839
237996762,0,281,281,0,1.0,0.0
68243677,1,1000,169,831,0.169,0.831
1350129238104485888,0,142,142,0,1.0,0.0
1260313111162208257,1,74,9,65,0.12162162162162163,0.8783783783783784
1049070992444870656,0,119,119,0,1.0,0.0
1044718050006757387,1,196,16,180,0.08163265306122448,0.9183673469387755
3253608432,0,31,30,1,0.967741935483871,0.03225806451612903
1066082226,1,1000,108,892,0.108,0.892
354719909,0,578,573,5,0.9913494809688581,0.00865051903114187
68008892,1,1000,95,905,0.095,0.905
71001523,0,762,710,52,0.931758530183727,0.06824146981627296
952357145479122946,1,221,17,204,0.07692307692307693,0.9230769230769231
1197903253553459206,1,806,198,608,0.2456575682382134,0.7543424317617866
1509753112180965376,0,208,208,0,1.0,0.0
1958879893,0,408,408,0,1.0,0.0
1320822908978188290,1,208,16,192,0.07692307692307693,0.9230769230769231
1160615174157434881,0,217,217,0,1.0,0.0
145074229,0,259,259,0,1.0,0.0
251067495,1,1000,109,891,0.109,0.891
410833813,0,1000,977,23,0.977,0.023
1018105278242254854,1,1000,7,993,0.007,0.993
877301431136641025,0,178,175,3,0.9831460674157303,0.016853932584269662
147038205,1,301,6,295,0.019933554817275746,0.9800664451827242
1330620971590434817,0,309,292,17,0.9449838187702265,0.05501618122977346
1025867276623331328,1,317,66,251,0.2082018927444795,0.7917981072555205
1508871182249979904,0,192,192,0,1.0,0.0
463198777,1,1000,48,952,0.048,0.952
1163277639328489472,0,128,121,7,0.9453125,0.0546875
1248482223025582082,1,183,8,175,0.04371584699453552,0.9562841530054644
386020893,0,228,226,2,0.9912280701754386,0.008771929824561403
279753108,1,133,16,117,0.12030075187969924,0.8796992481203008
3376213325,0,1000,964,36,0.964,0.036
2867659051,1,983,93,890,0.09460834181078331,0.9053916581892166
482480501,0,191,181,10,0.9476439790575916,0.05235602094240838
26117763,1,252,5,247,0.01984126984126984,0.9801587301587301
79356087,0,333,331,2,0.993993993993994,0.006006006006006006
29757971,1,1000,62,938,0.062,0.938
1314757852452589568,0,166,160,6,0.963855421686747,0.03614457831325301
2967114797,1,50,1,49,0.02,0.98
1527018083428220928,0,21,21,0,1.0,0.0
1348173782138056705,1,325,35,290,0.1076923076923077,0.8923076923076924
1037867618118627328,0,519,507,12,0.976878612716763,0.023121387283236993
846087950,1,271,89,182,0.3284132841328413,0.6715867158671587
2241169429,0,482,441,41,0.9149377593360996,0.08506224066390042
825028810877853696,0,330,327,3,0.990909090909091,0.00909090909090909
262867735,1,707,100,607,0.14144271570014144,0.8585572842998586
49273415,0,391,374,17,0.9565217391304348,0.043478260869565216
19264509,1,778,101,677,0.12982005141388175,0.8701799485861182
19655644,0,226,221,5,0.9778761061946902,0.022123893805309734
1346627522801381380,1,272,80,192,0.29411764705882354,0.7058823529411765
729416204,0,1000,996,4,0.996,0.004
1406519496,1,389,86,303,0.2210796915167095,0.7789203084832905
704599983304024064,0,25,25,0,1.0,0.0
316023499,1,577,203,374,0.35181975736568455,0.6481802426343154
716803705,0,390,370,20,0.9487179487179487,0.05128205128205128
1429540179640037377,1,333,34,299,0.1021021021021021,0.8978978978978979
1835035194,0,1000,978,22,0.978,0.022
1344167592789852161,1,170,18,152,0.10588235294117647,0.8941176470588236
890047387779125248,0,64,61,3,0.953125,0.046875
2415313494,1,1000,78,922,0.078,0.922
703731059008126978,0,355,334,21,0.9408450704225352,0.059154929577464786
635045836,1,397,29,368,0.07304785894206549,0.9269521410579346
989657895313772544,0,103,102,1,0.9902912621359223,0.009708737864077669
2518354518,1,342,83,259,0.24269005847953215,0.7573099415204678
105533808,0,99,99,0,1.0,0.0
1833407366,1,208,76,132,0.36538461538461536,0.6346153846153846
452754055,0,219,218,1,0.9954337899543378,0.0045662100456621
2648324967,1,583,74,509,0.1269296740994854,0.8730703259005146
16607787,0,337,330,7,0.9792284866468842,0.020771513353115726
322711193,1,1000,34,966,0.034,0.966
2865048388,0,35,35,0,1.0,0.0
191695844,1,1000,170,830,0.17,0.83
88003707,0,1000,970,30,0.97,0.03
39079123,1,1000,243,757,0.243,0.757
19080952,0,245,243,2,0.9918367346938776,0.00816326530612245
907459673040801792,1,1000,150,850,0.15,0.85
2209302388,0,186,184,2,0.989247311827957,0.010752688172043012
4804677374,1,1000,171,829,0.171,0.829
1145190287452647424,0,20,20,0,1.0,0.0
23483984,1,542,103,439,0.1900369003690037,0.8099630996309963
1510627779150237698,0,85,85,0,1.0,0.0
179699738,1,1000,137,863,0.137,0.863
1501887220587900931,0,90,87,3,0.9666666666666667,0.03333333333333333
27473742,1,294,24,270,0.08163265306122448,0.9183673469387755
1093108454376402950,0,72,72,0,1.0,0.0
1185761099347566594,1,1000,182,818,0.182,0.818
1343384174,0,753,739,14,0.9814077025232404,0.01859229747675963
1119106667071688709,1,127,11,116,0.08661417322834646,0.9133858267716536
191495678,0,1000,986,14,0.986,0.014
1391010187121676291,1,222,80,142,0.36036036036036034,0.6396396396396397
901638715877072902,0,43,43,0,1.0,0.0
890926161949315072,1,1000,145,855,0.145,0.855
1395154439170936835,0,88,87,1,0.9886363636363636,0.011363636363636364
94627935,1,1000,100,900,0.1,0.9
2782013469,0,852,852,0,1.0,0.0
2741306168,1,350,28,322,0.08,0.92
62859515,0,1000,993,7,0.993,0.007
3409339865,1,206,48,158,0.23300970873786409,0.7669902912621359
4578744912,0,303,303,0,1.0,0.0
38935120,1,1000,33,967,0.033,0.967
20040284,0,398,380,18,0.9547738693467337,0.04522613065326633
763313223055597568,1,765,145,620,0.1895424836601307,0.8104575163398693
1453207977188421634,0,1000,996,4,0.996,0.004
95875170,1,870,239,631,0.2747126436781609,0.725287356321839
1491448863751823360,0,532,528,4,0.9924812030075187,0.007518796992481203
1021372159879499777,1,141,19,122,0.1347517730496454,0.8652482269503546
1182026403795148801,0,318,316,2,0.9937106918238994,0.006289308176100629
952280083175301120,1,680,165,515,0.2426470588235294,0.7573529411764706
1258429032867258368,1,195,5,190,0.02564102564102564,0.9743589743589743
1434997671710711809,0,20,20,0,1.0,0.0
1536701636839620608,1,511,131,380,0.2563600782778865,0.7436399217221135
1252852550,0,1000,996,4,0.996,0.004
15495095,1,390,42,348,0.1076923076923077,0.8923076923076924
933187133103226880,0,1000,1000,0,1.0,0.0
904816056820105216,1,1000,125,875,0.125,0.875
2676050844,1,783,88,695,0.1123882503192848,0.8876117496807152
268560939,0,746,746,0,1.0,0.0
1574206560,1,282,39,243,0.13829787234042554,0.8617021276595744
1392857544851345415,0,92,92,0,1.0,0.0
1378956012787535872,1,75,5,70,0.06666666666666667,0.9333333333333333
384173651,0,1000,994,6,0.994,0.006
770320689618415616,1,1000,64,936,0.064,0.936
23258069,0,130,126,4,0.9692307692307692,0.03076923076923077
2912008965,1,998,75,923,0.07515030060120241,0.9248496993987976
1223112722683850752,0,1000,998,2,0.998,0.002
1451282169251442689,1,326,24,302,0.0736196319018405,0.9263803680981595
18640610,0,525,518,7,0.9866666666666667,0.013333333333333334
115875996,0,1000,988,12,0.988,0.012
1244791,1,538,80,458,0.14869888475836432,0.8513011152416357
490021309,0,1000,998,2,0.998,0.002
779883430351732737,1,417,87,330,0.20863309352517986,0.7913669064748201
1306853698333675521,0,170,169,1,0.9941176470588236,0.0058823529411764705
151320340,1,767,84,683,0.10951760104302477,0.8904823989569752
633982424,0,1000,969,31,0.969,0.031
1094847064679346177,1,466,107,359,0.2296137339055794,0.7703862660944206
829929686486568960,0,459,452,7,0.9847494553376906,0.015250544662309368
15620050,1,723,21,702,0.029045643153526972,0.970954356846473
1507855765763239936,0,452,447,5,0.9889380530973452,0.011061946902654867
37852525,1,1000,128,872,0.128,0.872
584485224,0,810,806,4,0.9950617283950617,0.0049382716049382715
618449076,1,311,16,295,0.05144694533762058,0.9485530546623794
909601633,0,302,302,0,1.0,0.0
60437219,1,822,53,769,0.06447688564476886,0.9355231143552312
41643941,0,95,95,0,1.0,0.0
1496529208411144195,0,10,10,0,1.0,0.0
172566424,1,694,58,636,0.08357348703170028,0.9164265129682997
2361774048,0,301,300,1,0.9966777408637874,0.0033222591362126247
18515201,1,74,2,72,0.02702702702702703,0.972972972972973
1887188364,0,308,286,22,0.9285714285714286,0.07142857142857142
1479367256257622017,1,92,16,76,0.17391304347826086,0.8260869565217391
1192699412532756480,0,480,444,36,0.925,0.075
120369828,1,754,89,665,0.11803713527851459,0.8819628647214854
1113187052693020672,0,69,66,3,0.9565217391304348,0.043478260869565216
460740458,1,1000,73,927,0.073,0.927
815599724,0,408,384,24,0.9411764705882353,0.058823529411764705
17168776,1,966,81,885,0.08385093167701864,0.9161490683229814
395488024,0,281,278,3,0.9893238434163701,0.010676156583629894
2752161299,1,767,111,656,0.14471968709256844,0.8552803129074316
3021859992,0,353,352,1,0.9971671388101983,0.0028328611898017
208536614,1,471,28,443,0.059447983014861996,0.940552016985138
113463401,0,253,252,1,0.9960474308300395,0.003952569169960474
3134068107,1,67,3,64,0.04477611940298507,0.9552238805970149
1288878416457015299,0,173,167,6,0.9653179190751445,0.03468208092485549
1135642131538665473,1,199,13,186,0.06532663316582915,0.9346733668341709
1180512132565258246,0,152,152,0,1.0,0.0
560542589,1,245,36,209,0.1469387755102041,0.8530612244897959
57927934,0,672,665,7,0.9895833333333334,0.010416666666666666
1147583655247851527,1,957,80,877,0.08359456635318704,0.9164054336468129
85587123,0,168,168,0,1.0,0.0
402896033,1,655,168,487,0.2564885496183206,0.7435114503816794
158291721,0,181,174,7,0.9613259668508287,0.03867403314917127
763528572111761412,1,1000,46,954,0.046,0.954
1504287758,0,360,355,5,0.9861111111111112,0.013888888888888888
548003863,1,372,23,349,0.06182795698924731,0.9381720430107527
1730578190,0,306,304,2,0.9934640522875817,0.006535947712418301
802981867708411905,1,296,38,258,0.12837837837837837,0.8716216216216216
137493398,0,1000,1000,0,1.0,0.0
20394174,1,707,53,654,0.07496463932107496,0.925035360678925
1513644274545483776,0,51,50,1,0.9803921568627451,0.0196078431372549
59304522,1,277,13,264,0.04693140794223827,0.9530685920577617
856586869,0,730,725,5,0.9931506849315068,0.00684931506849315
1128782458974031872,1,424,29,395,0.06839622641509434,0.9316037735849056
875298567895879681,0,433,418,15,0.9653579676674365,0.03464203233256351
251489816,1,893,161,732,0.18029115341545351,0.8197088465845465
450043664,0,792,710,82,0.8964646464646465,0.10353535353535354
581458012,1,1000,105,895,0.105,0.895
1224474704565678082,0,182,181,1,0.9945054945054945,0.005494505494505495
79661356,1,1000,50,950,0.05,0.95
1306644323660947461,0,34,33,1,0.9705882352941176,0.029411764705882353
2312504473,1,189,23,166,0.12169312169312169,0.8783068783068783
745415797955235840,0,800,790,10,0.9875,0.0125
9890872,1,1000,32,968,0.032,0.968
1402587671944257538,0,77,76,1,0.987012987012987,0.012987012987012988
1227564959560695808,1,1000,127,873,0.127,0.873
2937601316,0,610,607,3,0.9950819672131147,0.004918032786885246
72283937,1,669,52,617,0.07772795216741404,0.922272047832586
158580776,0,26,26,0,1.0,0.0
815960263077888000,1,1000,308,692,0.308,0.692
540215719,0,164,164,0,1.0,0.0
378149124,1,239,16,223,0.06694560669456066,0.9330543933054394
57423680,0,500,473,27,0.946,0.054
39890575,1,1000,142,858,0.142,0.858
728313317283008512,0,1000,949,51,0.949,0.051
251184816,1,202,13,189,0.06435643564356436,0.9356435643564357
29458419,0,240,237,3,0.9875,0.0125
2311478010,0,939,906,33,0.9648562300319489,0.03514376996805112
2896549421,1,498,55,443,0.11044176706827309,0.8895582329317269
192322172,0,431,430,1,0.9976798143851509,0.002320185614849188
77066018,1,464,52,412,0.11206896551724138,0.8879310344827587
2580359500,0,315,315,0,1.0,0.0
988540174236729344,1,519,81,438,0.15606936416184972,0.8439306358381503
19104847,0,182,181,1,0.9945054945054945,0.005494505494505495
2649983658,1,1000,20,980,0.02,0.98
1497074700,0,166,164,2,0.9879518072289156,0.012048192771084338
1384531347612463109,1,1000,229,771,0.229,0.771
54424983,0,1000,971,29,0.971,0.029
375984883,1,293,62,231,0.21160409556313994,0.78839590443686
469499707,0,1000,912,88,0.912,0.088
273443844,1,583,51,532,0.08747855917667238,0.9125214408233276
185869356,0,569,544,25,0.9560632688927944,0.043936731107205626
294206560,1,334,12,322,0.03592814371257485,0.9640718562874252
1172661863810850816,0,188,173,15,0.9202127659574468,0.0797872340425532
49931787,1,1000,23,977,0.023,0.977
1304516707910905856,0,567,564,3,0.9947089947089947,0.005291005291005291
1067445684142522369,1,91,19,72,0.2087912087912088,0.7912087912087912
1165236952926425089,0,14,14,0,1.0,0.0
622120706,1,204,11,193,0.05392156862745098,0.946078431372549
2315718056,0,145,144,1,0.993103448275862,0.006896551724137931
378743397,1,585,54,531,0.09230769230769231,0.9076923076923077
1330299406046949379,1,805,313,492,0.38881987577639754,0.6111801242236025
1518676385652297728,0,546,546,0,1.0,0.0
23449948,1,726,246,480,0.33884297520661155,0.6611570247933884
868958067458703360,0,52,52,0,1.0,0.0
502246310,1,412,51,361,0.12378640776699029,0.8762135922330098
402031331,0,1000,984,16,0.984,0.016
2369982852,1,1000,178,822,0.178,0.822
1325887824252588038,0,61,61,0,1.0,0.0
813083028796870657,1,1000,216,784,0.216,0.784
1178693965320728576,0,37,36,1,0.972972972972973,0.02702702702702703
38416475,1,894,133,761,0.1487695749440716,0.8512304250559284
848038114593353728,0,148,145,3,0.9797297297297297,0.02027027027027027
555395944,1,1000,111,889,0.111,0.889
864157777211531264,0,12,12,0,1.0,0.0
743183856,1,1000,135,865,0.135,0.865
371121089,0,367,363,4,0.989100817438692,0.010899182561307902
824451517151379458,1,56,2,54,0.03571428571428571,0.9642857142857143
1324908613454934016,0,227,220,7,0.9691629955947136,0.030837004405286344
1482071221,1,419,11,408,0.026252983293556086,0.9737470167064439
489115006,0,35,35,0,1.0,0.0
983710864493527040,1,1000,121,879,0.121,0.879
3379443423,0,1000,958,42,0.958,0.042
525576807,0,374,373,1,0.9973262032085561,0.00267379679144385
1102053602271477760,1,250,64,186,0.256,0.744
937660764428652545,0,364,352,12,0.967032967032967,0.03296703296703297
900305060,1,1000,69,931,0.069,0.931
346879101,0,158,148,10,0.9367088607594937,0.06329113924050633
329173253,1,251,27,224,0.10756972111553785,0.8924302788844621
3381644753,0,219,219,0,1.0,0.0
1130106910798016512,1,308,120,188,0.38961038961038963,0.6103896103896104
2178375739,0,359,335,24,0.9331476323119777,0.06685236768802229
864229313083842565,1,990,287,703,0.2898989898989899,0.7101010101010101
538515472,0,694,682,12,0.9827089337175793,0.01729106628242075
30951714,1,252,36,216,0.14285714285714285,0.8571428571428571
1329562722380386305,0,1000,946,54,0.946,0.054
779869353403641856,1,316,93,223,0.29430379746835444,0.7056962025316456
1046493124045008898,0,73,73,0,1.0,0.0
18490021,1,1000,406,594,0.406,0.594
885288816,0,86,82,4,0.9534883720930233,0.046511627906976744
3060376346,1,1000,47,953,0.047,0.953
2502119562,0,1000,996,4,0.996,0.004
3113337816,1,296,18,278,0.060810810810810814,0.9391891891891891
583396925,0,347,347,0,1.0,0.0
3642280156,0,388,388,0,1.0,0.0
1051130964,1,244,27,217,0.11065573770491803,0.889344262295082
779339008048365568,0,254,254,0,1.0,0.0
806128083124162560,1,1000,204,796,0.204,0.796
904051969,0,179,167,12,0.9329608938547486,0.0670391061452514
2509276794,1,618,84,534,0.13592233009708737,0.8640776699029126
1151217184695152640,0,199,190,9,0.9547738693467337,0.04522613065326633
21218130,1,1000,27,973,0.027,0.973
603146311,0,494,490,4,0.9919028340080972,0.008097165991902834
120941602,1,1000,86,914,0.086,0.914
845698845686280192,0,227,224,3,0.986784140969163,0.013215859030837005
191719467,1,334,72,262,0.2155688622754491,0.7844311377245509
4885770726,0,812,811,1,0.9987684729064039,0.0012315270935960591
2278737420,1,669,71,598,0.10612855007473841,0.8938714499252616
1367602229868453891,0,1000,1000,0,1.0,0.0
58561666,1,276,40,236,0.14492753623188406,0.855072463768116
603497871,0,618,617,1,0.9983818770226537,0.0016181229773462784
16070989,1,887,33,854,0.03720405862457723,0.9627959413754228
67346411,0,1000,990,10,0.99,0.01
1073111187917725696,1,1000,141,859,0.141,0.859
1317970641493151744,0,1000,1000,0,1.0,0.0
294421135,1,321,38,283,0.11838006230529595,0.881619937694704
1078156146110652416,0,1000,952,48,0.952,0.048
266359322,1,168,24,144,0.14285714285714285,0.8571428571428571
1050235047536513025,0,650,591,59,0.9092307692307692,0.09076923076923077
4880551694,1,144,11,133,0.0763888888888889,0.9236111111111112
1410453695993577481,0,480,467,13,0.9729166666666667,0.027083333333333334
1335365959775789057,1,227,50,177,0.22026431718061673,0.7797356828193832
386862625,0,98,98,0,1.0,0.0
70298555,1,548,89,459,0.1624087591240876,0.8375912408759124
1498656096,0,1000,977,23,0.977,0.023
20491623,1,802,192,610,0.23940149625935161,0.7605985037406484
305269657,0,597,587,10,0.983249581239531,0.01675041876046901
187293542,1,316,17,299,0.05379746835443038,0.9462025316455697
1053430916880621568,0,1000,940,60,0.94,0.06
1109673689547763713,1,1000,178,822,0.178,0.822
930628005436805120,0,535,532,3,0.994392523364486,0.005607476635514018
25631181,1,314,32,282,0.10191082802547771,0.8980891719745223
139107179,0,775,773,2,0.9974193548387097,0.0025806451612903226
1069288212,1,499,70,429,0.1402805611222445,0.8597194388777555
377187463,0,422,419,3,0.9928909952606635,0.0071090047393364926
1556045240,1,271,32,239,0.11808118081180811,0.8819188191881919
325028164,0,204,191,13,0.9362745098039216,0.06372549019607843
534852517,1,179,25,154,0.13966480446927373,0.8603351955307262
1344330901975609345,0,41,40,1,0.975609756097561,0.024390243902439025
1233982719236935680,1,1000,161,839,0.161,0.839
1419883537092673538,0,38,38,0,1.0,0.0
213144782,1,763,58,705,0.07601572739187418,0.9239842726081258
1440744862890954753,0,287,274,13,0.9547038327526133,0.04529616724738676
30556242,1,1000,68,932,0.068,0.932
1045166077561511936,0,1000,931,69,0.931,0.069
616386123,1,102,7,95,0.06862745098039216,0.9313725490196079
1455711605992341512,0,430,427,3,0.9930232558139535,0.0069767441860465115
2840658614,1,639,149,490,0.23317683881064163,0.7668231611893583
1389585191585206276,0,118,118,0,1.0,0.0
995040994063200257,1,822,86,736,0.10462287104622871,0.8953771289537713
1448261995610849289,0,346,345,1,0.9971098265895953,0.002890173410404624
955864004089565184,1,411,54,357,0.13138686131386862,0.8686131386861314
952165174634598400,0,254,252,2,0.9921259842519685,0.007874015748031496
1305939813762314247,1,157,8,149,0.050955414012738856,0.9490445859872612
570208881,0,814,813,1,0.9987714987714987,0.0012285012285012285
2955453975,1,177,12,165,0.06779661016949153,0.9322033898305084
231394499,0,247,201,46,0.8137651821862348,0.1862348178137652
1391562375355015172,1,46,1,45,0.021739130434782608,0.9782608695652174
1515072088817631234,0,443,443,0,1.0,0.0
847662969932570626,1,1000,173,827,0.173,0.827
76170955,0,144,133,11,0.9236111111111112,0.0763888888888889
2436384402,1,1000,114,886,0.114,0.886
2216824864,0,248,245,3,0.9879032258064516,0.012096774193548387
735368053,1,454,34,420,0.07488986784140969,0.9251101321585903
1288099538302054402,0,131,131,0,1.0,0.0
486128223,1,174,32,142,0.1839080459770115,0.8160919540229885
90440227,0,457,447,10,0.9781181619256017,0.02188183807439825
1254411,1,1000,318,682,0.318,0.682
185678031,0,888,881,7,0.9921171171171171,0.007882882882882882
1260016414657662976,1,148,29,119,0.19594594594594594,0.8040540540540541
312775245,0,1000,998,2,0.998,0.002
36233034,1,713,29,684,0.04067321178120617,0.9593267882187938
353241442,0,392,392,0,1.0,0.0
56357090,1,360,30,330,0.08333333333333333,0.9166666666666666
27445100,0,637,637,0,1.0,0.0
1079953903238533120,1,163,26,137,0.15950920245398773,0.8404907975460123
2502908489,0,110,104,6,0.9454545454545454,0.05454545454545454
1220911172544757760,1,525,180,345,0.34285714285714286,0.6571428571428571
1265904246412771328,0,381,374,7,0.9816272965879265,0.01837270341207349
593813511,1,1000,168,832,0.168,0.832
210669822,0,566,552,14,0.9752650176678446,0.024734982332155476
1133219737436131328,1,341,17,324,0.04985337243401759,0.9501466275659824
70020543,0,1000,978,22,0.978,0.022
992810344107118592,1,129,28,101,0.21705426356589147,0.7829457364341085
987730796181184512,0,121,112,9,0.9256198347107438,0.0743801652892562
1195203509353877505,1,156,10,146,0.0641025641025641,0.9358974358974359
37177625,0,70,70,0,1.0,0.0
1264300262811787264,1,40,4,36,0.1,0.9
1193141755895435264,0,51,51,0,1.0,0.0
295369860,1,538,11,527,0.020446096654275093,0.9795539033457249
1291175331601305601,0,505,499,6,0.9881188118811881,0.011881188118811881
327436527,1,842,209,633,0.24821852731591448,0.7517814726840855
744279250270826496,0,343,326,17,0.9504373177842566,0.04956268221574344
2324628397,1,252,32,220,0.12698412698412698,0.873015873015873
2263458716,0,104,101,3,0.9711538461538461,0.028846153846153848
830804881292222465,1,1000,120,880,0.12,0.88
241771628,0,662,655,7,0.9894259818731118,0.010574018126888218
1096512542980038656,1,237,26,211,0.10970464135021098,0.890295358649789
1270997539928465409,0,447,418,29,0.9351230425055929,0.06487695749440715
2622998961,1,319,17,302,0.05329153605015674,0.9467084639498433
325917880,0,396,378,18,0.9545454545454546,0.045454545454545456
495328359,1,517,72,445,0.13926499032882012,0.8607350096711799
337820006,0,535,535,0,1.0,0.0
18733082,1,469,43,426,0.09168443496801706,0.908315565031983
4891999486,0,66,65,1,0.9848484848484849,0.015151515151515152
785307077077897216,1,127,14,113,0.11023622047244094,0.889763779527559
2889963539,0,613,607,6,0.9902120717781403,0.009787928221859706
1154544483523911680,1,435,124,311,0.2850574712643678,0.7149425287356321
1291572962366296064,0,1000,948,52,0.948,0.052
1433410363,1,268,29,239,0.10820895522388059,0.8917910447761194
1348854900936028160,0,245,245,0,1.0,0.0
1071893745782673408,1,32,3,29,0.09375,0.90625
35193276,0,189,186,3,0.9841269841269841,0.015873015873015872
598455146,1,763,172,591,0.2254259501965924,0.7745740498034076
39087449,0,532,490,42,0.9210526315789473,0.07894736842105263
170074981,1,546,124,422,0.2271062271062271,0.7728937728937729
944739336154689537,0,1000,954,46,0.954,0.046
194319035,1,179,16,163,0.0893854748603352,0.9106145251396648
65560722,0,142,142,0,1.0,0.0
1257525819842256896,1,305,37,268,0.12131147540983607,0.8786885245901639
3432451306,0,722,682,40,0.9445983379501385,0.055401662049861494
1247736435622531073,1,674,71,603,0.10534124629080119,0.8946587537091988
64039087,0,141,141,0,1.0,0.0
3180236590,1,577,35,542,0.060658578856152515,0.9393414211438474
3303248092,0,414,385,29,0.9299516908212561,0.07004830917874397
1142946045216866304,1,1000,187,813,0.187,0.813
3003942823,0,1000,913,87,0.913,0.087
787373389820399616,1,751,47,704,0.06258322237017311,0.9374167776298269
821443574046728192,0,397,394,3,0.9924433249370277,0.007556675062972292
314902493,1,263,22,241,0.08365019011406843,0.9163498098859315
836899585,0,1000,998,2,0.998,0.002
858827054825046016,1,206,30,176,0.14563106796116504,0.8543689320388349
481494408,0,1000,991,9,0.991,0.009
1100564902035578882,1,388,32,356,0.08247422680412371,0.9175257731958762
1435277770104262659,0,127,126,1,0.9921259842519685,0.007874015748031496
351268208,1,1000,42,958,0.042,0.958
1337634542,0,1000,727,273,0.727,0.273
54744255,1,212,33,179,0.15566037735849056,0.8443396226415094
1328763361471967232,0,65,65,0,1.0,0.0
836969381703864320,1,86,8,78,0.09302325581395349,0.9069767441860465
4882904758,0,289,286,3,0.9896193771626297,0.010380622837370242
4092766393,1,1000,54,946,0.054,0.946
370437540,0,135,135,0,1.0,0.0
234975323,1,1000,90,910,0.09,0.91
1421209467492917250,0,710,694,16,0.9774647887323944,0.022535211267605635
1142440227786678273,1,999,140,859,0.14014014014014015,0.8598598598598599
118307989,0,66,66,0,1.0,0.0
2352572952,1,364,23,341,0.06318681318681318,0.9368131868131868
4550891941,0,832,828,4,0.9951923076923077,0.004807692307692308
979430964882423808,1,616,133,483,0.2159090909090909,0.7840909090909091
1161775784916410371,0,176,176,0,1.0,0.0
1004091420678897664,1,176,13,163,0.07386363636363637,0.9261363636363636
1357985241982509058,0,667,663,4,0.9940029985007496,0.005997001499250375
28283907,1,751,201,550,0.26764314247669774,0.7323568575233023
174857130,0,505,503,2,0.996039603960396,0.0039603960396039604
532860102,1,486,130,356,0.2674897119341564,0.7325102880658436
4109020934,0,920,919,1,0.9989130434782608,0.0010869565217391304
18113347,1,713,253,460,0.3548387096774194,0.6451612903225806
150441783,0,941,937,4,0.9957492029755579,0.004250797024442083
1062435300075597827,1,325,10,315,0.03076923076923077,0.9692307692307692
948858196877348865,0,50,47,3,0.94,0.06
1126173764201451520,1,75,14,61,0.18666666666666668,0.8133333333333334
1497345202150903812,0,22,22,0,1.0,0.0
950577775974297600,1,356,151,205,0.4241573033707865,0.5758426966292135
1461513116223565824,0,132,126,6,0.9545454545454546,0.045454545454545456
197548906,1,445,51,394,0.1146067415730337,0.8853932584269663
946480184760389632,0,1000,968,32,0.968,0.032
1411471755609317377,1,23,2,21,0.08695652173913043,0.9130434782608695
2214359314,0,1000,972,28,0.972,0.028
2678260008,1,1000,228,772,0.228,0.772
933980445255065602,0,1000,991,9,0.991,0.009
3054168524,1,457,112,345,0.24507658643326038,0.7549234135667396
1203742431725989888,0,843,843,0,1.0,0.0
1052023219757051904,1,653,71,582,0.10872894333843798,0.891271056661562
4292642895,0,656,608,48,0.926829268292683,0.07317073170731707
3379565435,1,102,3,99,0.029411764705882353,0.9705882352941176
1477835909596860422,0,983,960,23,0.9766022380467956,0.023397761953204477
2402164562,1,1000,156,844,0.156,0.844
138242478,0,472,452,20,0.9576271186440678,0.0423728813559322
2209354132,1,511,76,435,0.1487279843444227,0.8512720156555773
1131003750041214978,0,3,3,0,1.0,0.0
14465541,1,1000,127,873,0.127,0.873
2796339044,0,1000,1000,0,1.0,0.0
1158181196465102849,1,105,34,71,0.3238095238095238,0.6761904761904762
2495373469,0,381,379,2,0.994750656167979,0.005249343832020997
521476047,1,382,12,370,0.031413612565445025,0.9685863874345549
1455153977272774663,0,177,177,0,1.0,0.0
2861736940,1,1000,179,821,0.179,0.821
3307520411,0,453,439,14,0.9690949227373068,0.03090507726269316
1387865507299201029,1,891,286,605,0.32098765432098764,0.6790123456790124
2399022816,0,912,908,4,0.9956140350877193,0.0043859649122807015
753096588592091141,1,1000,234,766,0.234,0.766
822104797704757248,0,193,192,1,0.9948186528497409,0.0051813471502590676
131273745,1,1000,48,952,0.048,0.952
1315089709937422338,0,1000,1000,0,1.0,0.0
1000021907452948480,1,946,41,905,0.04334038054968287,0.9566596194503171
222101365,0,1000,996,4,0.996,0.004
995836015343353856,1,237,19,218,0.08016877637130802,0.919831223628692
1497006487700398080,0,68,63,5,0.9264705882352942,0.07352941176470588
734953659461570560,1,1000,266,734,0.266,0.734
1537155122639228928,0,1000,930,70,0.93,0.07
2823106050,1,331,65,266,0.19637462235649547,0.8036253776435045
2261743321,0,1000,991,9,0.991,0.009
56606936,1,319,32,287,0.10031347962382445,0.8996865203761756
4466708549,0,912,895,17,0.981359649122807,0.01864035087719298
713910805,1,262,14,248,0.05343511450381679,0.9465648854961832
1051589893,1,194,39,155,0.20103092783505155,0.7989690721649485
994708806587183109,0,1000,762,238,0.762,0.238
803212488942751744,1,417,20,397,0.047961630695443645,0.9520383693045563
622094947,0,463,457,6,0.9870410367170627,0.012958963282937365
59534878,1,1000,61,939,0.061,0.939
374598930,0,1000,973,27,0.973,0.027
17953559,1,373,47,326,0.1260053619302949,0.8739946380697051
157465167,0,733,731,2,0.9972714870395635,0.002728512960436562
789573929803186176,1,281,14,267,0.0498220640569395,0.9501779359430605
1247730812230881282,0,56,56,0,1.0,0.0
36217007,1,649,46,603,0.07087827426810478,0.9291217257318952
24837381,0,326,320,6,0.9815950920245399,0.018404907975460124
2321210755,1,1000,130,870,0.13,0.87
905977236393742336,0,84,84,0,1.0,0.0
39137407,1,1000,32,968,0.032,0.968
193880897,0,1000,985,15,0.985,0.015
1192311877792960512,1,497,106,391,0.21327967806841047,0.7867203219315896
1028255405263204352,0,2,1,1,0.5,0.5
1340082892156891138,1,528,127,401,0.24053030303030304,0.759469696969697
231123342,0,300,298,2,0.9933333333333333,0.006666666666666667
14849958,1,1000,198,802,0.198,0.802
965080208914214912,0,23,23,0,1.0,0.0
1281086360317648896,1,203,24,179,0.11822660098522167,0.8817733990147784
775677191728271360,0,216,216,0,1.0,0.0
996039625889275905,1,290,61,229,0.2103448275862069,0.7896551724137931
418366918,0,306,304,2,0.9934640522875817,0.006535947712418301
49074319,1,1000,168,832,0.168,0.832
1557121201,0,1000,999,1,0.999,0.001
14592636,1,108,11,97,0.10185185185185185,0.8981481481481481
139554380,0,340,337,3,0.9911764705882353,0.008823529411764706
2727188352,1,350,23,327,0.06571428571428571,0.9342857142857143
714655979762282497,0,63,62,1,0.9841269841269841,0.015873015873015872
121585690,1,275,30,245,0.10909090909090909,0.8909090909090909
35730248,0,670,645,25,0.9626865671641791,0.03731343283582089
1050544457165225985,1,78,8,70,0.10256410256410256,0.8974358974358975
3041276505,0,176,170,6,0.9659090909090909,0.03409090909090909
1541318397564452864,1,215,2,213,0.009302325581395349,0.9906976744186047
3240008393,0,201,201,0,1.0,0.0
375760346,1,211,13,198,0.061611374407582936,0.9383886255924171
455377205,0,1000,986,14,0.986,0.014
2866011039,0,820,788,32,0.9609756097560975,0.03902439024390244
197369708,1,752,142,610,0.18882978723404256,0.8111702127659575
1256186122062958592,0,257,257,0,1.0,0.0
2473424053,1,897,30,867,0.033444816053511704,0.9665551839464883
3400086748,0,237,234,3,0.9873417721518988,0.012658227848101266
2220276559,1,1000,22,978,0.022,0.978
1041960185579761665,0,163,137,26,0.8404907975460123,0.15950920245398773
1452492326119657478,1,299,37,262,0.12374581939799331,0.8762541806020067
904215791062712320,1,397,38,359,0.09571788413098237,0.9042821158690176
164729502,0,342,342,0,1.0,0.0
1064670182126297088,1,483,88,395,0.18219461697722567,0.8178053830227743
211370584,0,72,72,0,1.0,0.0
3072364874,1,256,16,240,0.0625,0.9375
556289916,0,329,324,5,0.9848024316109423,0.015197568389057751
996528873700409345,1,113,11,102,0.09734513274336283,0.9026548672566371
1417224847948763137,0,69,69,0,1.0,0.0
267707212,1,916,125,791,0.13646288209606988,0.8635371179039302
1316157382909743107,0,210,183,27,0.8714285714285714,0.12857142857142856
263001924,1,398,41,357,0.10301507537688442,0.8969849246231156
1136693027500638209,0,483,478,5,0.989648033126294,0.010351966873706004
316080897,1,688,14,674,0.020348837209302327,0.9796511627906976
1277669551623282688,0,1,1,0,1.0,0.0
1070556380002607104,1,693,166,527,0.23953823953823955,0.7604617604617605
95983051,0,749,747,2,0.9973297730307076,0.0026702269692923898
47269446,1,320,73,247,0.228125,0.771875
321872696,0,679,677,2,0.9970544918998527,0.0029455081001472753
812171815,1,889,273,616,0.30708661417322836,0.6929133858267716
111151730,0,120,120,0,1.0,0.0
33448971,1,1000,224,776,0.224,0.776
921754502407041026,0,75,75,0,1.0,0.0
4880042884,1,168,36,132,0.21428571428571427,0.7857142857142857
1447702329852145668,0,47,46,1,0.9787234042553191,0.02127659574468085
148110018,1,450,109,341,0.24222222222222223,0.7577777777777778
198165193,0,384,369,15,0.9609375,0.0390625
1367976276825432066,1,410,44,366,0.1073170731707317,0.8926829268292683
1421919249577168899,0,1000,774,226,0.774,0.226
370431785,1,1000,121,879,0.121,0.879
1569803304,0,245,245,0,1.0,0.0
892846741971542016,1,406,42,364,0.10344827586206896,0.896551724137931
1107527217632948226,0,266,248,18,0.9323308270676691,0.06766917293233082
1407156277416017922,1,251,20,231,0.0796812749003984,0.9203187250996016
1432410102565330946,0,14,14,0,1.0,0.0
831118357663449089,1,369,93,276,0.25203252032520324,0.7479674796747967
1361112588755496967,0,172,160,12,0.9302325581395349,0.06976744186046512
968887754456293376,1,611,171,440,0.27986906710310966,0.7201309328968903
875789397085573121,0,494,491,3,0.9939271255060729,0.006072874493927126
1508790397,1,1000,129,871,0.129,0.871
203940998,0,151,147,4,0.9735099337748344,0.026490066225165563
55609682,1,270,36,234,0.13333333333333333,0.8666666666666667
1218282778200084480,0,924,864,60,0.935064935064935,0.06493506493506493
309731097,1,1000,233,767,0.233,0.767
1345784431118868486,0,282,274,8,0.9716312056737588,0.028368794326241134
741338586100928512,1,468,75,393,0.16025641025641027,0.8397435897435898
1400228949058326530,0,880,854,26,0.9704545454545455,0.029545454545454545
173034983,1,1000,34,966,0.034,0.966
1404501324784443401,0,75,74,1,0.9866666666666667,0.013333333333333334
1513374054249603077,1,602,55,547,0.09136212624584718,0.9086378737541528
56000815,0,130,130,0,1.0,0.0
15013405,1,1000,216,784,0.216,0.784
708055968,0,365,365,0,1.0,0.0
730936528982024193,1,1000,318,682,0.318,0.682
1453411354472222725,0,1000,977,23,0.977,0.023
768669673621557249,1,582,71,511,0.12199312714776632,0.8780068728522337
1402443070507978760,0,99,99,0,1.0,0.0
82319961,0,1000,995,5,0.995,0.005
2290557818,1,624,20,604,0.03205128205128205,0.967948717948718
221191387,0,370,368,2,0.9945945945945946,0.005405405405405406
1520043224404054016,1,163,50,113,0.3067484662576687,0.6932515337423313
3249275141,0,56,50,6,0.8928571428571429,0.10714285714285714
1435083606603415555,1,1000,263,737,0.263,0.737
2242314521,0,346,346,0,1.0,0.0
1068015137376747521,1,1000,284,716,0.284,0.716
1676081581,0,562,555,7,0.9875444839857651,0.012455516014234875
853561418,1,1000,229,771,0.229,0.771
1024802656341110784,0,341,339,2,0.9941348973607038,0.005865102639296188
772947342471356416,1,214,21,193,0.09813084112149532,0.9018691588785047
24616605,0,464,463,1,0.9978448275862069,0.0021551724137931034
1032393750310477825,1,228,22,206,0.09649122807017543,0.9035087719298246
759881703632605184,0,1000,995,5,0.995,0.005
938827686377598976,1,89,8,81,0.0898876404494382,0.9101123595505618
1473532122325524480,0,46,46,0,1.0,0.0
30620619,1,136,35,101,0.25735294117647056,0.7426470588235294
731531983852077057,0,19,19,0,1.0,0.0
181945481,1,1000,169,831,0.169,0.831
2384676188,0,1000,962,38,0.962,0.038
932366358964264960,1,26,6,20,0.23076923076923078,0.7692307692307693
1359954641920884738,0,25,24,1,0.96,0.04
761354906074624001,1,346,124,222,0.3583815028901734,0.6416184971098265
895059129240215552,0,53,53,0,1.0,0.0
9650732,1,324,55,269,0.1697530864197531,0.8302469135802469
930696890563420161,0,1000,997,3,0.997,0.003
965345964126035969,1,369,61,308,0.16531165311653118,0.8346883468834688
634037352,0,258,258,0,1.0,0.0
525723134,1,278,62,216,0.22302158273381295,0.7769784172661871
1256768623361867782,0,455,454,1,0.9978021978021978,0.002197802197802198
177730460,1,1000,24,976,0.024,0.976
2823484158,0,370,366,4,0.9891891891891892,0.010810810810810811
795813652318273537,0,511,511,0,1.0,0.0
1249067339372527617,0,47,46,1,0.9787234042553191,0.02127659574468085
3198059238,1,999,123,876,0.12312312312312312,0.8768768768768769
2288055151,0,1000,970,30,0.97,0.03
3235689446,1,385,20,365,0.05194805194805195,0.948051948051948
1195519014778347522,0,139,139,0,1.0,0.0
62994795,1,410,34,376,0.08292682926829269,0.9170731707317074
3771613103,0,271,217,54,0.8007380073800738,0.1992619926199262
1350315995626434560,1,38,10,28,0.2631578947368421,0.7368421052631579
1426276538975100930,0,1000,947,53,0.947,0.053
550189789,1,408,100,308,0.24509803921568626,0.7549019607843137
19366549,0,116,107,9,0.9224137931034483,0.07758620689655173
100529379,1,229,14,215,0.0611353711790393,0.9388646288209607
1266197894161412096,0,109,106,3,0.9724770642201835,0.027522935779816515
2615074357,1,60,12,48,0.2,0.8
491740679,0,532,528,4,0.9924812030075187,0.007518796992481203
121291297,1,1000,199,801,0.199,0.801
1145020009950797824,0,1000,995,5,0.995,0.005
2839276745,1,962,74,888,0.07692307692307693,0.9230769230769231
790566470652747776,0,3,3,0,1.0,0.0
1275562326930964482,1,526,168,358,0.3193916349809886,0.6806083650190115
2350491252,0,1000,985,15,0.985,0.015
1081973756388691968,1,1000,227,773,0.227,0.773
105240114,1,1000,187,813,0.187,0.813
2169483632,0,997,835,162,0.8375125376128385,0.1624874623871615
1331951832495636482,1,701,65,636,0.09272467902995721,0.9072753209700428
1071418207498571776,0,183,170,13,0.9289617486338798,0.07103825136612021
1403948584597430275,1,1000,103,897,0.103,0.897
812807421932421120,0,61,59,2,0.9672131147540983,0.03278688524590164
4167539782,1,168,20,148,0.11904761904761904,0.8809523809523809
863534063264555009,0,528,524,4,0.9924242424242424,0.007575757575757576
22883622,1,1000,150,850,0.15,0.85
1355286419669975045,0,105,105,0,1.0,0.0
829175346788450306,1,161,19,142,0.11801242236024845,0.8819875776397516
1035714298771697664,0,81,80,1,0.9876543209876543,0.012345679012345678
882750520687026176,1,877,76,801,0.08665906499429875,0.9133409350057012
234487487,0,651,593,58,0.9109062980030722,0.0890937019969278
173242362,1,303,97,206,0.3201320132013201,0.6798679867986799
1472406909055639553,0,22,22,0,1.0,0.0
1409323026,1,388,45,343,0.11597938144329897,0.884020618556701
56966164,0,199,188,11,0.9447236180904522,0.05527638190954774
1445236642290221057,1,185,40,145,0.21621621621621623,0.7837837837837838
472411566,0,1000,992,8,0.992,0.008
1483429328817999878,1,183,13,170,0.07103825136612021,0.9289617486338798
990572197537345537,0,60,59,1,0.9833333333333333,0.016666666666666666
1090247697263669248,1,83,23,60,0.27710843373493976,0.7228915662650602
20933139,0,946,887,59,0.9376321353065539,0.06236786469344609
2977975420,1,154,6,148,0.03896103896103896,0.961038961038961
1182850044275445760,0,44,43,1,0.9772727272727273,0.022727272727272728
4352209634,1,184,9,175,0.04891304347826087,0.9510869565217391
1032638716840435712,0,132,116,16,0.8787878787878788,0.12121212121212122
481919352,1,282,39,243,0.13829787234042554,0.8617021276595744
1366136441835712513,0,431,427,4,0.9907192575406032,0.009280742459396751
1124420749375234053,1,152,14,138,0.09210526315789473,0.9078947368421053
107493748,0,753,743,10,0.9867197875166003,0.013280212483399735
56002305,1,1000,29,971,0.029,0.971
95293726,0,244,243,1,0.9959016393442623,0.004098360655737705
958107513391669255,1,66,20,46,0.30303030303030304,0.696969696969697
1479897220841451521,0,92,91,1,0.9891304347826086,0.010869565217391304
2752190295,1,850,174,676,0.20470588235294118,0.7952941176470588
872305590441213953,0,1000,996,4,0.996,0.004
1523430378,1,287,39,248,0.13588850174216027,0.8641114982578397
1471743854059540483,0,118,111,7,0.940677966101695,0.059322033898305086
14940761,0,1000,994,6,0.994,0.006
1548349573,1,941,90,851,0.09564293304994687,0.9043570669500531
318735315,0,136,134,2,0.9852941176470589,0.014705882352941176
750383245989117952,1,63,9,54,0.14285714285714285,0.8571428571428571
1413179152908251141,0,221,220,1,0.995475113122172,0.004524886877828055
1270535935990681603,1,1000,272,728,0.272,0.728
285344206,0,190,190,0,1.0,0.0
43019793,1,1000,205,795,0.205,0.795
50496958,0,696,694,2,0.9971264367816092,0.0028735632183908046
834073394115133442,1,319,7,312,0.0219435736677116,0.9780564263322884
1399795897471574017,0,1000,996,4,0.996,0.004
1033157102,1,859,76,783,0.08847497089639116,0.9115250291036089
19543277,0,1000,979,21,0.979,0.021
1023413306340659200,1,1000,126,874,0.126,0.874
387964917,0,162,156,6,0.9629629629629629,0.037037037037037035
1297233267083677696,1,804,106,698,0.1318407960199005,0.8681592039800995
1081570905422221312,0,107,107,0,1.0,0.0
1333098279110922240,1,318,72,246,0.22641509433962265,0.7735849056603774
908239156056379392,0,283,283,0,1.0,0.0
91269241,1,167,4,163,0.023952095808383235,0.9760479041916168
21040084,0,1000,965,35,0.965,0.035
2888689414,1,739,66,673,0.08930987821380243,0.9106901217861976
1018023948,0,423,388,35,0.91725768321513,0.08274231678486997
153168449,1,1000,167,833,0.167,0.833
868111131562303490,0,455,444,11,0.9758241758241758,0.024175824175824177
1256383960478658560,1,123,44,79,0.35772357723577236,0.6422764227642277
164396247,0,305,305,0,1.0,0.0
2869331888,1,513,20,493,0.03898635477582846,0.9610136452241715
65619987,0,1000,942,58,0.942,0.058
15377878,1,295,33,262,0.11186440677966102,0.888135593220339
1074686637530144769,0,708,697,11,0.9844632768361582,0.015536723163841809
2490460837,1,310,8,302,0.025806451612903226,0.9741935483870968
1049138906191593473,0,441,437,4,0.9909297052154195,0.009070294784580499
1199195269,1,456,102,354,0.2236842105263158,0.7763157894736842
10399172,0,1000,846,154,0.846,0.154
1243144031829397506,1,43,12,31,0.27906976744186046,0.7209302325581395
3141437566,0,143,143,0,1.0,0.0
2345826411,1,1000,16,984,0.016,0.984
54778608,0,265,263,2,0.9924528301886792,0.007547169811320755
1169717818604044289,1,1000,141,859,0.141,0.859
2745625529,0,1000,998,2,0.998,0.002
900303757447241728,1,229,45,184,0.1965065502183406,0.8034934497816594
1383187308669669380,0,85,85,0,1.0,0.0
994571204722864130,1,54,4,50,0.07407407407407407,0.9259259259259259
1328840197635592192,0,132,132,0,1.0,0.0
1034536291961065473,1,1000,174,826,0.174,0.826
1266847535123107841,0,1000,993,7,0.993,0.007
969570897123307520,1,1000,125,875,0.125,0.875
1252635968651354115,0,112,112,0,1.0,0.0
1653690498,0,1000,969,31,0.969,0.031
773715179762806784,0,122,122,0,1.0,0.0
815297159352315904,1,397,72,325,0.181360201511335,0.818639798488665
43218257,0,318,318,0,1.0,0.0
707825269143420930,1,192,26,166,0.13541666666666666,0.8645833333333334
861780425571741697,0,209,204,5,0.9760765550239234,0.023923444976076555
1460329381830746123,1,88,7,81,0.07954545454545454,0.9204545454545454
1466308668685750274,0,42,41,1,0.9761904761904762,0.023809523809523808
854196189733855232,1,572,56,516,0.0979020979020979,0.9020979020979021
898350914796478464,0,321,317,4,0.9875389408099688,0.012461059190031152
963201481217228800,1,665,142,523,0.21353383458646616,0.7864661654135339
839295780934545408,0,1000,997,3,0.997,0.003
6389182,1,422,46,376,0.10900473933649289,0.8909952606635071
1049110415194644481,0,1000,998,2,0.998,0.002
20875791,1,416,93,323,0.22355769230769232,0.7764423076923077
2394482574,0,868,813,55,0.9366359447004609,0.06336405529953917
545330657,1,303,28,275,0.0924092409240924,0.9075907590759076
1183609916357054465,0,291,281,10,0.9656357388316151,0.03436426116838488
1261087794,1,229,16,213,0.06986899563318777,0.9301310043668122
1280251282096304131,0,1000,933,67,0.933,0.067
1496917675120943106,1,75,5,70,0.06666666666666667,0.9333333333333333
1522744600372334592,0,516,510,6,0.9883720930232558,0.011627906976744186
801972152,1,515,33,482,0.06407766990291262,0.9359223300970874
1049731589511553026,0,235,235,0,1.0,0.0
3294337892,1,230,32,198,0.1391304347826087,0.8608695652173913
1468834097879519236,0,1000,998,2,0.998,0.002
130017324,1,1000,200,800,0.2,0.8
107220654,0,750,737,13,0.9826666666666667,0.017333333333333333
70212972,1,334,7,327,0.020958083832335328,0.9790419161676647
103669241,0,1000,1000,0,1.0,0.0
3181157384,1,1000,126,874,0.126,0.874
1078367500423843841,0,696,594,102,0.853448275862069,0.14655172413793102
339788038,1,838,288,550,0.3436754176610978,0.6563245823389021
892666645705052160,0,545,544,1,0.998165137614679,0.001834862385321101
790336603734548481,1,112,30,82,0.26785714285714285,0.7321428571428571
920405629969338368,0,100,100,0,1.0,0.0
937672062,1,791,100,691,0.1264222503160556,0.8735777496839444
1131985017415118848,0,647,640,7,0.9891808346213292,0.010819165378670788
876305266043531264,1,368,48,320,0.13043478260869565,0.8695652173913043
1473962717971202051,0,62,62,0,1.0,0.0
1029128166470762497,1,140,15,125,0.10714285714285714,0.8928571428571429
1534716947765547008,0,412,401,11,0.9733009708737864,0.02669902912621359
2897638783,1,1000,285,715,0.285,0.715
1453744845680304142,0,182,181,1,0.9945054945054945,0.005494505494505495
133577240,1,1000,60,940,0.06,0.94
769299135388418048,0,564,549,15,0.973404255319149,0.026595744680851064
1539706041470001154,1,75,1,74,0.013333333333333334,0.9866666666666667
870808802,0,358,330,28,0.9217877094972067,0.0782122905027933
1529633865647669249,1,115,13,102,0.11304347826086956,0.8869565217391304
1334722090377875457,0,14,14,0,1.0,0.0
1193704881023901696,1,283,70,213,0.24734982332155478,0.7526501766784452
1476150757581737984,0,35,35,0,1.0,0.0
1185821,1,1000,93,907,0.093,0.907
1258115828,0,408,398,10,0.9754901960784313,0.024509803921568627
1540543120688852992,0,388,386,2,0.9948453608247423,0.005154639175257732
1280488628364308480,1,1000,126,874,0.126,0.874
2720760288,0,184,184,0,1.0,0.0
723304084753752064,1,1000,208,792,0.208,0.792
26441012,0,685,632,53,0.9226277372262773,0.07737226277372262
1083554082466549762,1,452,29,423,0.06415929203539823,0.9358407079646017
1275952926083686406,0,291,291,0,1.0,0.0
1430726767,1,711,86,625,0.1209563994374121,0.8790436005625879
1347210982624473092,0,2,2,0,1.0,0.0
3685687152,0,164,164,0,1.0,0.0
1364637219483451395,1,807,303,504,0.3754646840148699,0.6245353159851301
3039626092,0,682,660,22,0.967741935483871,0.03225806451612903
394263537,1,1000,142,858,0.142,0.858
3081902086,0,112,111,1,0.9910714285714286,0.008928571428571428
2159352529,1,569,74,495,0.13005272407732865,0.8699472759226714
3368435967,0,706,682,24,0.9660056657223796,0.0339943342776204
423804392,1,698,143,555,0.20487106017191978,0.7951289398280802
360873063,0,38,38,0,1.0,0.0
1385265620447600642,1,1000,161,839,0.161,0.839
2355488882,0,1000,999,1,0.999,0.001
1664212986,1,265,10,255,0.03773584905660377,0.9622641509433962
151238451,0,1000,997,3,0.997,0.003
636703298,1,941,274,667,0.2911795961742827,0.7088204038257173
777677336661614592,0,278,275,3,0.9892086330935251,0.01079136690647482
3303851497,1,1000,75,925,0.075,0.925
991337041387577344,0,346,329,17,0.9508670520231214,0.049132947976878616
495221330,1,1000,203,797,0.203,0.797
762294758,0,193,192,1,0.9948186528497409,0.0051813471502590676
2740990491,1,731,63,668,0.08618331053351573,0.9138166894664843
1060396787226329088,0,74,72,2,0.972972972972973,0.02702702702702703
1222961655472148484,1,27,3,24,0.1111111111111111,0.8888888888888888
1232155433835618305,0,7,7,0,1.0,0.0
26097224,1,1000,78,922,0.078,0.922
2911901047,0,369,367,2,0.994579945799458,0.005420054200542005
1213524533686128640,1,1000,225,775,0.225,0.775
1418548113674051588,0,48,45,3,0.9375,0.0625
1173987175786061824,1,843,41,802,0.04863582443653618,0.9513641755634639
1494795211754676227,0,22,22,0,1.0,0.0
20492698,1,560,23,537,0.04107142857142857,0.9589285714285715
966802608,0,749,693,56,0.9252336448598131,0.07476635514018691
6096912,1,39,5,34,0.1282051282051282,0.8717948717948718
280255353,0,1000,986,14,0.986,0.014
1151755686998679552,1,32,7,25,0.21875,0.78125
1577219084,0,220,220,0,1.0,0.0
285447621,1,359,18,341,0.05013927576601671,0.9498607242339833
3171423794,0,285,284,1,0.9964912280701754,0.0035087719298245615
1225184593009106946,1,736,47,689,0.06385869565217392,0.936141304347826
1269037025853726720,0,828,827,1,0.998792270531401,0.0012077294685990338
2521561446,1,783,55,728,0.070242656449553,0.929757343550447
1202030976827703303,0,302,297,5,0.9834437086092715,0.016556291390728478
875002035166474240,1,622,107,515,0.1720257234726688,0.8279742765273312
738424954081841153,1,454,73,381,0.16079295154185022,0.8392070484581498
1334379646960291840,0,145,145,0,1.0,0.0
1364001969380204551,1,113,28,85,0.24778761061946902,0.7522123893805309
2324927070,0,234,232,2,0.9914529914529915,0.008547008547008548
1421180220451606532,1,407,16,391,0.03931203931203931,0.9606879606879607
1448548515806736384,0,46,44,2,0.9565217391304348,0.043478260869565216
42741720,0,133,133,0,1.0,0.0
25905774,1,1000,80,920,0.08,0.92
1264718814530252800,0,15,15,0,1.0,0.0
753461494524833792,1,1000,50,950,0.05,0.95
338145806,0,167,165,2,0.9880239520958084,0.011976047904191617
3873315552,1,111,37,74,0.3333333333333333,0.6666666666666666
4720813934,0,228,200,28,0.8771929824561403,0.12280701754385964
16955750,1,1000,187,813,0.187,0.813
978243691671441408,0,113,113,0,1.0,0.0
823033540015259648,1,1000,65,935,0.065,0.935
973306848,0,71,70,1,0.9859154929577465,0.014084507042253521
786955297843798016,1,173,21,152,0.12138728323699421,0.8786127167630058
2710217520,0,424,367,57,0.8655660377358491,0.13443396226415094
485312210,1,523,63,460,0.12045889101338432,0.8795411089866156
590366367,0,717,715,2,0.99721059972106,0.002789400278940028
1207977070875283456,1,364,34,330,0.09340659340659341,0.9065934065934066
1150886745325654019,0,621,621,0,1.0,0.0
22374503,1,874,127,747,0.14530892448512586,0.8546910755148741
35455261,1,567,124,443,0.21869488536155202,0.781305114638448
1486090041852325888,0,11,10,1,0.9090909090909091,0.09090909090909091
223032241,1,372,56,316,0.15053763440860216,0.8494623655913979
244405894,0,999,982,17,0.982982982982983,0.01701701701701702
1104514089219325952,1,505,93,412,0.18415841584158416,0.8158415841584158
1286705567269085186,0,107,105,2,0.9813084112149533,0.018691588785046728
30528507,1,1000,34,966,0.034,0.966
993342628883185665,0,251,247,4,0.9840637450199203,0.01593625498007968
2947296641,1,860,34,826,0.03953488372093023,0.9604651162790697
2408124216,0,1000,988,12,0.988,0.012
1935472784,1,483,48,435,0.09937888198757763,0.9006211180124224
1310650754655543296,0,708,664,44,0.9378531073446328,0.062146892655367235
3219693205,1,1000,161,839,0.161,0.839
133194880,0,487,465,22,0.9548254620123203,0.045174537987679675
3336178967,1,1000,113,887,0.113,0.887
3072319776,0,513,511,2,0.9961013645224172,0.003898635477582846
1443222721085775883,1,17,2,15,0.11764705882352941,0.8823529411764706
1500219946105810945,0,874,873,1,0.9988558352402745,0.0011441647597254005
3352475483,1,1000,115,885,0.115,0.885
1195454734729134087,0,103,103,0,1.0,0.0
1240598400694919174,0,99,99,0,1.0,0.0
225047823,1,165,25,140,0.15151515151515152,0.8484848484848485
138182773,0,515,513,2,0.996116504854369,0.003883495145631068
1362192672119615493,1,1000,42,958,0.042,0.958
1002368427175153670,0,622,588,34,0.9453376205787781,0.05466237942122187
1873418989,1,311,27,284,0.08681672025723473,0.9131832797427653
1264030915010928640,0,419,418,1,0.9976133651551312,0.002386634844868735
1036141586,1,472,38,434,0.08050847457627118,0.9194915254237288
3271476050,0,205,201,4,0.9804878048780488,0.01951219512195122
738963785612812288,1,136,22,114,0.16176470588235295,0.8382352941176471
1037675018065461249,0,207,205,2,0.9903381642512077,0.00966183574879227
15805527,1,746,43,703,0.057640750670241284,0.9423592493297587
188181519,0,633,632,1,0.9984202211690363,0.001579778830963665
1013153537776345089,1,447,28,419,0.06263982102908278,0.9373601789709173
1248249725557583873,0,165,164,1,0.9939393939393939,0.006060606060606061
257492391,1,605,27,578,0.04462809917355372,0.9553719008264463
1119869846240419841,0,103,102,1,0.9902912621359223,0.009708737864077669
801383051301359616,1,469,41,428,0.08742004264392324,0.9125799573560768
52411193,0,1000,996,4,0.996,0.004
1446681931916226561,1,101,9,92,0.0891089108910891,0.9108910891089109
3259513424,0,1000,998,2,0.998,0.002
824068048348999680,1,195,40,155,0.20512820512820512,0.7948717948717948
139250227,0,882,874,8,0.9909297052154195,0.009070294784580499
19828645,1,882,105,777,0.11904761904761904,0.8809523809523809
866814643033047040,0,107,106,1,0.9906542056074766,0.009345794392523364
21801309,1,401,163,238,0.40648379052369077,0.5935162094763092
1281960889495805952,0,999,994,5,0.994994994994995,0.005005005005005005
1339985083067973634,1,1000,112,888,0.112,0.888
18820735,0,595,591,4,0.9932773109243698,0.0067226890756302525
1037452660159520768,1,1000,176,824,0.176,0.824
192691760,0,486,476,10,0.9794238683127572,0.0205761316872428
858119868801069056,1,527,4,523,0.007590132827324478,0.9924098671726755
771822683168337920,0,4,4,0,1.0,0.0
822618843239645186,1,89,12,77,0.1348314606741573,0.8651685393258427
1083324246217109504,0,138,131,7,0.9492753623188406,0.050724637681159424
1184461027695611905,1,1000,373,627,0.373,0.627
1090260556395827200,0,780,760,20,0.9743589743589743,0.02564102564102564
769715615288270848,1,411,33,378,0.08029197080291971,0.9197080291970803
127360014,0,221,218,3,0.9864253393665159,0.013574660633484163
1489501155810029568,0,115,115,0,1.0,0.0
1358939174670389250,1,77,19,58,0.24675324675324675,0.7532467532467533
3838504100,0,488,488,0,1.0,0.0
3288224432,1,373,42,331,0.1126005361930295,0.8873994638069705
1098824386306588672,0,843,842,1,0.9988137603795967,0.0011862396204033216
15828634,1,370,29,341,0.07837837837837838,0.9216216216216216
94742026,0,272,259,13,0.9522058823529411,0.04779411764705882
881594270716747776,1,275,61,214,0.22181818181818183,0.7781818181818182
32507761,0,373,359,14,0.9624664879356568,0.03753351206434316
1394023584079794182,1,89,13,76,0.14606741573033707,0.8539325842696629
19978417,0,430,376,54,0.8744186046511628,0.12558139534883722
941161390533947393,1,1000,248,752,0.248,0.752
1362935827244941314,0,97,96,1,0.9896907216494846,0.010309278350515464
1208439126334283776,1,31,5,26,0.16129032258064516,0.8387096774193549
3319614392,0,1000,868,132,0.868,0.132
735402450,0,424,424,0,1.0,0.0
98519454,1,601,75,526,0.12479201331114809,0.8752079866888519
386333936,0,999,987,12,0.987987987987988,0.012012012012012012
1131050457663721472,0,949,901,48,0.9494204425711275,0.0505795574288725
1524276100167348225,1,79,14,65,0.17721518987341772,0.8227848101265823
1051330118168195072,0,359,350,9,0.9749303621169917,0.025069637883008356
17169613,1,1000,218,782,0.218,0.782
1480699438314180614,0,1000,992,8,0.992,0.008
1429187093532708867,1,195,63,132,0.3230769230769231,0.676923076923077
332588379,0,981,977,4,0.9959225280326198,0.004077471967380225
821079036319305728,1,259,14,245,0.05405405405405406,0.9459459459459459
15462348,0,1000,934,66,0.934,0.066
413177055,1,220,9,211,0.04090909090909091,0.9590909090909091
563295521,0,95,93,2,0.9789473684210527,0.021052631578947368
3433462072,1,412,81,331,0.1966019417475728,0.8033980582524272
1055891059304087553,0,216,214,2,0.9907407407407407,0.009259259259259259
2876125536,1,730,153,577,0.2095890410958904,0.7904109589041096
1122601176648884227,0,71,69,2,0.971830985915493,0.028169014084507043
1140318390910775296,1,132,31,101,0.23484848484848486,0.7651515151515151
982032424992374786,0,169,168,1,0.9940828402366864,0.005917159763313609
1418344705545277440,1,237,53,184,0.22362869198312235,0.7763713080168776
2393197850,0,218,217,1,0.9954128440366973,0.0045871559633027525
2881466011,1,176,6,170,0.03409090909090909,0.9659090909090909
863435357840302080,0,287,278,9,0.9686411149825784,0.0313588850174216
27966276,1,499,34,465,0.06813627254509018,0.9318637274549099
274766251,0,312,312,0,1.0,0.0
21733037,1,1000,216,784,0.216,0.784
954035185435250688,0,92,92,0,1.0,0.0
46945095,1,948,192,756,0.20253164556962025,0.7974683544303798
721756885645262848,0,269,263,6,0.9776951672862454,0.022304832713754646
2308882549,1,1000,69,931,0.069,0.931
835909555267710981,0,224,224,0,1.0,0.0
21463449,1,1000,78,922,0.078,0.922
1266472230541832194,0,20,20,0,1.0,0.0
757506133,1,1000,91,909,0.091,0.909
82669164,0,129,129,0,1.0,0.0
381219989,1,432,80,352,0.18518518518518517,0.8148148148148148
2343696944,0,1000,997,3,0.997,0.003
47114540,1,252,55,197,0.21825396825396826,0.7817460317460317
1011309664754167808,0,58,58,0,1.0,0.0
195409453,1,1000,197,803,0.197,0.803
5875162,0,89,86,3,0.9662921348314607,0.033707865168539325
799230582,1,781,137,644,0.17541613316261204,0.8245838668373879
1966214083,0,1000,991,9,0.991,0.009
47036828,1,178,18,160,0.10112359550561797,0.898876404494382
37375478,0,1000,980,20,0.98,0.02
1450564534528208899,1,1000,148,852,0.148,0.852
1475849648757563393,0,92,89,3,0.967391304347826,0.03260869565217391
127954353,1,550,154,396,0.28,0.72
1493226041254449154,0,537,537,0,1.0,0.0
315423867,1,1000,85,915,0.085,0.915
1102316086031249408,0,224,166,58,0.7410714285714286,0.25892857142857145
513589530,1,527,60,467,0.11385199240986717,0.8861480075901328
3316274545,0,37,36,1,0.972972972972973,0.02702702702702703
348792069,1,1000,220,780,0.22,0.78
168993471,0,171,169,2,0.9883040935672515,0.011695906432748537
389079897,1,999,227,772,0.22722722722722724,0.7727727727727728
1422925413345488896,0,530,522,8,0.9849056603773585,0.01509433962264151
852876996552138753,1,1000,39,961,0.039,0.961
1140733255244607488,0,213,213,0,1.0,0.0
185022345,1,142,16,126,0.11267605633802817,0.8873239436619719
387459994,0,294,284,10,0.9659863945578231,0.034013605442176874
856228552517332992,1,777,143,634,0.18404118404118405,0.8159588159588159
1191078462913564673,0,102,101,1,0.9901960784313726,0.00980392156862745
3752374043,0,900,865,35,0.9611111111111111,0.03888888888888889
2186395186,1,1000,138,862,0.138,0.862
65253759,0,60,60,0,1.0,0.0
627971070,1,320,27,293,0.084375,0.915625
49378634,0,741,730,11,0.9851551956815114,0.014844804318488529
284572538,0,271,271,0,1.0,0.0
1490040328233041926,1,139,13,126,0.09352517985611511,0.9064748201438849
1476067012006793219,0,4,4,0,1.0,0.0
24894281,1,1000,110,890,0.11,0.89
1300854734509744128,0,113,111,2,0.9823008849557522,0.017699115044247787
621603803,1,791,94,697,0.11883691529709228,0.8811630847029077
1222927152280109059,0,3,3,0,1.0,0.0
845766285346656256,1,454,55,399,0.1211453744493392,0.8788546255506607
1017155845765951489,0,956,948,8,0.9916317991631799,0.008368200836820083
1130248216027512844,1,477,63,414,0.1320754716981132,0.8679245283018868
1140666167700463616,0,1000,1000,0,1.0,0.0
3306440520,1,1000,221,779,0.221,0.779
1040854849854861313,0,202,201,1,0.995049504950495,0.0049504950495049506
1011807231669559296,1,192,28,164,0.14583333333333334,0.8541666666666666
1052002175315075072,0,217,216,1,0.9953917050691244,0.004608294930875576
21183966,1,1000,60,940,0.06,0.94
473461880,0,374,368,6,0.983957219251337,0.016042780748663103
828543427,1,769,111,658,0.14434330299089726,0.8556566970091027
1156019573575102464,0,72,72,0,1.0,0.0
1290326235227336704,1,208,28,180,0.1346153846153846,0.8653846153846154
72197792,0,1000,989,11,0.989,0.011
39998231,1,413,5,408,0.012106537530266344,0.9878934624697336
1500324821938413571,0,136,129,7,0.9485294117647058,0.051470588235294115
427108956,1,714,14,700,0.0196078431372549,0.9803921568627451
24362103,0,268,260,8,0.9701492537313433,0.029850746268656716
619459896,1,427,35,392,0.08196721311475409,0.9180327868852459
104958345,0,800,715,85,0.89375,0.10625
992864904116948992,1,369,102,267,0.2764227642276423,0.7235772357723578
793484708814413824,0,145,144,1,0.993103448275862,0.006896551724137931
1262240625245683716,1,28,3,25,0.10714285714285714,0.8928571428571429
1427447780482588683,0,158,158,0,1.0,0.0
15990298,1,1000,104,896,0.104,0.896
1025758532,0,1000,999,1,0.999,0.001
749067142641905665,1,1000,148,852,0.148,0.852
1321529166,0,632,630,2,0.9968354430379747,0.0031645569620253164
2357185529,1,1000,29,971,0.029,0.971
1070861938224259072,0,81,72,9,0.8888888888888888,0.1111111111111111
91695126,1,1000,366,634,0.366,0.634
900113882848604160,0,335,320,15,0.9552238805970149,0.04477611940298507
1252094307550539779,1,459,62,397,0.13507625272331156,0.8649237472766884
1297230837889597441,0,41,41,0,1.0,0.0
2789062008,1,639,51,588,0.07981220657276995,0.92018779342723
463187679,0,113,108,5,0.9557522123893806,0.04424778761061947
760221785820389376,0,1000,988,12,0.988,0.012
1414130274,1,967,86,881,0.0889348500517063,0.9110651499482937
1110924404731596801,0,368,368,0,1.0,0.0
117451999,1,1000,111,889,0.111,0.889
15382430,0,584,503,81,0.8613013698630136,0.1386986301369863
1474473020567670784,1,278,26,252,0.09352517985611511,0.9064748201438849
837062168,0,88,88,0,1.0,0.0
16493977,0,874,874,0,1.0,0.0
251746946,1,729,297,432,0.4074074074074074,0.5925925925925926
1430024598737858562,1,699,143,556,0.20457796852646637,0.7954220314735336
68321035,0,305,305,0,1.0,0.0
1027671867027599362,1,505,48,457,0.09504950495049505,0.904950495049505
2596798807,0,470,470,0,1.0,0.0
939657025147023360,1,999,183,816,0.1831831831831832,0.8168168168168168
24615356,0,101,98,3,0.9702970297029703,0.0297029702970297
1268998117698961411,1,426,29,397,0.06807511737089202,0.931924882629108
1478436320368533507,0,532,531,1,0.9981203007518797,0.0018796992481203006
746000014732722176,1,1000,182,818,0.182,0.818
975902457137172481,0,566,562,4,0.9929328621908127,0.007067137809187279
61559571,1,682,101,581,0.14809384164222875,0.8519061583577713
1255177877554974720,0,402,401,1,0.9975124378109452,0.0024875621890547263
43827775,1,1000,188,812,0.188,0.812
941632087316140033,0,1000,988,12,0.988,0.012
1025959020593594369,1,90,1,89,0.011111111111111112,0.9888888888888889
884939081007935488,0,132,131,1,0.9924242424242424,0.007575757575757576
22717143,1,1000,146,854,0.146,0.854
33777489,0,289,286,3,0.9896193771626297,0.010380622837370242
1001608158232633345,1,159,25,134,0.15723270440251572,0.8427672955974843
3330585286,0,1000,1000,0,1.0,0.0
160622878,1,1000,79,921,0.079,0.921
797839116822052865,0,1000,936,64,0.936,0.064
38043000,1,508,37,471,0.07283464566929133,0.9271653543307087
1503745259192393728,0,213,212,1,0.9953051643192489,0.004694835680751174
873260952,1,1000,59,941,0.059,0.941
372932621,0,400,380,20,0.95,0.05
29360384,1,799,97,702,0.1214017521902378,0.8785982478097623
1483426841360752642,0,42,41,1,0.9761904761904762,0.023809523809523808
1327342444631953410,1,1,0,1,0.0,1.0
2648653210,0,999,945,54,0.9459459459459459,0.05405405405405406
612792368,1,868,53,815,0.06105990783410138,0.9389400921658986
16859667,0,1000,981,19,0.981,0.019
817900465061040129,1,195,36,159,0.18461538461538463,0.8153846153846154
858686324676714496,0,1000,941,59,0.941,0.059
1433288698574086144,0,70,69,1,0.9857142857142858,0.014285714285714285
2234022275,1,125,16,109,0.128,0.872
1533591092117086208,0,105,54,51,0.5142857142857142,0.4857142857142857
1307549060677529603,1,43,1,42,0.023255813953488372,0.9767441860465116
941530160544866305,0,152,151,1,0.993421052631579,0.006578947368421052
1146244738040901634,1,1000,162,838,0.162,0.838
132666760,0,1000,974,26,0.974,0.026
1142150590572580864,1,521,7,514,0.013435700575815739,0.9865642994241842
108455155,0,1,1,0,1.0,0.0
1387391859199148032,1,929,149,780,0.1603875134553283,0.8396124865446717
1151922562328408064,0,149,149,0,1.0,0.0
778082657938710528,1,59,9,50,0.15254237288135594,0.847457627118644
1182315647541420034,0,446,428,18,0.9596412556053812,0.04035874439461883
868491957387087872,1,320,46,274,0.14375,0.85625
47470008,0,1000,966,34,0.966,0.034
3246585106,1,1000,235,765,0.235,0.765
2837329418,0,418,418,0,1.0,0.0
768872149620781056,0,999,961,38,0.9619619619619619,0.03803803803803804
132275002,1,233,15,218,0.06437768240343347,0.9356223175965666
785399735343517696,0,365,358,7,0.9808219178082191,0.019178082191780823
427144984,1,709,34,675,0.047954866008462625,0.9520451339915373
3275106019,0,470,437,33,0.9297872340425531,0.07021276595744681
767847,1,498,60,438,0.12048192771084337,0.8795180722891566
1267928184286306304,0,434,417,17,0.9608294930875576,0.03917050691244239
980002978055602176,1,117,14,103,0.11965811965811966,0.8803418803418803
1536710112,0,331,329,2,0.9939577039274925,0.006042296072507553
18967522,1,1000,53,947,0.053,0.947
1459050355195617281,0,6,6,0,1.0,0.0
589486117,1,898,182,716,0.2026726057906459,0.7973273942093542
890712532629020672,0,75,70,5,0.9333333333333333,0.06666666666666667
4082681713,1,1000,64,936,0.064,0.936
1034492771422425088,0,100,99,1,0.99,0.01
1044748572602904577,1,312,14,298,0.04487179487179487,0.9551282051282052
37230936,0,976,968,8,0.9918032786885246,0.00819672131147541
1064335890879836161,1,1000,149,851,0.149,0.851
2584189818,0,139,137,2,0.9856115107913669,0.014388489208633094
320239608,1,1000,55,945,0.055,0.945
97281917,0,1000,996,4,0.996,0.004
905233032998617089,1,509,24,485,0.047151277013752456,0.9528487229862476
825755683274502144,0,309,285,24,0.9223300970873787,0.07766990291262135
1139288867687804937,1,1000,303,697,0.303,0.697
39588132,0,1000,961,39,0.961,0.039
11336,1,634,57,577,0.08990536277602523,0.9100946372239748
1255971737864470529,0,801,793,8,0.9900124843945068,0.009987515605493134
798127853598601220,1,26,12,14,0.46153846153846156,0.5384615384615384
864764387994849282,0,925,899,26,0.9718918918918918,0.02810810810810811
549463341,1,388,57,331,0.14690721649484537,0.8530927835051546
2376412609,0,1000,806,194,0.806,0.194
1976663983,1,68,13,55,0.19117647058823528,0.8088235294117647
26054929,0,550,476,74,0.8654545454545455,0.13454545454545455
836581447,1,371,46,325,0.12398921832884097,0.876010781671159
860730680581406720,0,1000,987,13,0.987,0.013
287951373,1,175,31,144,0.17714285714285713,0.8228571428571428
947941904,0,158,156,2,0.9873417721518988,0.012658227848101266
2915093074,1,398,25,373,0.06281407035175879,0.9371859296482412
2919650738,0,239,224,15,0.9372384937238494,0.06276150627615062
1055526148157911040,1,228,46,182,0.20175438596491227,0.7982456140350878
788491759315812352,1,402,65,337,0.16169154228855723,0.8383084577114428
2421665971,0,1000,989,11,0.989,0.011
565947460,1,402,31,371,0.07711442786069651,0.9228855721393034
1309617890,0,121,107,14,0.8842975206611571,0.11570247933884298
1152852902,1,168,14,154,0.08333333333333333,0.9166666666666666
21448687,0,421,403,18,0.9572446555819477,0.04275534441805225
699253238118379520,1,696,101,595,0.14511494252873564,0.8548850574712644
385487279,0,320,316,4,0.9875,0.0125
1274851370055557120,1,1000,121,879,0.121,0.879
177866947,0,164,149,15,0.9085365853658537,0.09146341463414634
1112690784132874246,1,1000,113,887,0.113,0.887
21668307,0,460,457,3,0.9934782608695653,0.006521739130434782
130227469,1,799,46,753,0.057571964956195244,0.9424280350438048
26876293,0,871,854,17,0.9804822043628014,0.01951779563719862
993971659005612032,1,272,71,201,0.2610294117647059,0.7389705882352942
285861431,0,1000,995,5,0.995,0.005
1250576719549026305,1,234,34,200,0.1452991452991453,0.8547008547008547
982135752694808577,0,47,47,0,1.0,0.0
1494514112,1,597,30,567,0.05025125628140704,0.949748743718593
816294557025443840,0,1000,985,15,0.985,0.015
50086035,1,218,97,121,0.44495412844036697,0.555045871559633
1296567472611643399,0,178,176,2,0.9887640449438202,0.011235955056179775
1511496139111075841,1,53,14,39,0.2641509433962264,0.7358490566037735
1281661755157028864,0,48,48,0,1.0,0.0
1019387621280186368,1,119,13,106,0.1092436974789916,0.8907563025210085
1306432371546226688,0,113,88,25,0.7787610619469026,0.22123893805309736
903327568471900160,1,1000,171,829,0.171,0.829
1654673510,0,137,137,0,1.0,0.0
367806311,1,568,64,504,0.11267605633802817,0.8873239436619719
1225408960263544832,0,153,153,0,1.0,0.0
891104565726244864,1,806,78,728,0.0967741935483871,0.9032258064516129
35874258,0,767,765,2,0.9973924380704041,0.002607561929595828
492712414,1,568,46,522,0.08098591549295775,0.9190140845070423
27992778,0,186,186,0,1.0,0.0
1849224102,0,437,437,0,1.0,0.0
3225288527,1,551,145,406,0.2631578947368421,0.7368421052631579
518938002,0,1000,996,4,0.996,0.004
1223752713990619137,1,1000,278,722,0.278,0.722
1248125296739581954,0,354,354,0,1.0,0.0
419912838,1,544,34,510,0.0625,0.9375
1298916002273431552,0,304,256,48,0.8421052631578947,0.15789473684210525
2790109049,1,689,124,565,0.1799709724238026,0.8200290275761973
1330338577650229249,0,1000,976,24,0.976,0.024
767798133996879872,1,947,141,806,0.14889123548046462,0.8511087645195353
1321606839625109504,0,153,151,2,0.9869281045751634,0.013071895424836602
2271956401,1,724,73,651,0.10082872928176796,0.899171270718232
419662043,0,754,749,5,0.993368700265252,0.006631299734748011
1013690961921302528,1,96,4,92,0.041666666666666664,0.9583333333333334
2468354164,0,484,481,3,0.993801652892562,0.006198347107438017
70560884,1,736,91,645,0.12364130434782608,0.876358695652174
4394473643,0,168,168,0,1.0,0.0
2645347070,1,242,85,157,0.3512396694214876,0.6487603305785123
818844966281760768,0,67,64,3,0.9552238805970149,0.04477611940298507
42876265,1,718,39,679,0.054317548746518104,0.9456824512534819
700529957907222528,0,326,324,2,0.9938650306748467,0.006134969325153374
12857382,1,1000,111,889,0.111,0.889
480194755,0,297,297,0,1.0,0.0
28019281,1,1000,80,920,0.08,0.92
1485543316985098246,0,259,259,0,1.0,0.0
605749535,1,223,16,207,0.07174887892376682,0.9282511210762332
30783702,0,339,303,36,0.8938053097345132,0.10619469026548672
1320939590723670016,1,567,54,513,0.09523809523809523,0.9047619047619048
1055140801066479618,0,167,167,0,1.0,0.0
2358535860,1,817,119,698,0.1456548347613219,0.8543451652386781
757713981951868929,0,513,510,3,0.9941520467836257,0.005847953216374269
519821114,1,1000,207,793,0.207,0.793
601570873,0,359,359,0,1.0,0.0
592411022,1,603,70,533,0.11608623548922056,0.8839137645107794
2736270120,0,229,229,0,1.0,0.0
27546802,1,409,71,338,0.17359413202933985,0.8264058679706602
1026563481749807105,0,68,68,0,1.0,0.0
878487589459820544,1,109,8,101,0.07339449541284404,0.926605504587156
1264428192732856321,0,1000,977,23,0.977,0.023
854468924,0,1000,948,52,0.948,0.052
1330597539989647360,1,399,22,377,0.05513784461152882,0.9448621553884712
399676604,0,184,177,7,0.9619565217391305,0.03804347826086957
47767335,1,1000,95,905,0.095,0.905
626830588,0,438,437,1,0.997716894977169,0.00228310502283105
834886399761473537,1,1000,132,868,0.132,0.868
39695185,0,108,107,1,0.9907407407407407,0.009259259259259259
1392980946706698245,1,472,10,462,0.0211864406779661,0.9788135593220338
3723335301,0,631,631,0,1.0,0.0
3093211402,1,348,51,297,0.14655172413793102,0.853448275862069
1172309513325678592,0,45,45,0,1.0,0.0
289664536,0,1000,998,2,0.998,0.002
4003624752,1,1000,59,941,0.059,0.941
814465960564453376,0,608,572,36,0.9407894736842105,0.05921052631578947
1073061430600056832,1,796,121,675,0.15201005025125627,0.8479899497487438
26117944,0,1000,870,130,0.87,0.13
924198607,1,1000,205,795,0.205,0.795
711259928,0,189,186,3,0.9841269841269841,0.015873015873015872
14058655,1,480,76,404,0.15833333333333333,0.8416666666666667
198039479,1,835,94,741,0.1125748502994012,0.8874251497005988
1156268295038930946,0,85,84,1,0.9882352941176471,0.011764705882352941
3038298626,1,172,21,151,0.12209302325581395,0.877906976744186
311168534,0,935,814,121,0.8705882352941177,0.12941176470588237
460905922,1,465,38,427,0.08172043010752689,0.9182795698924732
1261925502,0,366,362,4,0.9890710382513661,0.01092896174863388
1031937620333481984,1,507,30,477,0.05917159763313609,0.9408284023668639
849705260,0,926,913,13,0.9859611231101512,0.014038876889848811
885521587,1,424,170,254,0.4009433962264151,0.5990566037735849
813843871,0,279,216,63,0.7741935483870968,0.22580645161290322
1869860808,1,1000,219,781,0.219,0.781
26916477,0,69,68,1,0.9855072463768116,0.014492753623188406
308601388,1,210,9,201,0.04285714285714286,0.9571428571428572
50208331,0,1000,987,13,0.987,0.013
2573518092,1,1000,102,898,0.102,0.898
1432109534219231232,0,675,649,26,0.9614814814814815,0.03851851851851852
852171865745494016,1,999,194,805,0.1941941941941942,0.8058058058058059
357822530,0,224,218,6,0.9732142857142857,0.026785714285714284
734043616277057536,1,59,5,54,0.0847457627118644,0.9152542372881356
2843644069,0,709,708,1,0.998589562764457,0.0014104372355430183
1022135232949104640,1,1000,176,824,0.176,0.824
1294796430108962816,0,15,11,4,0.7333333333333333,0.26666666666666666
973227131802193920,1,1000,87,913,0.087,0.913
135171283,0,1000,999,1,0.999,0.001
2324349458,1,313,20,293,0.06389776357827476,0.9361022364217252
498329688,0,344,342,2,0.9941860465116279,0.005813953488372093
319741052,1,399,17,382,0.042606516290726815,0.9573934837092731
3153752374,0,1000,999,1,0.999,0.001
173889801,1,388,93,295,0.23969072164948454,0.7603092783505154
1326667538315554816,0,74,72,2,0.972972972972973,0.02702702702702703
2195548175,1,462,36,426,0.07792207792207792,0.922077922077922
965857277738717185,0,751,656,95,0.8735019973368842,0.12649800266311584
1159282324762181633,1,172,23,149,0.13372093023255813,0.8662790697674418
2562798266,0,809,807,2,0.9975278121137207,0.002472187886279357
1189969403820965888,1,335,35,300,0.1044776119402985,0.8955223880597015
773137300201037825,0,20,20,0,1.0,0.0
1075428438528442368,1,438,49,389,0.11187214611872145,0.8881278538812786
436245317,0,1000,989,11,0.989,0.011
435093495,1,368,25,343,0.06793478260869565,0.9320652173913043
74248130,0,274,272,2,0.9927007299270073,0.0072992700729927005
798344598934339584,1,578,58,520,0.10034602076124567,0.8996539792387543
863904323683704832,0,16,15,1,0.9375,0.0625
219889790,1,1000,24,976,0.024,0.976
1343291117584965645,0,839,805,34,0.9594755661501788,0.04052443384982122
2990644254,1,158,11,147,0.06962025316455696,0.930379746835443
1091638228380209153,0,212,212,0,1.0,0.0
113842575,1,461,9,452,0.019522776572668113,0.9804772234273319
14039832,0,1000,990,10,0.99,0.01
55855061,1,1000,59,941,0.059,0.941
555494586,0,584,559,25,0.9571917808219178,0.04280821917808219
1159146430809853952,1,352,47,305,0.13352272727272727,0.8664772727272727
948508126285844480,0,165,163,2,0.9878787878787879,0.012121212121212121
1091115426392825856,1,498,60,438,0.12048192771084337,0.8795180722891566
386626454,0,391,391,0,1.0,0.0
1327486357489344512,1,290,75,215,0.25862068965517243,0.7413793103448276
168200923,0,1000,909,91,0.909,0.091
3347722186,1,1000,92,908,0.092,0.908
947349467577114625,0,68,64,4,0.9411764705882353,0.058823529411764705
16551457,1,1000,158,842,0.158,0.842
764429519696650241,0,1000,998,2,0.998,0.002
2711210694,1,506,20,486,0.039525691699604744,0.9604743083003953
1401136642375757830,0,410,410,0,1.0,0.0
3192608191,1,234,10,224,0.042735042735042736,0.9572649572649573
753603639143309312,0,260,243,17,0.9346153846153846,0.06538461538461539
189062369,0,418,417,1,0.9976076555023924,0.0023923444976076554
1134780151127035904,1,1000,87,913,0.087,0.913
59161306,0,1000,946,54,0.946,0.054
3117154043,1,1000,63,937,0.063,0.937
22797117,0,1000,961,39,0.961,0.039
175442300,1,236,44,192,0.1864406779661017,0.8135593220338984
53587367,0,634,633,1,0.998422712933754,0.0015772870662460567
1077406220653350914,1,1000,123,877,0.123,0.877
1219857845631385601,0,357,326,31,0.9131652661064426,0.08683473389355742
251409959,1,1000,63,937,0.063,0.937
1881989748,0,385,385,0,1.0,0.0
1152070728331620352,1,224,14,210,0.0625,0.9375
3072863175,0,139,139,0,1.0,0.0
717534869597761536,1,653,130,523,0.1990811638591118,0.8009188361408882
1226539310201044995,0,167,167,0,1.0,0.0
4880238249,1,77,9,68,0.11688311688311688,0.8831168831168831
708844561414676481,0,631,631,0,1.0,0.0
1215505022,1,299,52,247,0.17391304347826086,0.8260869565217391
112576212,0,441,438,3,0.9931972789115646,0.006802721088435374
375369516,1,1000,84,916,0.084,0.916
1134641033067806722,0,64,64,0,1.0,0.0
1495550409749979139,1,46,10,36,0.21739130434782608,0.782608695652174
1234667232426385408,0,46,45,1,0.9782608695652174,0.021739130434782608
36490783,1,1000,118,882,0.118,0.882
172706485,0,233,232,1,0.9957081545064378,0.004291845493562232
168271570,1,422,59,363,0.13981042654028436,0.8601895734597157
912095713642909696,0,800,767,33,0.95875,0.04125
55869003,1,473,91,382,0.19238900634249473,0.8076109936575053
22599864,0,98,97,1,0.9897959183673469,0.01020408163265306
323621235,1,911,97,814,0.10647639956092206,0.893523600439078
1206679359874125827,0,28,28,0,1.0,0.0
29700419,1,315,14,301,0.044444444444444446,0.9555555555555556
29053723,0,929,928,1,0.9989235737351991,0.001076426264800861
32925384,1,1000,17,983,0.017,0.983
317397518,0,731,730,1,0.9986320109439124,0.0013679890560875513
1493893410,1,954,53,901,0.05555555555555555,0.9444444444444444
1488762526036750343,0,173,169,4,0.976878612716763,0.023121387283236993
1036286181003206661,1,124,8,116,0.06451612903225806,0.9354838709677419
45544324,0,1000,955,45,0.955,0.045
485317071,1,236,18,218,0.07627118644067797,0.923728813559322
298758137,0,708,696,12,0.9830508474576272,0.01694915254237288
346670597,1,999,21,978,0.021021021021021023,0.978978978978979
1513176099198545921,0,710,708,2,0.9971830985915493,0.0028169014084507044
441368348,1,825,85,740,0.10303030303030303,0.896969696969697
3309887669,0,296,252,44,0.8513513513513513,0.14864864864864866
1629079494,1,519,44,475,0.08477842003853564,0.9152215799614644
896094142115315713,0,238,237,1,0.9957983193277311,0.004201680672268907
4790501,1,1000,136,864,0.136,0.864
73516155,0,669,664,5,0.992526158445441,0.007473841554559043
1183446648107737091,1,1000,373,627,0.373,0.627
1391094351283978244,0,297,283,14,0.9528619528619529,0.04713804713804714
64495584,1,1000,234,766,0.234,0.766
1120746650836725760,0,261,245,16,0.9386973180076629,0.06130268199233716
1257022698632470528,1,39,0,39,0.0,1.0
1252329102029225989,0,493,492,1,0.9979716024340771,0.002028397565922921
971620061080444929,1,385,83,302,0.21558441558441557,0.7844155844155845
1238983038555623424,0,1000,1000,0,1.0,0.0
3125580658,1,216,11,205,0.05092592592592592,0.9490740740740741
1511016427494559746,0,120,117,3,0.975,0.025
5505852,1,370,79,291,0.21351351351351353,0.7864864864864864
981521571251703809,0,237,235,2,0.9915611814345991,0.008438818565400843
1186169293693546497,1,405,46,359,0.11358024691358025,0.8864197530864197
1473366864986185729,0,188,188,0,1.0,0.0
1435849561499529222,1,72,25,47,0.3472222222222222,0.6527777777777778
84615574,0,184,182,2,0.9891304347826086,0.010869565217391304
2357562937,1,467,59,408,0.12633832976445397,0.8736616702355461
2988103028,0,711,709,2,0.9971870604781997,0.0028129395218002813
170163772,1,966,24,942,0.024844720496894408,0.9751552795031055
1395389120,0,224,214,10,0.9553571428571429,0.044642857142857144
2268845812,1,446,38,408,0.08520179372197309,0.9147982062780269
424692766,0,446,432,14,0.968609865470852,0.03139013452914798
795758799026065408,1,316,42,274,0.13291139240506328,0.8670886075949367
962388883261489153,0,1000,994,6,0.994,0.006
2405598324,1,216,5,211,0.023148148148148147,0.9768518518518519
1519811225298866178,0,12,12,0,1.0,0.0
16689223,1,790,245,545,0.310126582278481,0.689873417721519
1090323166524633088,0,153,150,3,0.9803921568627451,0.0196078431372549
1255597943035486217,1,70,4,66,0.05714285714285714,0.9428571428571428
452711717,0,571,567,4,0.9929947460595446,0.0070052539404553416
936959970708480000,1,190,44,146,0.23157894736842105,0.7684210526315789
1304490209086550016,0,34,34,0,1.0,0.0
20390248,1,343,53,290,0.15451895043731778,0.8454810495626822
1157148679385468928,0,226,223,3,0.9867256637168141,0.01327433628318584
865620031106826240,1,426,38,388,0.0892018779342723,0.9107981220657277
1466289160348602371,0,116,115,1,0.9913793103448276,0.008620689655172414
42809044,1,1000,146,854,0.146,0.854
1465292014187126785,1,190,19,171,0.1,0.9
30327810,0,179,174,5,0.9720670391061452,0.027932960893854747
122407698,1,463,23,440,0.04967602591792657,0.9503239740820735
17780747,1,1000,68,932,0.068,0.932
1105209895962345472,0,17,17,0,1.0,0.0
4311732635,1,28,2,26,0.07142857142857142,0.9285714285714286
4819904303,0,310,309,1,0.9967741935483871,0.0032258064516129032
2994621739,1,1000,59,941,0.059,0.941
1038823140061786112,0,100,96,4,0.96,0.04
2825149878,1,1000,215,785,0.215,0.785
233176419,0,999,964,35,0.964964964964965,0.035035035035035036
1452878912774569985,1,67,3,64,0.04477611940298507,0.9552238805970149
968842865228034048,0,327,327,0,1.0,0.0
485242527,1,1000,51,949,0.051,0.949
1384487226504097792,0,197,189,8,0.9593908629441624,0.04060913705583756
388108740,1,1000,120,880,0.12,0.88
1217311323005931523,0,61,55,6,0.9016393442622951,0.09836065573770492
2382685903,1,164,53,111,0.3231707317073171,0.676829268292683
1112728711449767936,0,121,120,1,0.9917355371900827,0.008264462809917356
587080290,1,1000,200,800,0.2,0.8
41368430,0,1000,998,2,0.998,0.002
2769379512,1,317,39,278,0.12302839116719243,0.8769716088328076
4227012327,0,201,197,4,0.9800995024875622,0.01990049751243781
989624128402583553,1,921,284,637,0.30836047774158526,0.6916395222584147
488922431,0,53,53,0,1.0,0.0
887157736844140544,1,1000,180,820,0.18,0.82
46726590,0,967,950,17,0.9824198552223371,0.017580144777662874
3393931953,1,1000,157,843,0.157,0.843
1445969903974899716,0,550,540,10,0.9818181818181818,0.01818181818181818
579500744,1,252,13,239,0.051587301587301584,0.9484126984126984
95948586,1,705,100,605,0.14184397163120568,0.8581560283687943
1969272565,0,94,94,0,1.0,0.0
879793510886637570,1,1000,93,907,0.093,0.907
1505765755354296322,0,26,26,0,1.0,0.0
3334051702,1,532,100,432,0.18796992481203006,0.8120300751879699
2692755319,0,1000,988,12,0.988,0.012
41791751,1,163,57,106,0.3496932515337423,0.6503067484662577
714915503114944516,0,683,679,4,0.9941434846266471,0.005856515373352855
976138907296370690,1,238,39,199,0.1638655462184874,0.8361344537815126
1521551863593816064,0,159,159,0,1.0,0.0
1320405827858001920,0,1000,929,71,0.929,0.071
811630648087769089,1,492,18,474,0.036585365853658534,0.9634146341463414
1394672693069316097,0,7,7,0,1.0,0.0
15787250,1,412,102,310,0.24757281553398058,0.7524271844660194
717536985620029440,0,232,229,3,0.9870689655172413,0.01293103448275862
735202881498976256,1,444,97,347,0.21846846846846846,0.7815315315315315
1493123022382936067,0,503,496,7,0.9860834990059643,0.013916500994035786
24377134,1,879,250,629,0.2844141069397042,0.7155858930602957
1038812719242244098,0,238,233,5,0.9789915966386554,0.02100840336134454
21451933,1,398,18,380,0.04522613065326633,0.9547738693467337
1411034704606867458,0,616,615,1,0.9983766233766234,0.0016233766233766235
1043911389633380352,1,639,30,609,0.046948356807511735,0.9530516431924883
1261873838066937856,0,154,136,18,0.8831168831168831,0.11688311688311688
1496122832,1,480,93,387,0.19375,0.80625
877604350255742977,0,222,220,2,0.990990990990991,0.009009009009009009
1216156043564257282,1,261,43,218,0.16475095785440613,0.8352490421455939
1037128550745362434,0,152,107,45,0.7039473684210527,0.29605263157894735
247369277,1,1000,147,853,0.147,0.853
19545032,1,1000,48,952,0.048,0.952
1225166699319582720,0,277,253,24,0.9133574007220217,0.08664259927797834
2561922888,1,98,36,62,0.3673469387755102,0.6326530612244898
2332765076,0,449,436,13,0.9710467706013363,0.028953229398663696
1168551334095785986,1,133,22,111,0.16541353383458646,0.8345864661654135
141827705,0,62,62,0,1.0,0.0
891674538,1,289,24,265,0.08304498269896193,0.916955017301038
796259072626540546,0,404,384,20,0.9504950495049505,0.04950495049504951
116623208,0,316,314,2,0.9936708860759493,0.006329113924050633
701884834340331520,1,445,94,351,0.21123595505617979,0.7887640449438202
100118229,1,836,64,772,0.07655502392344497,0.9234449760765551
454972243,0,898,898,0,1.0,0.0
151139826,1,1000,63,937,0.063,0.937
1202049553693847552,0,102,97,5,0.9509803921568627,0.049019607843137254
1618973492,1,271,41,230,0.15129151291512916,0.8487084870848709
1349017400268779520,0,1000,1000,0,1.0,0.0
1115997747423907841,1,309,22,287,0.07119741100323625,0.9288025889967637
1865089524,0,999,996,3,0.996996996996997,0.003003003003003003
249877873,1,1000,271,729,0.271,0.729
743120108592078848,0,111,109,2,0.9819819819819819,0.018018018018018018
230086115,1,1000,203,797,0.203,0.797
974595731745984513,0,342,339,3,0.9912280701754386,0.008771929824561403
479162062,1,1000,123,877,0.123,0.877
754102953942724608,0,1000,994,6,0.994,0.006
3024237458,1,604,72,532,0.11920529801324503,0.8807947019867549
1527457468955217927,0,31,31,0,1.0,0.0
20790641,1,1000,213,787,0.213,0.787
1269632320123830272,0,904,904,0,1.0,0.0
4540905474,1,68,23,45,0.3382352941176471,0.6617647058823529
26937115,0,367,356,11,0.9700272479564033,0.02997275204359673
2344636084,1,674,123,551,0.1824925816023739,0.8175074183976261
1253168587,0,42,42,0,1.0,0.0
1187118594,1,250,28,222,0.112,0.888
4668361398,0,703,696,7,0.9900426742532006,0.00995732574679943
1354220960593932296,1,580,120,460,0.20689655172413793,0.7931034482758621
424727626,0,946,926,20,0.9788583509513742,0.021141649048625793
4846966540,1,714,49,665,0.06862745098039216,0.9313725490196079
883698192390533124,0,610,602,8,0.9868852459016394,0.013114754098360656
66597588,1,213,23,190,0.107981220657277,0.892018779342723
527768991,0,607,603,4,0.9934102141680395,0.006589785831960461
49193833,1,380,14,366,0.03684210526315789,0.9631578947368421
2722811534,0,428,423,5,0.9883177570093458,0.011682242990654205
981153354,1,665,54,611,0.081203007518797,0.9187969924812031
1507799690707931136,0,80,79,1,0.9875,0.0125
1326931671715811329,1,176,47,129,0.26704545454545453,0.7329545454545454
2500545182,0,754,721,33,0.9562334217506632,0.04376657824933687
1082521627215216640,1,116,11,105,0.09482758620689655,0.9051724137931034
49095462,0,539,535,4,0.9925788497217068,0.0074211502782931356
936490881452007425,1,291,72,219,0.24742268041237114,0.7525773195876289
1394396588143955968,0,85,81,4,0.9529411764705882,0.047058823529411764
392315642,1,394,27,367,0.06852791878172589,0.9314720812182741
709814183756324864,0,166,166,0,1.0,0.0
1008534511540424704,1,1000,43,957,0.043,0.957
719223866,0,389,376,13,0.9665809768637532,0.033419023136246784
57448605,1,237,28,209,0.11814345991561181,0.8818565400843882
92317057,0,288,288,0,1.0,0.0
553230956,1,454,120,334,0.2643171806167401,0.73568281938326
3380498218,0,733,722,11,0.984993178717599,0.015006821282401092
1284174819605409792,1,699,88,611,0.12589413447782546,0.8741058655221745
132688413,0,71,70,1,0.9859154929577465,0.014084507042253521
1174408730428891142,1,1000,302,698,0.302,0.698
104280494,0,311,311,0,1.0,0.0
1686954672,1,431,93,338,0.21577726218097448,0.7842227378190255
1334221044022800385,0,140,139,1,0.9928571428571429,0.007142857142857143
1069702638852284417,1,112,33,79,0.29464285714285715,0.7053571428571429
438927426,0,616,612,4,0.9935064935064936,0.006493506493506494
187825932,1,504,149,355,0.29563492063492064,0.7043650793650794
1160908954412544001,0,9,9,0,1.0,0.0
14350632,1,438,12,426,0.0273972602739726,0.9726027397260274
2827397054,0,451,422,29,0.9356984478935698,0.06430155210643015
1654693400,1,654,61,593,0.09327217125382263,0.9067278287461774
344345894,0,921,873,48,0.9478827361563518,0.05211726384364821
2624193147,1,233,5,228,0.02145922746781116,0.9785407725321889
2885824475,0,795,792,3,0.9962264150943396,0.0037735849056603774
1155718100,1,681,105,576,0.15418502202643172,0.8458149779735683
1821853650,0,479,470,9,0.9812108559498957,0.018789144050104383
941939309422227456,1,1000,294,706,0.294,0.706
979928103588978688,0,133,130,3,0.9774436090225563,0.022556390977443608
165122959,1,758,73,685,0.09630606860158311,0.9036939313984169
1498082711310848003,0,708,678,30,0.9576271186440678,0.0423728813559322
1443735877944070147,0,306,306,0,1.0,0.0
1054086290315059200,1,673,215,458,0.31946508172362553,0.6805349182763745
860879029972471809,0,724,703,21,0.9709944751381215,0.029005524861878452
1926963414,0,237,226,11,0.9535864978902954,0.046413502109704644
1597317444,1,528,45,483,0.08522727272727272,0.9147727272727273
79183098,0,301,301,0,1.0,0.0
1244557884,1,325,45,280,0.13846153846153847,0.8615384615384616
1281312250662457345,0,1000,854,146,0.854,0.146
20113974,1,869,69,800,0.07940161104718067,0.9205983889528193
1242539663249887232,0,276,276,0,1.0,0.0
37552438,1,824,216,608,0.2621359223300971,0.7378640776699029
1297256463946207234,0,452,452,0,1.0,0.0
1172952130652557312,1,810,72,738,0.08888888888888889,0.9111111111111111
256282837,0,91,91,0,1.0,0.0
13145772,1,999,40,959,0.04004004004004004,0.95995995995996
759944324662657025,0,1000,946,54,0.946,0.054
882968102971035648,1,995,153,842,0.15376884422110554,0.8462311557788945
758443494012620800,0,648,646,2,0.9969135802469136,0.0030864197530864196
29890789,0,1000,969,31,0.969,0.031
2476316178,1,716,180,536,0.25139664804469275,0.7486033519553073
1459790322607837186,0,894,893,1,0.9988814317673378,0.0011185682326621924
2847559045,1,359,13,346,0.036211699164345405,0.9637883008356546
2899589482,0,68,68,0,1.0,0.0
471401228,1,203,7,196,0.034482758620689655,0.9655172413793104
1404262048578654211,0,142,142,0,1.0,0.0
170443071,1,644,180,464,0.2795031055900621,0.7204968944099379
1524586383234330626,0,145,136,9,0.9379310344827586,0.06206896551724138
846912058310475777,1,986,270,716,0.2738336713995943,0.7261663286004056
1465691157535592453,0,77,77,0,1.0,0.0
1096602802120478723,1,1000,190,810,0.19,0.81
358811046,0,231,231,0,1.0,0.0
260476938,1,1000,216,784,0.216,0.784
1255196882,0,1000,999,1,0.999,0.001
48566425,1,1000,134,866,0.134,0.866
989550901554753536,0,129,122,7,0.9457364341085271,0.05426356589147287
1398369055514443781,1,220,12,208,0.05454545454545454,0.9454545454545454
1025975011855622144,0,643,622,21,0.9673405909797823,0.03265940902021773
991730983786266624,1,380,51,329,0.13421052631578947,0.8657894736842106
1244055361251753984,0,155,155,0,1.0,0.0
1078554154849746945,1,11,0,11,0.0,1.0
1346465609735839746,0,1000,990,10,0.99,0.01
1050507798037983232,0,40,38,2,0.95,0.05
298893051,1,347,33,314,0.09510086455331412,0.9048991354466859
1474201721488683008,0,10,10,0,1.0,0.0
348737331,1,1000,326,674,0.326,0.674
1400623432883224576,0,65,65,0,1.0,0.0
1478780628082507776,1,236,6,230,0.025423728813559324,0.9745762711864406
4050852377,0,21,21,0,1.0,0.0
3329606392,1,387,19,368,0.04909560723514212,0.9509043927648578
1518673188057542656,0,118,118,0,1.0,0.0
1010475266379001857,1,1000,128,872,0.128,0.872
2537812289,0,780,776,4,0.9948717948717949,0.005128205128205128
33146186,1,550,37,513,0.06727272727272728,0.9327272727272727
1279572168809025536,1,90,5,85,0.05555555555555555,0.9444444444444444
1524100068177227776,0,31,31,0,1.0,0.0
629801488,1,1000,63,937,0.063,0.937
1422897139659706371,0,40,40,0,1.0,0.0
1459230860780134401,1,78,8,70,0.10256410256410256,0.8974358974358975
805509734111608832,0,354,352,2,0.9943502824858758,0.005649717514124294
1407794806324174848,1,388,46,342,0.11855670103092783,0.8814432989690721
35550173,0,1000,992,8,0.992,0.008
1444379522862915596,1,269,28,241,0.10408921933085502,0.895910780669145
18479728,0,1000,984,16,0.984,0.016
1296952745115648008,1,441,35,406,0.07936507936507936,0.9206349206349206
849122510851497985,0,41,36,5,0.8780487804878049,0.12195121951219512
1615987543,0,175,175,0,1.0,0.0
730034825675968513,1,562,85,477,0.1512455516014235,0.8487544483985765
1075248840,0,1000,993,7,0.993,0.007
1520168026750042113,1,167,57,110,0.3413173652694611,0.6586826347305389
1492596533782773760,0,426,425,1,0.9976525821596244,0.002347417840375587
2942263408,1,67,7,60,0.1044776119402985,0.8955223880597015
1291423682103881729,0,210,210,0,1.0,0.0
1239725136011390976,1,634,103,531,0.16246056782334384,0.8375394321766562
265626908,0,589,583,6,0.9898132427843803,0.010186757215619695
1005973911769579520,1,592,37,555,0.0625,0.9375
1201771329302728704,0,1000,936,64,0.936,0.064
1352031027770716161,1,739,80,659,0.10825439783491204,0.8917456021650879
67562476,0,491,487,4,0.9918533604887984,0.008146639511201629
1007066801421848576,1,210,45,165,0.21428571428571427,0.7857142857142857
1288923927205613569,0,97,97,0,1.0,0.0
1052824244,1,347,6,341,0.01729106628242075,0.9827089337175793
19818393,0,1000,919,81,0.919,0.081
1296320065,1,151,9,142,0.059602649006622516,0.9403973509933775
1267296847657197568,0,316,314,2,0.9936708860759493,0.006329113924050633
15276763,1,1000,157,843,0.157,0.843
3280361340,0,774,772,2,0.9974160206718347,0.002583979328165375
15353186,1,272,22,250,0.08088235294117647,0.9191176470588235
150749196,0,419,419,0,1.0,0.0
1359595551654821897,1,105,18,87,0.17142857142857143,0.8285714285714286
1472100363163643904,1,1000,29,971,0.029,0.971
1293592373474340870,0,139,139,0,1.0,0.0
3103309774,1,655,34,621,0.051908396946564885,0.9480916030534351
213470153,0,182,158,24,0.8681318681318682,0.13186813186813187
822614290603581440,1,390,40,350,0.10256410256410256,0.8974358974358975
1296114026791882752,0,333,329,4,0.987987987987988,0.012012012012012012
1354606543,1,669,299,370,0.4469357249626308,0.5530642750373692
196342031,0,398,382,16,0.9597989949748744,0.04020100502512563
629518379,1,455,62,393,0.13626373626373625,0.8637362637362638
32826358,0,88,88,0,1.0,0.0
363800420,1,1000,197,803,0.197,0.803
318202307,0,963,949,14,0.9854620976116303,0.014537902388369679
1362892472775368706,1,1000,104,896,0.104,0.896
4806390024,0,489,480,9,0.9815950920245399,0.018404907975460124
1467628034148777989,1,137,4,133,0.029197080291970802,0.9708029197080292
3404317493,0,125,108,17,0.864,0.136
919645947923136513,1,551,23,528,0.041742286751361164,0.9582577132486388
382442510,0,241,241,0,1.0,0.0
174763886,1,290,62,228,0.21379310344827587,0.7862068965517242
14809725,0,1000,950,50,0.95,0.05
1283111737101660161,1,30,7,23,0.23333333333333334,0.7666666666666667
925815223,0,927,874,53,0.9428263214670982,0.05717367853290183
20863696,1,933,147,786,0.15755627009646303,0.842443729903537
836286696765415425,0,236,219,17,0.9279661016949152,0.07203389830508475
14074498,1,1000,161,839,0.161,0.839
286132948,1,414,30,384,0.07246376811594203,0.927536231884058
1350935774401880070,0,71,71,0,1.0,0.0
7154212,1,380,71,309,0.1868421052631579,0.8131578947368421
198353993,0,139,131,8,0.9424460431654677,0.05755395683453238
1147227232995201024,1,1000,150,850,0.15,0.85
108477581,0,119,118,1,0.9915966386554622,0.008403361344537815
1245578846742523909,1,817,234,583,0.2864137086903305,0.7135862913096696
3354538912,0,440,439,1,0.9977272727272727,0.0022727272727272726
258952359,1,293,49,244,0.16723549488054607,0.8327645051194539
153619565,0,333,322,11,0.9669669669669669,0.03303303303303303
1641215935,1,59,26,33,0.4406779661016949,0.559322033898305
754360463375290368,0,401,353,48,0.8802992518703242,0.11970074812967581
390429223,1,339,33,306,0.09734513274336283,0.9026548672566371
1340969006333796353,0,175,172,3,0.9828571428571429,0.017142857142857144
288374146,1,829,51,778,0.061519903498190594,0.9384800965018094
855241566,0,301,296,5,0.9833887043189369,0.016611295681063124
1032443717720973312,1,286,14,272,0.04895104895104895,0.951048951048951
40265743,0,27,27,0,1.0,0.0
21502315,1,1000,304,696,0.304,0.696
1262533061113249798,0,167,166,1,0.9940119760479041,0.005988023952095809
491869684,1,288,26,262,0.09027777777777778,0.9097222222222222
1325245642348785665,0,323,312,11,0.9659442724458205,0.034055727554179564
88000963,1,836,177,659,0.2117224880382775,0.7882775119617225
2397099121,0,1000,956,44,0.956,0.044
1461543263442145281,1,597,171,426,0.2864321608040201,0.7135678391959799
2359128300,0,200,198,2,0.99,0.01
1494472616664604672,1,674,102,572,0.1513353115727003,0.8486646884272997
726713486,0,610,607,3,0.9950819672131147,0.004918032786885246
17279430,1,464,33,431,0.07112068965517242,0.9288793103448276
374743732,0,240,226,14,0.9416666666666667,0.058333333333333334
39020639,1,1000,36,964,0.036,0.964
1366931127521271810,0,53,53,0,1.0,0.0
705166106,1,1000,29,971,0.029,0.971
24643276,0,739,644,95,0.871447902571042,0.12855209742895804
2364560508,0,776,726,50,0.9355670103092784,0.06443298969072164
27822442,1,1000,233,767,0.233,0.767
1536208126596497408,0,117,117,0,1.0,0.0
1315796750272270336,1,105,26,79,0.24761904761904763,0.7523809523809524
1194966990844317697,0,961,922,39,0.959417273673257,0.04058272632674298
315487346,1,153,9,144,0.058823529411764705,0.9411764705882353
1033394009136345095,0,790,789,1,0.9987341772151899,0.0012658227848101266
2722241520,1,467,61,406,0.13062098501070663,0.8693790149892934
1459623790401495049,0,1000,998,2,0.998,0.002
16888791,1,355,61,294,0.17183098591549295,0.828169014084507
513207211,0,752,733,19,0.9747340425531915,0.02526595744680851
1654168326,1,232,13,219,0.05603448275862069,0.9439655172413793
2728622371,0,271,269,2,0.992619926199262,0.007380073800738007
1087137438,1,290,38,252,0.1310344827586207,0.8689655172413793
2305655792,0,923,913,10,0.9891657638136512,0.010834236186348862
1492964764875698188,1,18,2,16,0.1111111111111111,0.8888888888888888
1166577155557470208,0,1000,984,16,0.984,0.016
1012879939463516160,1,153,37,116,0.24183006535947713,0.7581699346405228
853150970015907841,0,353,338,15,0.9575070821529745,0.042492917847025496
2999751926,1,273,39,234,0.14285714285714285,0.8571428571428571
2272333951,1,110,13,97,0.11818181818181818,0.8818181818181818
3359404444,0,1000,879,121,0.879,0.121
1350897711076179968,1,641,45,596,0.07020280811232449,0.9297971918876755
1244830254230839301,0,29,29,0,1.0,0.0
1081600532521848832,1,139,19,120,0.1366906474820144,0.8633093525179856
1345136142614728705,1,1000,122,878,0.122,0.878
617741551,0,590,577,13,0.9779661016949153,0.022033898305084745
912769615,1,359,43,316,0.11977715877437325,0.8802228412256268
395171845,0,584,583,1,0.9982876712328768,0.0017123287671232876
758359976473538560,1,424,10,414,0.02358490566037736,0.9764150943396226
872579755442397189,0,1000,998,2,0.998,0.002
1405648149251768321,1,272,18,254,0.0661764705882353,0.9338235294117647
819226551564668928,0,1000,952,48,0.952,0.048
172630516,1,464,67,397,0.14439655172413793,0.8556034482758621
26067771,0,257,249,8,0.9688715953307393,0.0311284046692607
44698073,1,1000,103,897,0.103,0.897
184266135,0,111,104,7,0.9369369369369369,0.06306306306306306
1466114974699376658,1,268,41,227,0.15298507462686567,0.8470149253731343
448193750,0,798,793,5,0.993734335839599,0.006265664160401002
16716518,1,1000,122,878,0.122,0.878
15842618,0,947,918,29,0.9693769799366421,0.030623020063357972
1388746949319266307,1,30,0,30,0.0,1.0
50684237,0,515,501,14,0.9728155339805825,0.027184466019417475
94630831,1,364,65,299,0.17857142857142858,0.8214285714285714
75894119,0,755,749,6,0.9920529801324504,0.007947019867549669
1353740300926267392,1,83,0,83,0.0,1.0
816291724062556160,0,606,597,9,0.9851485148514851,0.01485148514851485
15310883,1,1000,111,889,0.111,0.889
1472092254684827653,0,173,165,8,0.953757225433526,0.046242774566473986
2427781412,1,1000,68,932,0.068,0.932
1093531075383619584,0,104,99,5,0.9519230769230769,0.04807692307692308
1133384433917210624,1,94,13,81,0.13829787234042554,0.8617021276595744
22979161,0,1000,966,34,0.966,0.034
632346097,1,281,28,253,0.099644128113879,0.900355871886121
887920564832043008,0,302,300,2,0.9933774834437086,0.006622516556291391
1489441698,1,1000,87,913,0.087,0.913
24541966,0,957,942,15,0.9843260188087775,0.01567398119122257
842266606923276288,1,1000,72,928,0.072,0.928
971642545179541504,0,112,111,1,0.9910714285714286,0.008928571428571428
780886748377276417,1,143,64,79,0.44755244755244755,0.5524475524475524
945477964619288577,0,447,447,0,1.0,0.0
3949326674,1,204,23,181,0.11274509803921569,0.8872549019607843
4877078194,0,218,218,0,1.0,0.0
2468704056,1,357,38,319,0.10644257703081232,0.8935574229691877
248084144,0,385,381,4,0.9896103896103896,0.01038961038961039
126510853,1,264,14,250,0.05303030303030303,0.946969696969697
114038976,0,1000,1000,0,1.0,0.0
412693192,1,303,43,260,0.1419141914191419,0.858085808580858
3408883641,0,298,297,1,0.9966442953020134,0.003355704697986577
1589280415,1,1000,219,781,0.219,0.781
17259930,0,1000,969,31,0.969,0.031
54540783,1,328,48,280,0.14634146341463414,0.8536585365853658
1235224916409999361,0,64,64,0,1.0,0.0
1376103904459550720,1,671,65,606,0.09687034277198212,0.9031296572280179
120339575,0,460,440,20,0.9565217391304348,0.043478260869565216
1466476552921751565,1,125,34,91,0.272,0.728
1037161486270058496,0,47,43,4,0.9148936170212766,0.0851063829787234
91050393,1,553,189,364,0.34177215189873417,0.6582278481012658
791785608133828609,0,201,200,1,0.9950248756218906,0.004975124378109453
3128296969,1,189,25,164,0.13227513227513227,0.8677248677248677
1492932402985025541,0,12,11,1,0.9166666666666666,0.08333333333333333
996951154172014597,1,1000,301,699,0.301,0.699
1191388475800588288,0,125,125,0,1.0,0.0
242030033,1,1000,202,798,0.202,0.798
794461182,0,535,519,16,0.9700934579439252,0.029906542056074768
2915162016,1,104,26,78,0.25,0.75
1325217265,0,1000,974,26,0.974,0.026
1720208101,1,309,26,283,0.08414239482200647,0.9158576051779935
1069427689390522368,0,597,590,7,0.9882747068676717,0.011725293132328308
1128343546312970242,1,53,5,48,0.09433962264150944,0.9056603773584906
2208930070,0,585,582,3,0.9948717948717949,0.005128205128205128
144055413,1,999,51,948,0.05105105105105105,0.948948948948949
278131808,0,1000,995,5,0.995,0.005
955127681980489728,1,473,41,432,0.08668076109936575,0.9133192389006343
1105300091605147649,0,741,741,0,1.0,0.0
1110697146993516544,1,165,20,145,0.12121212121212122,0.8787878787878788
615523904,0,13,13,0,1.0,0.0
341533319,1,1000,95,905,0.095,0.905
450106039,0,260,247,13,0.95,0.05
1041059790934482944,0,125,121,4,0.968,0.032
388977789,1,834,73,761,0.08752997601918465,0.9124700239808153
1442752783132737536,1,96,29,67,0.3020833333333333,0.6979166666666666
2322336582,0,389,387,2,0.9948586118251928,0.005141388174807198
1083752140642885633,1,612,75,537,0.12254901960784313,0.8774509803921569
17007981,1,1000,105,895,0.105,0.895
1345413117908455426,0,558,551,7,0.9874551971326165,0.012544802867383513
820360844,1,1000,234,766,0.234,0.766
17154457,0,1000,976,24,0.976,0.024
1232838048,1,266,74,192,0.2781954887218045,0.7218045112781954
59218832,0,640,580,60,0.90625,0.09375
1349888410006204418,1,627,51,576,0.08133971291866028,0.9186602870813397
1470288529,1,233,12,221,0.05150214592274678,0.9484978540772532
78704499,0,242,238,4,0.9834710743801653,0.01652892561983471
1071890635462975490,1,921,46,875,0.0499457111834962,0.9500542888165038
39311513,0,773,757,16,0.9793014230271668,0.02069857697283312
1389664623696220161,1,198,14,184,0.0707070707070707,0.9292929292929293
1049682074830073857,0,121,121,0,1.0,0.0
110780513,1,884,63,821,0.07126696832579185,0.9287330316742082
539367588,0,28,28,0,1.0,0.0
611758045,1,1000,144,856,0.144,0.856
45478205,0,292,290,2,0.9931506849315068,0.00684931506849315
1554623401,1,352,23,329,0.06534090909090909,0.9346590909090909
1442578273880313860,0,120,120,0,1.0,0.0
15951763,1,1000,69,931,0.069,0.931
3246470984,0,278,273,5,0.9820143884892086,0.017985611510791366
1090867124,1,980,197,783,0.2010204081632653,0.7989795918367347
936641499613167616,0,480,430,50,0.8958333333333334,0.10416666666666667
137707855,1,1000,129,871,0.129,0.871
1044801135968702464,0,1000,971,29,0.971,0.029
2879474420,1,302,12,290,0.039735099337748346,0.9602649006622517
716254736,0,111,108,3,0.972972972972973,0.02702702702702703
27979847,1,574,24,550,0.041811846689895474,0.9581881533101045
1480550850233659393,0,279,276,3,0.989247311827957,0.010752688172043012
193126619,1,417,99,318,0.23741007194244604,0.762589928057554
225504268,0,321,319,2,0.9937694704049844,0.006230529595015576
30086993,1,584,60,524,0.10273972602739725,0.8972602739726028
1390825815525429248,1,68,8,60,0.11764705882352941,0.8823529411764706
2415486482,0,87,78,9,0.896551724137931,0.10344827586206896
989388379539296256,1,385,31,354,0.08051948051948052,0.9194805194805195
1051151713946804225,0,376,364,12,0.9680851063829787,0.031914893617021274
17491207,1,531,104,427,0.1958568738229755,0.8041431261770244
826945664798035968,0,1000,984,16,0.984,0.016
966439254053281792,1,547,29,518,0.05301645338208409,0.946983546617916
1529285286823202817,0,206,206,0,1.0,0.0
2956269982,1,999,113,886,0.11311311311311312,0.8868868868868869
863723485,0,827,827,0,1.0,0.0
2355425269,1,528,58,470,0.10984848484848485,0.8901515151515151
1155580486984634372,0,1000,976,24,0.976,0.024
2747892842,1,1000,232,768,0.232,0.768
390975459,0,757,737,20,0.9735799207397622,0.026420079260237782
19313707,1,703,80,623,0.11379800853485064,0.8862019914651493
2448680113,0,999,982,17,0.982982982982983,0.01701701701701702
1295100647755440137,1,92,12,80,0.13043478260869565,0.8695652173913043
2893511847,0,326,325,1,0.9969325153374233,0.003067484662576687
2842909732,1,369,49,320,0.13279132791327913,0.8672086720867209
1195322985193844736,0,1000,997,3,0.997,0.003
582377845,1,141,32,109,0.22695035460992907,0.7730496453900709
4813292361,0,581,579,2,0.9965576592082617,0.0034423407917383822
1381246941632270336,1,215,53,162,0.24651162790697675,0.7534883720930232
710382085,0,189,189,0,1.0,0.0
22278725,1,678,173,505,0.2551622418879056,0.7448377581120944
1482487061030473730,0,184,161,23,0.875,0.125
1250172540,1,720,165,555,0.22916666666666666,0.7708333333333334
815904103347855360,0,818,801,17,0.9792176039119804,0.02078239608801956
3451615167,1,141,15,126,0.10638297872340426,0.8936170212765957
377808679,0,564,561,3,0.9946808510638298,0.005319148936170213
36907483,1,893,200,693,0.22396416573348266,0.7760358342665173
1465093783415099404,0,157,152,5,0.9681528662420382,0.03184713375796178
1074461963684642817,1,342,60,282,0.17543859649122806,0.8245614035087719
1087015037808472065,0,48,48,0,1.0,0.0
776103183118503937,1,179,18,161,0.1005586592178771,0.8994413407821229
926227460353556481,0,157,157,0,1.0,0.0
4428256480,1,270,66,204,0.24444444444444444,0.7555555555555555
838044786015641601,0,1000,1000,0,1.0,0.0
841764134773526532,1,231,20,211,0.08658008658008658,0.9134199134199135
154922856,0,1000,923,77,0.923,0.077
15819380,1,1000,166,834,0.166,0.834
1318179707083542528,0,26,26,0,1.0,0.0
1283068002842431488,1,1000,36,964,0.036,0.964
1084496449071648769,0,1000,998,2,0.998,0.002
3297542962,1,319,18,301,0.05642633228840126,0.9435736677115988
808468468387512320,0,1000,989,11,0.989,0.011
763135962486628352,1,1000,116,884,0.116,0.884
705955774174875648,0,80,80,0,1.0,0.0
200550985,1,1000,61,939,0.061,0.939
927996622176423938,0,64,64,0,1.0,0.0
1070759136713957376,1,366,36,330,0.09836065573770492,0.9016393442622951
1067308963165847552,0,948,946,2,0.9978902953586498,0.002109704641350211
3247475215,1,100,16,84,0.16,0.84
1483714134567186436,0,18,17,1,0.9444444444444444,0.05555555555555555
60350375,1,178,7,171,0.03932584269662921,0.9606741573033708
2798630851,0,77,76,1,0.987012987012987,0.012987012987012988
380069072,1,370,55,315,0.14864864864864866,0.8513513513513513
1314812960414535685,0,1000,999,1,0.999,0.001
904812073317572608,1,914,107,807,0.11706783369803063,0.8829321663019694
56749735,0,1000,997,3,0.997,0.003
1146818448,1,766,211,555,0.2754569190600522,0.7245430809399478
17197288,0,552,526,26,0.9528985507246377,0.04710144927536232
919294402991976448,1,277,32,245,0.11552346570397112,0.8844765342960289
3184503259,0,157,157,0,1.0,0.0
845974881418252288,1,570,157,413,0.2754385964912281,0.724561403508772
1089945058458116098,0,1000,996,4,0.996,0.004
1883627556,1,303,28,275,0.0924092409240924,0.9075907590759076
227785929,0,620,615,5,0.9919354838709677,0.008064516129032258
733034214430367744,1,171,8,163,0.04678362573099415,0.9532163742690059
1234981483254669314,0,68,68,0,1.0,0.0
1363865449440686083,1,276,9,267,0.03260869565217391,0.967391304347826
439621581,1,311,13,298,0.04180064308681672,0.9581993569131833
204111638,0,148,147,1,0.9932432432432432,0.006756756756756757
3115364990,1,1000,219,781,0.219,0.781
1480889706984337420,0,37,37,0,1.0,0.0
15202057,1,174,15,159,0.08620689655172414,0.9137931034482759
2755643247,0,980,931,49,0.95,0.05
17530356,1,811,177,634,0.218249075215783,0.781750924784217
2179126170,0,321,321,0,1.0,0.0
787843926422007808,1,217,34,183,0.15668202764976957,0.8433179723502304
23971179,0,548,532,16,0.9708029197080292,0.029197080291970802
168726730,1,1000,95,905,0.095,0.905
1071951123290963968,0,599,596,3,0.994991652754591,0.005008347245409015
771784872272785412,1,954,224,730,0.2348008385744235,0.7651991614255765
590445932,0,78,77,1,0.9871794871794872,0.01282051282051282
1294129039427244033,1,1000,64,936,0.064,0.936
1343993411234385921,0,256,254,2,0.9921875,0.0078125
589301551,1,239,18,221,0.07531380753138076,0.9246861924686193
1389256930204524544,0,58,58,0,1.0,0.0
4674113910,1,335,72,263,0.21492537313432836,0.7850746268656716
771472805854609414,0,367,365,2,0.9945504087193461,0.005449591280653951
17886795,1,1000,175,825,0.175,0.825
36331628,0,381,381,0,1.0,0.0
80747243,1,1000,108,892,0.108,0.892
1509322744227250183,0,901,891,10,0.9889012208657048,0.011098779134295227
230454294,1,700,55,645,0.07857142857142857,0.9214285714285714
3432938343,0,735,732,3,0.9959183673469387,0.004081632653061225
1505334949397909509,1,85,28,57,0.32941176470588235,0.6705882352941176
3416678236,0,1000,1000,0,1.0,0.0
3207957837,1,1000,130,870,0.13,0.87
137919451,0,432,408,24,0.9444444444444444,0.05555555555555555
970896467182329857,1,609,131,478,0.21510673234811165,0.7848932676518884
885793459,0,54,54,0,1.0,0.0
4919874660,1,1000,184,816,0.184,0.816
68902973,0,1000,858,142,0.858,0.142
1501171902840193030,1,72,31,41,0.4305555555555556,0.5694444444444444
103102239,0,22,22,0,1.0,0.0
1450209477735628800,0,506,464,42,0.9169960474308301,0.08300395256916997
1276754030,1,999,148,851,0.14814814814814814,0.8518518518518519
903804523365335040,1,677,182,495,0.2688330871491876,0.7311669128508124
1344744670027513857,0,41,41,0,1.0,0.0
444270483,1,999,39,960,0.03903903903903904,0.960960960960961
1177161342555312128,0,280,274,6,0.9785714285714285,0.02142857142857143
1090826941249318912,1,145,14,131,0.09655172413793103,0.903448275862069
1120507979885883392,0,631,631,0,1.0,0.0
4168647192,1,1000,48,952,0.048,0.952
1518794820323627008,0,84,80,4,0.9523809523809523,0.047619047619047616
2424153900,1,516,44,472,0.08527131782945736,0.9147286821705426
259705615,0,1000,996,4,0.996,0.004
4740408741,1,646,74,572,0.11455108359133127,0.8854489164086687
1466530922824560640,0,30,30,0,1.0,0.0
728070906581426178,0,101,100,1,0.9900990099009901,0.009900990099009901
17061194,1,1000,26,974,0.026,0.974
26956914,0,164,128,36,0.7804878048780488,0.21951219512195122
1206305665423040512,1,488,9,479,0.018442622950819672,0.9815573770491803
1425422799837876227,0,81,81,0,1.0,0.0
1022018055348649985,1,162,20,142,0.12345679012345678,0.8765432098765432
1387239251494965248,0,997,841,156,0.843530591775326,0.15646940822467403
851280086,1,738,70,668,0.0948509485094851,0.9051490514905149
1270022309080969219,0,1000,999,1,0.999,0.001
3065710549,1,172,24,148,0.13953488372093023,0.8604651162790697
1321848240736735233,0,58,57,1,0.9827586206896551,0.017241379310344827
715969908056535040,1,392,120,272,0.30612244897959184,0.6938775510204082
1320057381250846720,0,810,624,186,0.7703703703703704,0.22962962962962963
1076964748888018945,1,757,68,689,0.08982826948480846,0.9101717305151915
1384644212961038338,0,342,341,1,0.9970760233918129,0.0029239766081871343
2779904855,1,1000,85,915,0.085,0.915
38325455,0,746,578,168,0.774798927613941,0.225201072386059
271184973,1,268,19,249,0.0708955223880597,0.9291044776119403
1407565590198378497,0,96,96,0,1.0,0.0
961454031402127361,1,189,14,175,0.07407407407407407,0.9259259259259259
808437952846053376,0,2,2,0,1.0,0.0
215856777,1,496,22,474,0.04435483870967742,0.9556451612903226
1352226616525561857,0,11,11,0,1.0,0.0
188347697,1,232,10,222,0.04310344827586207,0.9568965517241379
889311143763861505,0,86,86,0,1.0,0.0
2459031451,1,207,17,190,0.0821256038647343,0.9178743961352657
41274833,0,965,958,7,0.9927461139896373,0.007253886010362694
1326474968134283265,1,186,8,178,0.043010752688172046,0.956989247311828
803137730414870528,0,87,86,1,0.9885057471264368,0.011494252873563218
1251579077691166720,1,417,57,360,0.1366906474820144,0.8633093525179856
58081519,0,263,253,10,0.9619771863117871,0.03802281368821293
227841653,1,1000,59,941,0.059,0.941
1180817663595032580,0,376,376,0,1.0,0.0
2823309571,1,451,39,412,0.08647450110864745,0.9135254988913526
1078233238005604352,0,1000,870,130,0.87,0.13
1048584763,1,37,16,21,0.43243243243243246,0.5675675675675675
16012211,0,1000,945,55,0.945,0.055
48391246,1,907,200,707,0.2205071664829107,0.7794928335170893
51628161,0,63,53,10,0.8412698412698413,0.15873015873015872
308182977,1,897,74,823,0.08249721293199554,0.9175027870680045
1005297729168388096,0,845,832,13,0.9846153846153847,0.015384615384615385
389406751,1,497,9,488,0.018108651911468814,0.9818913480885312
943572645345484800,0,678,588,90,0.8672566371681416,0.13274336283185842
940223651865128960,0,255,254,1,0.996078431372549,0.00392156862745098
26195407,1,1000,132,868,0.132,0.868
33185281,0,1000,998,2,0.998,0.002
44554267,1,397,48,349,0.12090680100755667,0.8790931989924433
1568626333,0,71,71,0,1.0,0.0
15389191,1,1000,96,904,0.096,0.904
2365195520,0,855,851,4,0.9953216374269006,0.004678362573099415
1378723657099456522,1,414,133,281,0.321256038647343,0.678743961352657
722503279,0,1000,991,9,0.991,0.009
1374215289487908865,1,99,9,90,0.09090909090909091,0.9090909090909091
1323876121373532160,0,1000,985,15,0.985,0.015
857716724979961856,1,536,67,469,0.125,0.875
57464572,0,1000,929,71,0.929,0.071
893853643,1,390,27,363,0.06923076923076923,0.9307692307692308
1270191423162208256,0,44,44,0,1.0,0.0
3622523594,1,145,6,139,0.041379310344827586,0.9586206896551724
1294774151274565632,0,385,383,2,0.9948051948051948,0.005194805194805195
1348481834464595969,1,163,18,145,0.11042944785276074,0.8895705521472392
1059853346302058496,0,386,386,0,1.0,0.0
1313683607374966784,0,1000,997,3,0.997,0.003
1018998584769941504,0,999,991,8,0.991991991991992,0.008008008008008008
55493049,1,945,223,722,0.23597883597883598,0.764021164021164
1513648290834829316,0,360,360,0,1.0,0.0
11918592,1,1000,184,816,0.184,0.816
2827209293,0,582,572,10,0.9828178694158075,0.01718213058419244
1305147163635220482,1,90,15,75,0.16666666666666666,0.8333333333333334
805460031571427328,0,1000,994,6,0.994,0.006
1114154872629231617,1,104,6,98,0.057692307692307696,0.9423076923076923
1472975316301791241,0,75,70,5,0.9333333333333333,0.06666666666666667
112156645,1,635,50,585,0.07874015748031496,0.9212598425196851
2474899595,0,187,187,0,1.0,0.0
728452078738116608,1,972,179,793,0.18415637860082304,0.815843621399177
806822750962798594,0,429,417,12,0.972027972027972,0.027972027972027972
1493050852151549952,1,98,22,76,0.22448979591836735,0.7755102040816326
140682448,0,115,115,0,1.0,0.0
15184908,1,1000,104,896,0.104,0.896
1493385349225402368,0,11,11,0,1.0,0.0
1482095241331159043,1,595,215,380,0.36134453781512604,0.6386554621848739
1459488023754674177,1,246,5,241,0.02032520325203252,0.9796747967479674
288016520,0,496,486,10,0.9798387096774194,0.020161290322580645
1532089429225095178,1,68,23,45,0.3382352941176471,0.6617647058823529
14128849,0,236,234,2,0.9915254237288136,0.00847457627118644
1089541092972941312,1,1000,112,888,0.112,0.888
3361295464,0,251,251,0,1.0,0.0
1512984434097762308,1,325,10,315,0.03076923076923077,0.9692307692307692
2990339822,0,458,454,4,0.9912663755458515,0.008733624454148471
1130618558923333632,1,892,131,761,0.1468609865470852,0.8531390134529148
248018458,0,1000,988,12,0.988,0.012
121952628,1,1000,147,853,0.147,0.853
2610003413,0,1000,964,36,0.964,0.036
1497010744558194689,1,29,2,27,0.06896551724137931,0.9310344827586207
821174936471531525,0,131,131,0,1.0,0.0
1363263762950684672,1,23,5,18,0.21739130434782608,0.782608695652174
846357361430347776,0,466,445,21,0.9549356223175965,0.045064377682403435
1218139863087828993,1,317,90,227,0.28391167192429023,0.7160883280757098
1329451231203520515,0,7,7,0,1.0,0.0
1403787384848846849,1,20,0,20,0.0,1.0
263416294,0,262,262,0,1.0,0.0
120161209,1,200,34,166,0.17,0.83
489136990,0,567,567,0,1.0,0.0
7138732,1,674,136,538,0.20178041543026706,0.798219584569733
769737883804508160,0,400,393,7,0.9825,0.0175
383272636,1,348,36,312,0.10344827586206896,0.896551724137931
128128135,0,132,132,0,1.0,0.0
220455950,1,514,129,385,0.2509727626459144,0.7490272373540856
1266469393661341696,0,104,102,2,0.9807692307692307,0.019230769230769232
574915829,1,154,8,146,0.05194805194805195,0.948051948051948
41128131,0,1000,988,12,0.988,0.012
1291413136566820864,1,623,94,529,0.1508828250401284,0.8491171749598716
158806167,0,794,782,12,0.9848866498740554,0.015113350125944584
804567649049047040,1,733,55,678,0.07503410641200546,0.9249658935879945
1458622376858423298,0,58,58,0,1.0,0.0
1011460624180707329,1,362,17,345,0.04696132596685083,0.9530386740331491
153660864,0,122,122,0,1.0,0.0
117511679,1,208,22,186,0.10576923076923077,0.8942307692307693
1491695227442106370,0,75,74,1,0.9866666666666667,0.013333333333333334
2835261132,1,991,123,868,0.124117053481332,0.875882946518668
1382766808059494403,0,339,317,22,0.9351032448377581,0.06489675516224189
90890267,1,380,22,358,0.05789473684210526,0.9421052631578948
38429589,0,1000,989,11,0.989,0.011
983714120171220992,1,753,46,707,0.06108897742363878,0.9389110225763613
752280109,0,166,162,4,0.9759036144578314,0.024096385542168676
895758034743345152,1,1000,56,944,0.056,0.944
54832403,0,66,66,0,1.0,0.0
2499875814,1,90,12,78,0.13333333333333333,0.8666666666666667
620104952,0,582,567,15,0.9742268041237113,0.02577319587628866
1088509145110573056,1,228,24,204,0.10526315789473684,0.8947368421052632
402836762,0,385,372,13,0.9662337662337662,0.033766233766233764
719282313431896065,1,1000,220,780,0.22,0.78
1037097605614817280,0,323,311,12,0.9628482972136223,0.03715170278637771
2269601972,1,530,24,506,0.045283018867924525,0.9547169811320755
710635003,0,65,65,0,1.0,0.0
1455354498692435974,1,213,17,196,0.07981220657276995,0.92018779342723
24553544,0,792,791,1,0.9987373737373737,0.0012626262626262627
17611596,1,1000,227,773,0.227,0.773
21164844,0,1000,876,124,0.876,0.124
1471416948697227273,0,1000,986,14,0.986,0.014
1393429500,1,591,189,402,0.3197969543147208,0.6802030456852792
4387040417,0,1000,987,13,0.987,0.013
1316948897713975296,1,616,100,516,0.16233766233766234,0.8376623376623377
4425691,0,32,32,0,1.0,0.0
2705424949,1,492,67,425,0.13617886178861788,0.8638211382113821
1366414317969670147,0,786,785,1,0.9987277353689568,0.001272264631043257
17917048,1,1000,74,926,0.074,0.926
1392520912864485376,0,1000,979,21,0.979,0.021
878547261403406336,1,569,32,537,0.056239015817223195,0.9437609841827768
744122562,0,526,526,0,1.0,0.0
1269499596247642112,1,247,19,228,0.07692307692307693,0.9230769230769231
795595851469033472,0,245,243,2,0.9918367346938776,0.00816326530612245
407997782,1,382,123,259,0.3219895287958115,0.6780104712041884
13889262,0,63,60,3,0.9523809523809523,0.047619047619047616
2862656088,1,518,91,427,0.17567567567567569,0.8243243243243243
4886414601,0,541,540,1,0.9981515711645101,0.0018484288354898336
29030047,1,793,86,707,0.10844892812105927,0.8915510718789408
22598032,0,831,809,22,0.97352587244284,0.026474127557160047
985885766051037184,1,363,67,296,0.18457300275482094,0.8154269972451791
577586037,0,1000,996,4,0.996,0.004
2790475743,1,580,154,426,0.2655172413793103,0.7344827586206897
817756229225353216,0,319,318,1,0.9968652037617555,0.003134796238244514
801425273463967744,1,1000,78,922,0.078,0.922
33742079,0,438,417,21,0.952054794520548,0.04794520547945205
850912552397570048,1,950,165,785,0.1736842105263158,0.8263157894736842
1458844334703489027,0,131,130,1,0.9923664122137404,0.007633587786259542
474437338,1,783,14,769,0.017879948914431672,0.9821200510855683
1071220278771007488,0,1000,991,9,0.991,0.009
1100473741593718784,0,95,94,1,0.9894736842105263,0.010526315789473684
822470232291692544,1,636,105,531,0.1650943396226415,0.8349056603773585
75946098,0,767,767,0,1.0,0.0
587054500,1,1000,199,801,0.199,0.801
232660342,0,1000,980,20,0.98,0.02
1235219890853883904,1,202,29,173,0.14356435643564355,0.8564356435643564
247519604,0,250,244,6,0.976,0.024
2267060820,1,894,54,840,0.06040268456375839,0.9395973154362416
88538287,0,1000,996,4,0.996,0.004
766117119939448832,1,1000,164,836,0.164,0.836
21845346,0,525,525,0,1.0,0.0
27499456,1,1000,84,916,0.084,0.916
1201041105598345216,0,1000,992,8,0.992,0.008
1101208392494972930,1,1000,52,948,0.052,0.948
1341908631382593547,0,197,197,0,1.0,0.0
1488003713298018304,1,259,31,228,0.11969111969111969,0.8803088803088803
1464409504402059266,0,46,46,0,1.0,0.0
266004492,1,1000,29,971,0.029,0.971
1384542286470545408,0,187,186,1,0.9946524064171123,0.0053475935828877
1242845707356319744,1,572,233,339,0.40734265734265734,0.5926573426573427
744187380,0,372,359,13,0.9650537634408602,0.03494623655913978
722673265,1,231,71,160,0.30735930735930733,0.6926406926406926
76712344,0,1000,970,30,0.97,0.03
4161239919,1,221,55,166,0.248868778280543,0.751131221719457
906635821,0,114,114,0,1.0,0.0
1082452448873193472,1,1000,260,740,0.26,0.74
2325899132,1,1000,20,980,0.02,0.98
2563831999,0,339,327,12,0.9646017699115044,0.035398230088495575
1402323502997331979,1,65,5,60,0.07692307692307693,0.9230769230769231
725735600,0,293,286,7,0.9761092150170648,0.023890784982935155
2925878579,1,469,74,395,0.15778251599147122,0.8422174840085288
1441735343825305603,0,175,175,0,1.0,0.0
23095055,1,517,18,499,0.03481624758220503,0.965183752417795
256348177,0,528,526,2,0.9962121212121212,0.003787878787878788
1140917923382464512,0,516,516,0,1.0,0.0
326350276,0,495,494,1,0.997979797979798,0.00202020202020202
2841861485,1,603,98,505,0.1625207296849088,0.8374792703150912
636229378,0,354,340,14,0.96045197740113,0.03954802259887006
276082414,1,759,123,636,0.16205533596837945,0.8379446640316206
1116142810720288768,0,475,427,48,0.8989473684210526,0.10105263157894737
15487730,1,413,141,272,0.3414043583535109,0.6585956416464891
1150812869321080839,0,1000,950,50,0.95,0.05
1317282829,1,221,17,204,0.07692307692307693,0.9230769230769231
2154677961,0,787,753,34,0.9567979669631512,0.043202033036848796
47680570,1,263,7,256,0.026615969581749048,0.973384030418251
1129878569838977024,0,329,324,5,0.9848024316109423,0.015197568389057751
1495875768420818953,1,161,7,154,0.043478260869565216,0.9565217391304348
437029438,0,1000,991,9,0.991,0.009
791778304093192192,1,318,59,259,0.18553459119496854,0.8144654088050315
2688071861,0,1000,991,9,0.991,0.009
3246386390,1,335,46,289,0.1373134328358209,0.8626865671641791
1171850200245264384,1,418,42,376,0.10047846889952153,0.8995215311004785
1450233812936314883,0,90,90,0,1.0,0.0
283510997,1,1000,175,825,0.175,0.825
2366190558,0,878,816,62,0.929384965831435,0.07061503416856492
896283551578050561,1,215,36,179,0.16744186046511628,0.8325581395348837
1456403847291752449,0,541,538,3,0.9944547134935305,0.005545286506469501
1230727553834373121,1,556,249,307,0.447841726618705,0.552158273381295
1172878583410364416,0,298,297,1,0.9966442953020134,0.003355704697986577
226176697,1,1000,106,894,0.106,0.894
990109454946521088,0,266,266,0,1.0,0.0
1016096427943038982,1,724,137,587,0.18922651933701656,0.8107734806629834
2259352532,0,916,891,25,0.972707423580786,0.027292576419213975
54358910,0,944,873,71,0.9247881355932204,0.07521186440677965
38371804,1,376,64,312,0.1702127659574468,0.8297872340425532
33124889,0,1000,986,14,0.986,0.014
484425517,1,1000,119,881,0.119,0.881
1536177709826580481,0,9,9,0,1.0,0.0
283096101,1,590,61,529,0.10338983050847457,0.8966101694915254
3289076784,0,131,111,20,0.8473282442748091,0.15267175572519084
755352921865330688,1,593,57,536,0.09612141652613827,0.9038785834738617
1064971775119974401,0,86,86,0,1.0,0.0
759802355256795136,1,836,126,710,0.1507177033492823,0.8492822966507177
291464886,0,1000,965,35,0.965,0.035
886008155297153025,1,412,10,402,0.024271844660194174,0.9757281553398058
1046498330342232064,0,156,152,4,0.9743589743589743,0.02564102564102564
2229381,1,1000,91,909,0.091,0.909
2660107893,0,461,458,3,0.9934924078091106,0.006507592190889371
1516873918702882816,1,302,115,187,0.38079470198675497,0.6192052980132451
1187518603089928192,0,769,762,7,0.9908972691807543,0.009102730819245773
1149914041667768320,1,1000,186,814,0.186,0.814
163561946,0,1000,998,2,0.998,0.002
20489393,1,1000,75,925,0.075,0.925
1504567484686508032,0,247,247,0,1.0,0.0
2176195576,1,158,15,143,0.0949367088607595,0.9050632911392406
425664205,0,1000,976,24,0.976,0.024
875883868880080896,1,393,23,370,0.058524173027989825,0.9414758269720102
2612057125,0,79,79,0,1.0,0.0
283281348,1,238,22,216,0.09243697478991597,0.907563025210084
42969333,0,230,219,11,0.9521739130434783,0.04782608695652174
1033797156417794049,1,232,14,218,0.0603448275862069,0.9396551724137931
1274589314085556225,0,481,437,44,0.9085239085239085,0.09147609147609148
7097372,1,476,87,389,0.18277310924369747,0.8172268907563025
798692402609451008,1,435,21,414,0.04827586206896552,0.9517241379310345
15895237,0,182,181,1,0.9945054945054945,0.005494505494505495
1443716739401859074,1,30,0,30,0.0,1.0
1312359526675353602,0,178,174,4,0.9775280898876404,0.02247191011235955
59340698,1,763,137,626,0.17955439056356487,0.8204456094364351
1372419827738972169,0,128,128,0,1.0,0.0
2804746860,1,525,127,398,0.2419047619047619,0.758095238095238
1306452791066464258,0,1000,999,1,0.999,0.001
108738787,1,849,106,743,0.1248527679623086,0.8751472320376914
1344113769870483456,0,248,243,5,0.9798387096774194,0.020161290322580645
631237078,1,1000,155,845,0.155,0.845
1196326985674264576,0,430,422,8,0.9813953488372092,0.018604651162790697
2533681651,1,740,229,511,0.30945945945945946,0.6905405405405406
1258594554426601475,0,1000,949,51,0.949,0.051
213806817,1,970,245,725,0.25257731958762886,0.7474226804123711
4832543472,0,217,216,1,0.9953917050691244,0.004608294930875576
26599173,1,410,62,348,0.15121951219512195,0.848780487804878
1066949072248926208,0,164,162,2,0.9878048780487805,0.012195121951219513
1414058466369433605,1,63,21,42,0.3333333333333333,0.6666666666666666
411816199,0,522,507,15,0.9712643678160919,0.028735632183908046
3305657789,1,495,107,388,0.21616161616161617,0.7838383838383839
807192658158370821,0,171,171,0,1.0,0.0
1378448855310594048,1,178,34,144,0.19101123595505617,0.8089887640449438
51187526,0,213,213,0,1.0,0.0
4780225672,1,1000,247,753,0.247,0.753
476180907,0,358,354,4,0.9888268156424581,0.0111731843575419
976557483253788678,1,1000,151,849,0.151,0.849
1430641015937851393,0,39,36,3,0.9230769230769231,0.07692307692307693
1016452016,1,578,15,563,0.025951557093425604,0.9740484429065744
3409921815,0,559,558,1,0.998211091234347,0.0017889087656529517
1204528160517308417,1,1000,110,890,0.11,0.89
921489978005139456,0,39,39,0,1.0,0.0
232698536,1,782,65,717,0.08312020460358056,0.9168797953964194
12422792,0,353,339,14,0.9603399433427762,0.039660056657223795
559132857,1,241,2,239,0.008298755186721992,0.991701244813278
1084569399766536192,0,42,41,1,0.9761904761904762,0.023809523809523808
618231549,1,1000,291,709,0.291,0.709
1430573329287634948,0,455,449,6,0.9868131868131869,0.013186813186813187
3947811437,1,1000,97,903,0.097,0.903
2405801681,0,89,88,1,0.9887640449438202,0.011235955056179775
84177590,1,1000,203,797,0.203,0.797
37285781,0,1000,980,20,0.98,0.02
317909076,1,435,46,389,0.10574712643678161,0.8942528735632184
738142704886898688,0,885,885,0,1.0,0.0
72406684,1,243,18,225,0.07407407407407407,0.9259259259259259
248914097,0,1000,995,5,0.995,0.005
1493098364,1,1000,151,849,0.151,0.849
329822910,0,1000,999,1,0.999,0.001
505175753,1,234,16,218,0.06837606837606838,0.9316239316239316
831116665655943168,0,722,715,7,0.9903047091412742,0.009695290858725761
849766169661845504,1,125,11,114,0.088,0.912
353396717,0,1000,999,1,0.999,0.001
560851455,1,1000,51,949,0.051,0.949
1288467096,0,129,129,0,1.0,0.0
1018269065813614593,1,1000,151,849,0.151,0.849
933415273,0,897,860,37,0.9587513935340022,0.04124860646599777
3218719562,1,1000,368,632,0.368,0.632
2181362224,0,958,937,21,0.9780793319415448,0.021920668058455117
3070940336,1,635,46,589,0.07244094488188976,0.9275590551181102
1486799650883575811,0,492,491,1,0.9979674796747967,0.0020325203252032522
3436076596,1,289,36,253,0.1245674740484429,0.8754325259515571
1090683056858558465,1,421,29,392,0.0688836104513064,0.9311163895486936
986295178574139392,0,1000,994,6,0.994,0.006
2877047215,1,692,171,521,0.24710982658959538,0.7528901734104047
629966983,0,212,211,1,0.9952830188679245,0.0047169811320754715
492674746,1,693,158,535,0.227994227994228,0.772005772005772
372069550,0,237,231,6,0.9746835443037974,0.02531645569620253
1499442397985574922,1,616,144,472,0.23376623376623376,0.7662337662337663
1229914788911894529,0,567,488,79,0.8606701940035273,0.13932980599647266
1344061170076946432,1,2,1,1,0.5,0.5
1145323119042678787,0,972,964,8,0.9917695473251029,0.00823045267489712
119896541,1,341,82,259,0.2404692082111437,0.7595307917888563
98910908,0,1000,971,29,0.971,0.029
1430171507385376777,1,49,1,48,0.02040816326530612,0.9795918367346939
1201760028882898944,0,419,413,6,0.9856801909307876,0.014319809069212411
568683364,1,519,19,500,0.036608863198458574,0.9633911368015414
756939775165227014,0,149,142,7,0.9530201342281879,0.04697986577181208
365267269,1,1000,89,911,0.089,0.911
888895726633140224,0,237,236,1,0.9957805907172996,0.004219409282700422
1028084498,1,679,34,645,0.050073637702503684,0.9499263622974963
740835093648969728,0,312,312,0,1.0,0.0
1108554221283098624,1,647,116,531,0.17928902627511592,0.8207109737248841
3041998472,0,217,215,2,0.9907834101382489,0.009216589861751152
1626647827,1,1000,211,789,0.211,0.789
14098082,0,615,585,30,0.9512195121951219,0.04878048780487805
456670835,0,933,915,18,0.9807073954983923,0.01929260450160772
232729395,1,404,75,329,0.18564356435643564,0.8143564356435643
1501619923466006538,0,12,12,0,1.0,0.0
5936312,1,322,50,272,0.15527950310559005,0.84472049689441
289560681,1,1000,42,958,0.042,0.958
1484873326312972288,0,379,346,33,0.9129287598944591,0.0870712401055409
934434331572961280,1,1000,128,872,0.128,0.872
1321602378324430848,0,20,16,4,0.8,0.2
890310054032924672,1,296,23,273,0.0777027027027027,0.9222972972972973
1402456419350159362,0,1000,999,1,0.999,0.001
916674604265017344,1,221,10,211,0.04524886877828054,0.9547511312217195
3651928994,0,728,720,8,0.989010989010989,0.01098901098901099
1923395773,1,234,37,197,0.1581196581196581,0.8418803418803419
1006395510624849920,0,217,217,0,1.0,0.0
56419038,1,542,21,521,0.03874538745387454,0.9612546125461254
1416140207057903616,0,119,84,35,0.7058823529411765,0.29411764705882354
1116899403552444416,1,729,245,484,0.33607681755829905,0.663923182441701
621422144,0,1000,996,4,0.996,0.004
253260057,1,1000,28,972,0.028,0.972
36080541,0,180,180,0,1.0,0.0
2258105042,1,282,17,265,0.06028368794326241,0.9397163120567376
1358315750516285442,0,134,120,14,0.8955223880597015,0.1044776119402985
44389431,1,714,96,618,0.13445378151260504,0.865546218487395
976997589622157312,0,1000,999,1,0.999,0.001
246403415,1,790,3,787,0.0037974683544303796,0.9962025316455696
1409582970843848707,0,616,595,21,0.9659090909090909,0.03409090909090909
2343861236,1,244,20,224,0.08196721311475409,0.9180327868852459
2382833827,0,542,538,4,0.992619926199262,0.007380073800738007
799361174,1,1000,222,778,0.222,0.778
15836786,0,1000,978,22,0.978,0.022
181090363,1,474,44,430,0.09282700421940929,0.9071729957805907
1446689679290650627,0,495,481,14,0.9717171717171718,0.028282828282828285
994272141792116736,1,341,72,269,0.21114369501466276,0.7888563049853372
937101919570423808,0,610,608,2,0.9967213114754099,0.003278688524590164
758541530,1,1000,132,868,0.132,0.868
1390698215796838402,0,989,982,7,0.9929221435793731,0.007077856420626896
560084928,1,1000,82,918,0.082,0.918
3918649528,0,710,708,2,0.9971830985915493,0.0028169014084507044
1096473249821671424,1,356,92,264,0.25842696629213485,0.7415730337078652
1228294274,0,188,186,2,0.9893617021276596,0.010638297872340425
28283188,1,101,11,90,0.10891089108910891,0.8910891089108911
824614872432439297,0,92,84,8,0.9130434782608695,0.08695652173913043
459649367,1,780,125,655,0.16025641025641027,0.8397435897435898
2192082620,0,1000,997,3,0.997,0.003
61948343,1,1000,180,820,0.18,0.82
70998793,0,1000,988,12,0.988,0.012
21193021,0,999,770,229,0.7707707707707707,0.22922922922922923
2760089947,1,884,28,856,0.03167420814479638,0.9683257918552036
1041682821205483520,0,240,237,3,0.9875,0.0125
757714694,1,1000,365,635,0.365,0.635
1480136178422755328,0,107,106,1,0.9906542056074766,0.009345794392523364
4670374934,1,1000,64,936,0.064,0.936
506083150,0,1000,895,105,0.895,0.105
1571544798,1,514,50,464,0.09727626459143969,0.9027237354085603
1493331487168634883,0,1000,996,4,0.996,0.004
102517528,1,999,186,813,0.18618618618618618,0.8138138138138138
540422766,0,1000,999,1,0.999,0.001
554551387,1,652,107,545,0.16411042944785276,0.8358895705521472
3023791078,1,740,96,644,0.12972972972972974,0.8702702702702703
1011042874664710145,0,1000,991,9,0.991,0.009
896476938390437894,1,352,70,282,0.19886363636363635,0.8011363636363636
4759905853,0,51,49,2,0.9607843137254902,0.0392156862745098
23831092,1,416,20,396,0.04807692307692308,0.9519230769230769
185712608,0,1000,968,32,0.968,0.032
796091824515391488,1,149,12,137,0.08053691275167785,0.9194630872483222
1299893437517365249,0,313,313,0,1.0,0.0
822451392,1,1000,185,815,0.185,0.815
64932019,0,536,533,3,0.9944029850746269,0.005597014925373134
1359913238125813760,1,22,4,18,0.18181818181818182,0.8181818181818182
348516596,0,304,303,1,0.9967105263157895,0.003289473684210526
1730331926,1,232,66,166,0.28448275862068967,0.7155172413793104
1313375594822791168,1,784,65,719,0.08290816326530612,0.9170918367346939
419118169,0,1000,991,9,0.991,0.009
1627788793,1,1000,108,892,0.108,0.892
1117596912465666048,0,256,256,0,1.0,0.0
4894669236,1,492,39,453,0.07926829268292683,0.9207317073170732
243079893,0,868,826,42,0.9516129032258065,0.04838709677419355
1494255683491008513,1,24,0,24,0.0,1.0
907433502974640129,0,85,85,0,1.0,0.0
838791370135449601,1,166,16,150,0.0963855421686747,0.9036144578313253
798689336829022208,0,420,416,4,0.9904761904761905,0.009523809523809525
1075612251833417728,1,88,5,83,0.056818181818181816,0.9431818181818182
1388145847339159553,0,64,64,0,1.0,0.0
259552210,1,980,56,924,0.05714285714285714,0.9428571428571428
17668816,0,81,73,8,0.9012345679012346,0.09876543209876543
1065553015627759616,1,1000,101,899,0.101,0.899
2785991501,0,108,108,0,1.0,0.0
1031958453500047360,1,1000,186,814,0.186,0.814
565281850,0,232,228,4,0.9827586206896551,0.017241379310344827
1173132350,1,1000,209,791,0.209,0.791
825153219663974406,0,41,38,3,0.926829268292683,0.07317073170731707
785641624135094276,1,837,97,740,0.11589008363201912,0.8841099163679809
1140400778458411008,0,1000,999,1,0.999,0.001
20904274,1,600,21,579,0.035,0.965
1477024703722270721,0,326,298,28,0.9141104294478528,0.08588957055214724
2606742457,0,1000,993,7,0.993,0.007
1072019347,1,863,45,818,0.05214368482039398,0.947856315179606
103300327,1,329,57,272,0.17325227963525835,0.8267477203647416
1330130919064297475,0,1000,942,58,0.942,0.058
1285370475674251271,1,136,6,130,0.04411764705882353,0.9558823529411765
96624113,0,592,591,1,0.9983108108108109,0.0016891891891891893
94384452,1,321,69,252,0.21495327102803738,0.7850467289719626
1440842851714146312,0,101,96,5,0.9504950495049505,0.04950495049504951
1301911237274382336,1,55,7,48,0.12727272727272726,0.8727272727272727
1149149043068719104,0,202,202,0,1.0,0.0
722247190018527232,1,109,7,102,0.06422018348623854,0.9357798165137615
1295924675730640896,0,112,112,0,1.0,0.0
1389795299573522432,1,568,119,449,0.20950704225352113,0.7904929577464789
622591823,0,542,540,2,0.996309963099631,0.0036900369003690036
166169203,1,445,31,414,0.0696629213483146,0.9303370786516854
1638249096,0,76,76,0,1.0,0.0
1546463455,1,528,30,498,0.056818181818181816,0.9431818181818182
1439053584,0,344,344,0,1.0,0.0
1333549200236154880,1,247,47,200,0.1902834008097166,0.8097165991902834
958723000618110978,0,336,333,3,0.9910714285714286,0.008928571428571428
846087950,1,275,89,186,0.3236363636363636,0.6763636363636364
1435791627747045379,0,30,23,7,0.7666666666666667,0.23333333333333334
24836339,1,436,30,406,0.06880733944954129,0.9311926605504587
45830935,0,253,243,10,0.9604743083003953,0.039525691699604744
778152703943999488,1,177,19,158,0.10734463276836158,0.8926553672316384
309768600,0,173,173,0,1.0,0.0
353047176,1,458,110,348,0.24017467248908297,0.759825327510917
38287402,0,156,156,0,1.0,0.0
1237104205585924096,1,1000,278,722,0.278,0.722
211597305,0,1000,996,4,0.996,0.004
329495717,1,547,200,347,0.3656307129798903,0.6343692870201096
1052868850650415104,0,213,212,1,0.9953051643192489,0.004694835680751174
1245172974,1,1000,324,676,0.324,0.676
775087720737538048,0,342,342,0,1.0,0.0
1334470450718650368,1,32,9,23,0.28125,0.71875
36668201,0,331,330,1,0.9969788519637462,0.0030211480362537764
1479930400327835654,1,437,79,358,0.18077803203661327,0.8192219679633868
783892761397239808,0,496,483,13,0.9737903225806451,0.02620967741935484
1261528831665623043,1,223,16,207,0.07174887892376682,0.9282511210762332
1114634185539563521,0,124,121,3,0.9758064516129032,0.024193548387096774
573281316,1,772,50,722,0.06476683937823834,0.9352331606217616
770336912,0,132,131,1,0.9924242424242424,0.007575757575757576
1232838048,1,266,74,192,0.2781954887218045,0.7218045112781954
1476312187908116490,0,238,166,72,0.6974789915966386,0.3025210084033613
722991393107402753,1,1000,30,970,0.03,0.97
846694632142622720,0,251,235,16,0.9362549800796812,0.06374501992031872
94845303,0,9,9,0,1.0,0.0
127400552,1,1000,146,854,0.146,0.854
1166594663551262721,0,1000,961,39,0.961,0.039
742127348661772288,1,1000,156,844,0.156,0.844
978060162136031232,0,112,110,2,0.9821428571428571,0.017857142857142856
34061375,1,430,19,411,0.044186046511627906,0.9558139534883721
36538802,0,520,514,6,0.9884615384615385,0.011538461538461539
19555275,1,547,31,516,0.056672760511883,0.943327239488117
888212098177654785,0,997,963,34,0.9658976930792377,0.034102306920762285
243685893,1,1000,100,900,0.1,0.9
1516632344433594368,0,20,20,0,1.0,0.0
1108043915951828992,1,134,8,126,0.05970149253731343,0.9402985074626866
1490459091839320064,0,1000,994,6,0.994,0.006
1355892315747987456,1,169,32,137,0.1893491124260355,0.8106508875739645
1490736927804465155,0,822,809,13,0.9841849148418491,0.015815085158150853
2931771820,1,1000,146,854,0.146,0.854
1180966563526131713,0,1000,993,7,0.993,0.007
3266789317,1,393,105,288,0.26717557251908397,0.732824427480916
3107416806,0,155,153,2,0.9870967741935484,0.012903225806451613
360358511,1,602,50,552,0.08305647840531562,0.9169435215946844
1327536927411752960,0,139,139,0,1.0,0.0
1060742184813690880,1,240,11,229,0.04583333333333333,0.9541666666666667
1037903944054435846,0,119,116,3,0.9747899159663865,0.025210084033613446
853456234913181696,1,1000,175,825,0.175,0.825
151554597,0,1000,989,11,0.989,0.011
1502684707548499982,0,31,30,1,0.967741935483871,0.03225806451612903
1270136908052660224,1,810,33,777,0.040740740740740744,0.9592592592592593
270203376,0,136,136,0,1.0,0.0
298286653,1,234,9,225,0.038461538461538464,0.9615384615384616
428583089,0,1000,884,116,0.884,0.116
241597797,1,1000,62,938,0.062,0.938
27001053,0,1000,997,3,0.997,0.003
48032168,1,1000,199,801,0.199,0.801
1505990393564913664,0,67,67,0,1.0,0.0
1241599952129646592,1,71,16,55,0.22535211267605634,0.7746478873239436
41844233,0,349,330,19,0.9455587392550143,0.054441260744985676
30203368,1,1000,58,942,0.058,0.942
796545686980280320,0,440,437,3,0.9931818181818182,0.006818181818181818
829061190131216386,1,295,35,260,0.11864406779661017,0.8813559322033898
875199115,0,168,168,0,1.0,0.0
2996219751,1,398,13,385,0.032663316582914576,0.9673366834170855
1066495009711521792,1,144,46,98,0.3194444444444444,0.6805555555555556
1212566471336849408,0,788,725,63,0.9200507614213198,0.0799492385786802
33431183,1,781,29,752,0.03713188220230474,0.9628681177976952
4499048540,0,1000,980,20,0.98,0.02
390922386,1,1000,311,689,0.311,0.689
3243919370,0,161,160,1,0.9937888198757764,0.006211180124223602
1386974121787940865,1,283,23,260,0.0812720848056537,0.9187279151943463
748705108112740352,0,240,185,55,0.7708333333333334,0.22916666666666666
1281099231521013760,1,1000,189,811,0.189,0.811
955961210180132865,0,836,836,0,1.0,0.0
613195056,1,681,91,590,0.13362701908957417,0.8663729809104258
1367756261668904962,0,36,36,0,1.0,0.0
3131434395,1,339,124,215,0.36578171091445427,0.6342182890855457
322154024,0,183,183,0,1.0,0.0
445304536,1,1000,237,763,0.237,0.763
172445787,0,347,347,0,1.0,0.0
3863918787,1,275,25,250,0.09090909090909091,0.9090909090909091
1003488903603675138,0,1000,950,50,0.95,0.05
1028539068,1,524,57,467,0.10877862595419847,0.8912213740458015
845360700,0,1000,889,111,0.889,0.111
1882601,1,1000,90,910,0.09,0.91
553767763,0,29,29,0,1.0,0.0
1486833825028132865,1,9,0,9,0.0,1.0
614474284,0,293,291,2,0.9931740614334471,0.006825938566552901
895187761250086917,1,395,107,288,0.2708860759493671,0.7291139240506329
373507385,0,47,47,0,1.0,0.0
30796479,1,405,12,393,0.02962962962962963,0.9703703703703703
1040384565267836928,0,58,57,1,0.9827586206896551,0.017241379310344827
2882474480,1,661,167,494,0.2526475037821483,0.7473524962178517
915964809203531777,0,117,110,7,0.9401709401709402,0.05982905982905983
14307124,1,739,90,649,0.12178619756427606,0.878213802435724
3433716759,0,217,201,16,0.9262672811059908,0.07373271889400922
1280710214480789505,1,213,66,147,0.30985915492957744,0.6901408450704225
843477901,0,106,105,1,0.9905660377358491,0.009433962264150943
1388273464323321863,1,261,17,244,0.06513409961685823,0.9348659003831418
1648104127,0,42,42,0,1.0,0.0
4461168076,1,64,26,38,0.40625,0.59375
3254391415,0,541,521,20,0.9630314232902033,0.036968576709796676
2790821220,1,250,22,228,0.088,0.912
602054994,0,875,870,5,0.9942857142857143,0.005714285714285714
163612692,1,823,80,743,0.09720534629404617,0.9027946537059538
1306469209065439232,0,150,149,1,0.9933333333333333,0.006666666666666667
302303831,1,423,29,394,0.06855791962174941,0.9314420803782506
279822493,0,1000,915,85,0.915,0.085
127045111,1,192,13,179,0.06770833333333333,0.9322916666666666
380132512,0,999,981,18,0.9819819819819819,0.018018018018018018
75682035,1,1000,88,912,0.088,0.912
36781243,0,785,780,5,0.9936305732484076,0.006369426751592357
560666832,1,1000,92,908,0.092,0.908
1084274837831540736,0,510,509,1,0.9980392156862745,0.00196078431372549
976267497044262912,1,223,48,175,0.21524663677130046,0.7847533632286996
1141806037701464065,0,67,67,0,1.0,0.0
1250946309487501312,1,683,98,585,0.14348462664714495,0.8565153733528551
438984403,0,1000,998,2,0.998,0.002
1156361892509749248,1,215,31,184,0.14418604651162792,0.8558139534883721
2923381672,0,1000,961,39,0.961,0.039
361376549,1,397,30,367,0.07556675062972293,0.924433249370277
830485541594361856,0,179,159,20,0.888268156424581,0.11173184357541899
1212307725192810496,1,852,44,808,0.051643192488262914,0.9483568075117371
3237440028,0,1000,992,8,0.992,0.008
1250624802324393987,1,136,11,125,0.08088235294117647,0.9191176470588235
615510532,0,213,210,3,0.9859154929577465,0.014084507042253521
968323734091304972,1,1000,143,857,0.143,0.857
1347205780353777664,0,77,77,0,1.0,0.0
42531494,1,954,105,849,0.11006289308176101,0.889937106918239
2260961328,0,432,429,3,0.9930555555555556,0.006944444444444444
1176220179371560961,1,200,23,177,0.115,0.885
864251957044801536,0,188,183,5,0.973404255319149,0.026595744680851064
1073321433038839812,1,1000,79,921,0.079,0.921
751956684906475520,0,107,101,6,0.9439252336448598,0.056074766355140186
2944882649,1,356,23,333,0.06460674157303371,0.9353932584269663
447484541,0,1000,985,15,0.985,0.015
280173978,1,204,31,173,0.15196078431372548,0.8480392156862745
940568068849307648,0,821,819,2,0.997563946406821,0.00243605359317905
1134467518620426241,1,1000,143,857,0.143,0.857
1102174716,0,225,225,0,1.0,0.0
742820522,1,888,42,846,0.0472972972972973,0.9527027027027027
1166727032,0,327,319,8,0.9755351681957186,0.024464831804281346
3128178603,0,413,405,8,0.9806295399515739,0.01937046004842615
1153527351361384448,1,348,90,258,0.25862068965517243,0.7413793103448276
882747427274592259,0,428,427,1,0.9976635514018691,0.002336448598130841
7302682,1,989,75,914,0.07583417593528817,0.9241658240647118
761620957240766464,0,384,383,1,0.9973958333333334,0.0026041666666666665
108077976,1,1000,93,907,0.093,0.907
788702507102904320,0,292,284,8,0.9726027397260274,0.0273972602739726
1206840930122248192,1,281,56,225,0.199288256227758,0.800711743772242
560114150,0,93,87,6,0.9354838709677419,0.06451612903225806
356519662,0,618,617,1,0.9983818770226537,0.0016181229773462784
105952472,1,642,98,544,0.1526479750778816,0.8473520249221184
849310744046915585,0,60,58,2,0.9666666666666667,0.03333333333333333
806901791187210240,1,213,13,200,0.06103286384976526,0.9389671361502347
994020889397284864,0,488,488,0,1.0,0.0
29122186,1,362,60,302,0.16574585635359115,0.8342541436464088
862138012502831108,0,430,391,39,0.9093023255813953,0.09069767441860466
920881292438392833,1,223,27,196,0.1210762331838565,0.8789237668161435
1222379240605175808,0,90,82,8,0.9111111111111111,0.08888888888888889
1058218418,1,419,77,342,0.18377088305489261,0.8162291169451074
2718434741,0,742,723,19,0.9743935309973046,0.025606469002695417
779130031,1,615,143,472,0.23252032520325203,0.767479674796748
2952580719,0,440,435,5,0.9886363636363636,0.011363636363636364
24283520,1,1000,379,621,0.379,0.621
890238243068932097,0,616,596,20,0.9675324675324676,0.032467532467532464
547016140,1,213,25,188,0.11737089201877934,0.8826291079812206
1345481639313465387,0,288,286,2,0.9930555555555556,0.006944444444444444
106439363,1,276,61,215,0.2210144927536232,0.7789855072463768
65693218,0,698,691,7,0.9899713467048711,0.01002865329512894
1034321571693752320,1,146,14,132,0.0958904109589041,0.9041095890410958
925501982927917056,0,470,470,0,1.0,0.0
14423880,1,543,78,465,0.143646408839779,0.856353591160221
19154806,0,784,731,53,0.9323979591836735,0.06760204081632654
1153318460929318913,1,1000,61,939,0.061,0.939
799121189608288256,0,985,978,7,0.9928934010152284,0.007106598984771574
2862103966,1,233,23,210,0.09871244635193133,0.9012875536480687
1052046694605451264,0,788,784,4,0.9949238578680203,0.005076142131979695
20538658,1,1000,62,938,0.062,0.938
1113933280087166976,0,183,181,2,0.9890710382513661,0.01092896174863388
77411494,1,1000,178,822,0.178,0.822
1485639000731926534,0,294,285,9,0.9693877551020408,0.030612244897959183
785274782795177984,1,942,177,765,0.18789808917197454,0.8121019108280255
979906139235201024,0,4,4,0,1.0,0.0
18771078,1,1000,97,903,0.097,0.903
278698679,0,982,981,1,0.9989816700610998,0.0010183299389002036
1042625083137617920,1,213,20,193,0.09389671361502347,0.9061032863849765
726343943516905472,0,282,276,6,0.9787234042553191,0.02127659574468085
1720921670,1,216,9,207,0.041666666666666664,0.9583333333333334
419992294,0,126,125,1,0.9920634920634921,0.007936507936507936
1268362426166042624,1,56,2,54,0.03571428571428571,0.9642857142857143
1091127704152244224,0,44,44,0,1.0,0.0
804577277472284673,1,240,19,221,0.07916666666666666,0.9208333333333333
1530992126502256641,0,40,40,0,1.0,0.0
157756704,1,437,62,375,0.14187643020594964,0.8581235697940504
397583204,0,698,693,5,0.9928366762177651,0.0071633237822349575
1071157634810695681,1,140,7,133,0.05,0.95
2253167061,0,154,154,0,1.0,0.0
234286799,1,983,113,870,0.11495422177009156,0.8850457782299085
3245497166,0,145,143,2,0.9862068965517241,0.013793103448275862
1129863126,1,548,57,491,0.10401459854014598,0.8959854014598541
320821826,0,300,300,0,1.0,0.0
2759091817,1,190,47,143,0.24736842105263157,0.7526315789473684
1269308881123061763,0,469,469,0,1.0,0.0
155210758,1,1000,91,909,0.091,0.909
735286164387704832,0,358,353,5,0.9860335195530726,0.013966480446927373
912891637,1,1000,176,824,0.176,0.824
1134710060876214272,0,88,85,3,0.9659090909090909,0.03409090909090909
796389335461306368,1,216,40,176,0.18518518518518517,0.8148148148148148
1330214271511310340,0,289,284,5,0.9826989619377162,0.01730103806228374
2935835683,1,833,212,621,0.2545018007202881,0.7454981992797118
1100416755845996545,0,233,226,7,0.9699570815450643,0.030042918454935622
17787312,1,1000,270,730,0.27,0.73
1428724509398368260,0,1000,998,2,0.998,0.002
2978752669,1,1000,47,953,0.047,0.953
23525456,0,877,857,20,0.9771949828962372,0.02280501710376283
1358572290015911938,1,622,88,534,0.1414790996784566,0.8585209003215434
1347104740455428103,0,207,206,1,0.9951690821256038,0.004830917874396135
156429988,0,1000,975,25,0.975,0.025
1063191522806587397,1,381,72,309,0.1889763779527559,0.8110236220472441
48109254,0,370,345,25,0.9324324324324325,0.06756756756756757
20343802,1,1000,91,909,0.091,0.909
831622817338716160,0,75,75,0,1.0,0.0
1059297265775456257,1,1000,99,901,0.099,0.901
1351718886878687233,0,39,38,1,0.9743589743589743,0.02564102564102564
1101160922,0,745,730,15,0.9798657718120806,0.020134228187919462
745766668744298496,1,356,66,290,0.1853932584269663,0.8146067415730337
17798426,0,152,152,0,1.0,0.0
345087946,1,888,39,849,0.04391891891891892,0.956081081081081
273358332,0,512,507,5,0.990234375,0.009765625
921595355577303041,1,610,131,479,0.21475409836065573,0.7852459016393443
891727844,0,253,243,10,0.9604743083003953,0.039525691699604744
1222867185422364672,1,358,69,289,0.19273743016759776,0.8072625698324022
75535786,0,827,819,8,0.9903264812575574,0.009673518742442563
774951528834543617,1,335,23,312,0.06865671641791045,0.9313432835820895
112035791,0,1000,948,52,0.948,0.052
733640839,1,554,42,512,0.07581227436823104,0.924187725631769
3235422798,0,91,91,0,1.0,0.0
1017971936842928128,1,81,5,76,0.06172839506172839,0.9382716049382716
998950961073807361,0,805,758,47,0.9416149068322981,0.058385093167701865
1424840499953688576,1,1000,161,839,0.161,0.839
868188362611576832,0,21,21,0,1.0,0.0
1095841184440815616,1,1000,83,917,0.083,0.917
804053999427211267,0,650,650,0,1.0,0.0
835909086839517184,1,989,290,699,0.29322548028311424,0.7067745197168858
167210247,0,1000,995,5,0.995,0.005
1258458665037762560,1,308,42,266,0.13636363636363635,0.8636363636363636
1553473274,0,1000,956,44,0.956,0.044
1071279518,1,139,12,127,0.08633093525179857,0.9136690647482014
21462941,0,181,173,8,0.9558011049723757,0.04419889502762431
1430599589808246801,1,616,124,492,0.2012987012987013,0.7987012987012987
531001593,0,1000,1000,0,1.0,0.0
2151041456,1,91,21,70,0.23076923076923078,0.7692307692307693
4330509440,0,792,786,6,0.9924242424242424,0.007575757575757576
22515376,1,1000,94,906,0.094,0.906
1497718090649329664,0,74,72,2,0.972972972972973,0.02702702702702703
716320961994354689,1,599,158,441,0.2637729549248748,0.7362270450751253
416475450,1,447,17,430,0.03803131991051454,0.9619686800894854
1273097659708923906,0,409,394,15,0.9633251833740831,0.03667481662591687
2999933480,1,1000,248,752,0.248,0.752
805301998471909376,0,1000,826,174,0.826,0.174
160035129,1,81,7,74,0.08641975308641975,0.9135802469135802
1094908670,0,1000,998,2,0.998,0.002
2363705562,1,224,16,208,0.07142857142857142,0.9285714285714286
953448651392774150,0,999,997,2,0.997997997997998,0.002002002002002002
1015989552950009856,1,252,34,218,0.1349206349206349,0.8650793650793651
1258399997470654466,0,257,248,9,0.9649805447470817,0.03501945525291829
1255709214015492097,1,602,187,415,0.3106312292358804,0.6893687707641196
808876802831773697,0,265,265,0,1.0,0.0
304081433,1,999,166,833,0.16616616616616617,0.8338338338338338
1374011620918239232,0,673,568,105,0.8439821693907875,0.15601783060921248
1069733331888234496,0,677,535,142,0.7902511078286558,0.20974889217134415
119471875,1,337,55,282,0.1632047477744807,0.8367952522255193
327724275,0,122,122,0,1.0,0.0
23648589,1,227,96,131,0.42290748898678415,0.5770925110132159
16139955,0,1000,976,24,0.976,0.024
201578671,1,1000,172,828,0.172,0.828
38317871,0,441,432,9,0.9795918367346939,0.02040816326530612
1303762786435166210,1,392,18,374,0.04591836734693878,0.9540816326530612
161143649,0,1000,955,45,0.955,0.045
1445226165808021504,1,1000,176,824,0.176,0.824
875408539505876993,0,174,172,2,0.9885057471264368,0.011494252873563218
1461334031514189841,1,138,21,117,0.15217391304347827,0.8478260869565217
3019136957,0,135,135,0,1.0,0.0
2982278560,1,667,106,561,0.15892053973013492,0.841079460269865
2815028412,0,341,337,4,0.9882697947214076,0.011730205278592375
1418683668353232896,1,595,14,581,0.023529411764705882,0.9764705882352941
1480192078680367112,0,1000,1000,0,1.0,0.0
29915986,1,1000,36,964,0.036,0.964
925723478736752641,0,369,357,12,0.967479674796748,0.032520325203252036
1354825036251725824,1,53,27,26,0.5094339622641509,0.49056603773584906
1166183181797580802,0,302,302,0,1.0,0.0
49193833,1,380,14,366,0.03684210526315789,0.9631578947368421
1404705730402398209,0,146,117,29,0.8013698630136986,0.19863013698630136
1122152787855511553,1,1000,71,929,0.071,0.929
952526416603680769,0,125,124,1,0.992,0.008
1423854024567185419,1,168,2,166,0.011904761904761904,0.9880952380952381
188804597,0,1000,907,93,0.907,0.093
739941280118112261,1,535,52,483,0.09719626168224299,0.902803738317757
79565321,0,1000,998,2,0.998,0.002
450363073,1,944,62,882,0.06567796610169492,0.934322033898305
926479663160967168,0,210,206,4,0.9809523809523809,0.01904761904761905
814987057613443072,1,1000,205,795,0.205,0.795
1309369630155132930,0,433,407,26,0.9399538106235565,0.06004618937644342
1298695676709281792,1,1000,120,880,0.12,0.88
14393068,0,966,913,53,0.9451345755693582,0.054865424430641824
2261902451,1,62,2,60,0.03225806451612903,0.967741935483871
744941286008971264,0,818,804,14,0.9828850855745721,0.017114914425427872
533380885,0,409,404,5,0.9877750611246944,0.012224938875305624
2333691512,1,1000,107,893,0.107,0.893
1334917531400749057,0,29,29,0,1.0,0.0
16185569,1,780,58,722,0.07435897435897436,0.9256410256410257
1425145189417594886,0,169,158,11,0.9349112426035503,0.0650887573964497
1292610020375486466,1,299,17,282,0.056856187290969896,0.9431438127090301
1486092546703081477,0,522,495,27,0.9482758620689655,0.05172413793103448
1668671840,1,753,63,690,0.08366533864541832,0.9163346613545816
1267596085624819713,0,149,142,7,0.9530201342281879,0.04697986577181208
1490455652669571079,1,88,30,58,0.3409090909090909,0.6590909090909091
1484308534422552577,0,93,93,0,1.0,0.0
1258446842,1,1000,279,721,0.279,0.721
1467410164504477703,0,99,99,0,1.0,0.0
4914573617,1,343,47,296,0.13702623906705538,0.8629737609329446
531588093,0,83,82,1,0.9879518072289156,0.012048192771084338
743833413434605568,1,544,110,434,0.20220588235294118,0.7977941176470589
328115087,0,177,176,1,0.9943502824858758,0.005649717514124294
112208608,1,331,37,294,0.11178247734138973,0.8882175226586103
813921627541045248,0,57,55,2,0.9649122807017544,0.03508771929824561
1069801756744282112,1,261,74,187,0.2835249042145594,0.7164750957854407
929267442798485504,0,100,100,0,1.0,0.0
834555073,1,787,22,765,0.02795425667090216,0.9720457433290979
817169032000499712,0,2,2,0,1.0,0.0
1013786418,0,78,72,6,0.9230769230769231,0.07692307692307693
1393031864479141890,1,163,8,155,0.049079754601226995,0.950920245398773
1037270144198815745,0,207,207,0,1.0,0.0
1363954780180201477,1,456,103,353,0.22587719298245615,0.7741228070175439
4288943714,0,415,407,8,0.980722891566265,0.01927710843373494
260592625,1,843,122,721,0.14472123368920523,0.8552787663107948
786352509455441921,0,161,161,0,1.0,0.0
4599937153,0,617,596,21,0.965964343598055,0.03403565640194489
284758735,1,100,7,93,0.07,0.93
1059553108928405504,0,120,120,0,1.0,0.0
52330027,1,977,143,834,0.14636642784032752,0.8536335721596725
1353690061280342017,0,104,100,4,0.9615384615384616,0.038461538461538464
17783263,1,1000,114,886,0.114,0.886
234874671,0,471,469,2,0.9957537154989384,0.004246284501061571
407488223,1,1000,43,957,0.043,0.957
55699369,0,1000,970,30,0.97,0.03
221243210,1,1000,107,893,0.107,0.893
310528359,0,720,706,14,0.9805555555555555,0.019444444444444445
783517268,1,1000,118,882,0.118,0.882
1430493861013606407,0,57,55,2,0.9649122807017544,0.03508771929824561
511224860,1,652,66,586,0.10122699386503067,0.8987730061349694
1198435875862056961,1,169,27,142,0.15976331360946747,0.8402366863905325
979214610887729152,0,633,617,16,0.9747235387045814,0.02527646129541864
1490481984572989443,1,210,77,133,0.36666666666666664,0.6333333333333333
300325068,0,982,974,8,0.9918533604887984,0.008146639511201629
2664337430,1,866,26,840,0.03002309468822171,0.9699769053117783
913149950,0,86,85,1,0.9883720930232558,0.011627906976744186
1294492286768750592,1,645,142,503,0.22015503875968992,0.7798449612403101
892582437670199297,0,417,407,10,0.9760191846522782,0.023980815347721823
2768423423,1,297,21,276,0.0707070707070707,0.9292929292929293
1223574767954878464,0,33,33,0,1.0,0.0
1056654261013110784,1,483,180,303,0.37267080745341613,0.6273291925465838
4002483725,0,1000,944,56,0.944,0.056
937081737775079424,1,1000,109,891,0.109,0.891
390208085,0,52,52,0,1.0,0.0
909088522157649921,1,1000,242,758,0.242,0.758
243880607,0,684,679,5,0.9926900584795322,0.007309941520467836
1046179311605227520,1,712,79,633,0.11095505617977527,0.8890449438202247
2874511719,0,905,860,45,0.9502762430939227,0.049723756906077346
80381605,1,1000,33,967,0.033,0.967
1411511868875632645,0,107,107,0,1.0,0.0
18399899,1,130,12,118,0.09230769230769231,0.9076923076923077
523938919,0,403,403,0,1.0,0.0
1016005394794274817,1,618,105,513,0.16990291262135923,0.8300970873786407
1445136405802409989,0,1000,1000,0,1.0,0.0
471630886,1,830,172,658,0.20722891566265061,0.7927710843373494
279493898,0,713,712,1,0.9985974754558204,0.001402524544179523
953687445052076032,1,1000,254,746,0.254,0.746
33781437,0,733,681,52,0.9290586630286494,0.07094133697135062
3038657449,1,453,75,378,0.16556291390728478,0.8344370860927153
4771217782,0,492,491,1,0.9979674796747967,0.0020325203252032522
1348974513027952642,1,728,38,690,0.0521978021978022,0.9478021978021978
15946309,0,104,99,5,0.9519230769230769,0.04807692307692308
867321158,1,140,14,126,0.1,0.9
4362118828,0,1000,998,2,0.998,0.002
1373874022048403458,1,58,1,57,0.017241379310344827,0.9827586206896551
1326011228,0,226,222,4,0.9823008849557522,0.017699115044247787
245186522,0,290,280,10,0.9655172413793104,0.034482758620689655
576483145,1,724,106,618,0.1464088397790055,0.8535911602209945
1146463792689139712,0,203,203,0,1.0,0.0
2332740919,1,701,99,602,0.14122681883024252,0.8587731811697575
275641014,0,23,23,0,1.0,0.0
14378441,1,416,90,326,0.21634615384615385,0.7836538461538461
519229400,0,1000,988,12,0.988,0.012
969056641,1,222,26,196,0.11711711711711711,0.8828828828828829
1309948196404297731,0,108,108,0,1.0,0.0
2922158649,1,428,83,345,0.1939252336448598,0.8060747663551402
974116763121147906,0,1000,980,20,0.98,0.02
722204073336770560,1,285,29,256,0.10175438596491228,0.8982456140350877
1514560325198258180,0,155,155,0,1.0,0.0
37431971,1,481,44,437,0.09147609147609148,0.9085239085239085
4855308201,0,229,227,2,0.9912663755458515,0.008733624454148471
1486466372825718786,1,19,2,17,0.10526315789473684,0.8947368421052632
1400326993044860930,0,464,454,10,0.978448275862069,0.021551724137931036
381128332,0,335,333,2,0.9940298507462687,0.005970149253731343
1528962999129493505,1,195,28,167,0.14358974358974358,0.8564102564102564
2865503706,0,417,416,1,0.9976019184652278,0.002398081534772182
789149336265515008,0,522,497,25,0.9521072796934866,0.04789272030651341
271900356,1,364,80,284,0.21978021978021978,0.7802197802197802
2290121684,0,471,457,14,0.970276008492569,0.029723991507430998
900567567537983490,1,146,13,133,0.08904109589041095,0.910958904109589
874409532319027200,0,70,70,0,1.0,0.0
776477990335213569,1,1000,123,877,0.123,0.877
1542417734,0,1000,995,5,0.995,0.005
934592632201691136,1,194,50,144,0.25773195876288657,0.7422680412371134
1514264578984923140,0,97,96,1,0.9896907216494846,0.010309278350515464
1068264780639756289,1,157,16,141,0.10191082802547771,0.8980891719745223
2364055979,0,16,16,0,1.0,0.0
25710232,1,293,30,263,0.10238907849829351,0.8976109215017065
785529636935512066,0,1000,1000,0,1.0,0.0
1154018968765718528,1,291,15,276,0.05154639175257732,0.9484536082474226
93550258,0,332,324,8,0.9759036144578314,0.024096385542168676
3419556532,1,511,43,468,0.08414872798434442,0.9158512720156555
305726252,0,1000,988,12,0.988,0.012
738518106,1,899,69,830,0.07675194660734148,0.9232480533926585
1176721783136952320,0,1000,834,166,0.834,0.166
343670328,1,145,12,133,0.08275862068965517,0.9172413793103448
1174331155530825728,0,821,795,26,0.9683313032886723,0.031668696711327646
41197568,1,1000,264,736,0.264,0.736
851600676845170689,0,171,170,1,0.9941520467836257,0.005847953216374269
323471620,1,1000,89,911,0.089,0.911
1507997144946405377,0,2,2,0,1.0,0.0
1450206279385948172,1,29,4,25,0.13793103448275862,0.8620689655172413
1473217470571991048,0,913,809,104,0.8860898138006572,0.11391018619934283
168321685,1,397,35,362,0.08816120906801007,0.9118387909319899
1336331550988722186,0,187,186,1,0.9946524064171123,0.0053475935828877
4867040573,1,235,39,196,0.16595744680851063,0.8340425531914893
264620693,0,698,693,5,0.9928366762177651,0.0071633237822349575
1394416443983372289,1,969,222,747,0.22910216718266255,0.7708978328173375
896474502,0,1000,998,2,0.998,0.002
2758035742,1,457,40,417,0.087527352297593,0.912472647702407
937884854473056256,0,251,250,1,0.9960159362549801,0.00398406374501992
130200997,0,1000,985,15,0.985,0.015
16310951,1,1000,148,852,0.148,0.852
77460699,0,126,104,22,0.8253968253968254,0.1746031746031746
44769912,1,835,75,760,0.08982035928143713,0.9101796407185628
32570713,0,323,309,14,0.9566563467492261,0.043343653250773995
3060998978,1,148,41,107,0.27702702702702703,0.722972972972973
182525488,0,1000,987,13,0.987,0.013
49235524,1,1000,130,870,0.13,0.87
1495170082900692993,0,723,710,13,0.9820193637621023,0.017980636237897647
48276452,1,221,19,202,0.08597285067873303,0.9140271493212669
205496531,0,1000,999,1,0.999,0.001
1580682506,1,427,100,327,0.234192037470726,0.765807962529274
1440390299809771535,0,308,307,1,0.9967532467532467,0.003246753246753247
3305756674,1,1000,125,875,0.125,0.875
1308443419707084800,0,432,427,5,0.9884259259259259,0.011574074074074073
19954842,1,347,107,240,0.30835734870317005,0.69164265129683
837958253321531393,0,477,467,10,0.9790356394129979,0.020964360587002098
47117986,1,999,170,829,0.17017017017017017,0.8298298298298298
1275552141818691586,0,39,39,0,1.0,0.0
1268581891843649536,1,1000,120,880,0.12,0.88
18038362,0,323,294,29,0.9102167182662538,0.08978328173374613
50167209,1,999,158,841,0.15815815815815815,0.8418418418418419
56662710,0,999,981,18,0.9819819819819819,0.018018018018018018
1077637215218528257,1,160,11,149,0.06875,0.93125
1158920324,0,91,89,2,0.978021978021978,0.02197802197802198
804087210719014912,1,680,168,512,0.24705882352941178,0.7529411764705882
2588346932,0,261,256,5,0.9808429118773946,0.019157088122605363
161885387,1,873,60,813,0.06872852233676977,0.9312714776632303
1053103662,0,721,692,29,0.9597780859916782,0.04022191400832178
440567957,1,195,4,191,0.020512820512820513,0.9794871794871794
554082653,0,203,197,6,0.9704433497536946,0.029556650246305417
1375816740593090562,1,593,91,502,0.15345699831365936,0.8465430016863407
48441341,0,43,43,0,1.0,0.0
1187534507102167040,1,611,173,438,0.28314238952536824,0.7168576104746317
259064705,0,778,735,43,0.9447300771208226,0.055269922879177376
1401322563314151425,1,832,132,700,0.15865384615384615,0.8413461538461539
1303832069697449984,0,116,114,2,0.9827586206896551,0.017241379310344827
117225124,1,1000,264,736,0.264,0.736
1022465051729580033,0,380,368,12,0.968421052631579,0.031578947368421054
711024759396548610,1,1000,172,828,0.172,0.828
1166771142230757376,0,1000,902,98,0.902,0.098
1195518602922909697,1,744,104,640,0.13978494623655913,0.8602150537634409
733652252,0,466,461,5,0.9892703862660944,0.01072961373390558
2748421982,1,746,202,544,0.2707774798927614,0.7292225201072386
1037452660159520768,1,1000,174,826,0.174,0.826
904387451984248832,0,381,352,29,0.9238845144356955,0.07611548556430446
1321466143572287488,1,157,39,118,0.2484076433121019,0.7515923566878981
1452994952,0,430,427,3,0.9930232558139535,0.0069767441860465115
1219000079144693760,1,278,27,251,0.09712230215827339,0.9028776978417267
1172572134729605120,0,1000,987,13,0.987,0.013
1458036711833931793,1,69,8,61,0.11594202898550725,0.8840579710144928
1111485043803897856,0,1000,968,32,0.968,0.032
184898859,1,1000,144,856,0.144,0.856
906985647256223744,0,322,321,1,0.9968944099378882,0.003105590062111801
140222919,1,898,66,832,0.07349665924276169,0.9265033407572383
482950625,0,1000,971,29,0.971,0.029
952606736870989824,1,135,12,123,0.08888888888888889,0.9111111111111111
1060489618578178049,0,382,381,1,0.9973821989528796,0.002617801047120419
381087875,1,1000,23,977,0.023,0.977
1492558016834510849,0,18,18,0,1.0,0.0
1267360765192712193,1,325,10,315,0.03076923076923077,0.9692307692307692
1519347873112014849,0,81,81,0,1.0,0.0
916407553336205313,1,217,65,152,0.2995391705069124,0.7004608294930875
1500839833685614606,0,25,25,0,1.0,0.0
1276675916257611776,1,985,257,728,0.2609137055837564,0.7390862944162436
40808451,0,113,113,0,1.0,0.0
1151700436945997826,1,1000,361,639,0.361,0.639
2540279072,0,206,188,18,0.912621359223301,0.08737864077669903
984049801,1,391,57,334,0.14578005115089515,0.8542199488491049
237934058,0,945,945,0,1.0,0.0
1265170866222047241,1,418,106,312,0.2535885167464115,0.7464114832535885
450470560,0,97,97,0,1.0,0.0
1418944773147308036,1,157,5,152,0.03184713375796178,0.9681528662420382
746382403803897856,0,119,116,3,0.9747899159663865,0.025210084033613446
614509199,1,169,28,141,0.16568047337278108,0.834319526627219
1467615626,0,224,215,9,0.9598214285714286,0.04017857142857143
90561613,1,686,100,586,0.1457725947521866,0.8542274052478134
1514063821970808845,0,91,91,0,1.0,0.0
18734999,1,651,31,620,0.047619047619047616,0.9523809523809523
50043410,0,344,334,10,0.9709302325581395,0.029069767441860465
455521331,1,999,51,948,0.05105105105105105,0.948948948948949
2307440358,0,1000,811,189,0.811,0.189
2833145937,1,236,44,192,0.1864406779661017,0.8135593220338984
1073155320,0,891,857,34,0.9618406285072951,0.038159371492704826
894373913911861248,1,37,4,33,0.10810810810810811,0.8918918918918919
247042562,0,616,580,36,0.9415584415584416,0.05844155844155844
1315059533740478469,1,681,52,629,0.0763582966226138,0.9236417033773862
1052710594141450241,0,118,108,10,0.9152542372881356,0.0847457627118644
404641900,1,1000,46,954,0.046,0.954
1240316397395349504,0,525,500,25,0.9523809523809523,0.047619047619047616
1182405530817454080,1,274,66,208,0.24087591240875914,0.7591240875912408
284199134,0,768,759,9,0.98828125,0.01171875
1229585986394279936,1,385,40,345,0.1038961038961039,0.8961038961038961
63263476,0,226,226,0,1.0,0.0
2241827394,1,616,63,553,0.10227272727272728,0.8977272727272727
2204354274,0,136,135,1,0.9926470588235294,0.007352941176470588
875421879523213313,1,1000,230,770,0.23,0.77
1418302441934577672,0,95,95,0,1.0,0.0
893070562846687232,1,1000,108,892,0.108,0.892
27813512,1,208,42,166,0.20192307692307693,0.7980769230769231
1300237829809766400,0,340,220,120,0.6470588235294118,0.35294117647058826
851342482453430272,1,1000,221,779,0.221,0.779
1346676258831171585,0,154,154,0,1.0,0.0
963062268320772096,1,96,4,92,0.041666666666666664,0.9583333333333334
2565224646,0,134,133,1,0.9925373134328358,0.007462686567164179
1289905603247210496,1,209,25,184,0.11961722488038277,0.8803827751196173
2300214248,0,491,490,1,0.9979633401221996,0.002036659877800407
1282386888,1,1000,265,735,0.265,0.735
256339143,0,599,556,43,0.9282136894824707,0.07178631051752922
51969251,1,666,24,642,0.036036036036036036,0.963963963963964
859254402569338881,0,286,278,8,0.972027972027972,0.027972027972027972
340413833,1,572,60,512,0.1048951048951049,0.8951048951048951
758662677392687105,0,398,398,0,1.0,0.0
18753280,1,999,155,844,0.15515515515515516,0.8448448448448449
1604884909,1,299,25,274,0.08361204013377926,0.9163879598662207
1449389585490841600,0,143,134,9,0.9370629370629371,0.06293706293706294
882360929635139585,1,408,53,355,0.12990196078431374,0.8700980392156863
1520958560175374336,0,3,3,0,1.0,0.0
820554236,1,503,32,471,0.0636182902584493,0.9363817097415507
22825106,0,304,304,0,1.0,0.0
35078260,1,1000,110,890,0.11,0.89
21547220,0,618,617,1,0.9983818770226537,0.0016181229773462784
1119466416237875201,1,100,19,81,0.19,0.81
1383008121883348992,0,22,22,0,1.0,0.0
764934889779007488,1,309,37,272,0.11974110032362459,0.8802588996763754
776121834030895104,0,438,391,47,0.8926940639269406,0.10730593607305935
1282796991211163648,1,736,59,677,0.08016304347826086,0.9198369565217391
586766596,0,270,250,20,0.9259259259259259,0.07407407407407407
65819305,1,1000,204,796,0.204,0.796
170120491,0,481,445,36,0.9251559251559252,0.07484407484407485
14296270,1,1000,46,954,0.046,0.954
14840869,0,160,160,0,1.0,0.0
378162884,1,1000,84,916,0.084,0.916
30751672,0,295,262,33,0.888135593220339,0.11186440677966102
903811,1,1000,176,824,0.176,0.824
1372711353069211652,0,128,127,1,0.9921875,0.0078125
97919839,1,402,57,345,0.1417910447761194,0.8582089552238806
1514333965,0,363,359,4,0.9889807162534435,0.011019283746556474
2836394614,1,259,50,209,0.19305019305019305,0.806949806949807
230035238,0,1000,977,23,0.977,0.023
26665491,0,1000,944,56,0.944,0.056
991529078938316801,1,618,76,542,0.12297734627831715,0.8770226537216829
1884567229,0,1000,995,5,0.995,0.005
39353263,1,1000,94,906,0.094,0.906
4847616493,0,268,253,15,0.9440298507462687,0.055970149253731345
714923687040843776,1,1000,76,924,0.076,0.924
1430137206509686797,0,28,28,0,1.0,0.0
900097566855102464,1,177,22,155,0.12429378531073447,0.8757062146892656
626865696,0,326,305,21,0.9355828220858896,0.06441717791411043
592975680,1,1000,126,874,0.126,0.874
923736092804706304,0,214,213,1,0.9953271028037384,0.004672897196261682
2732697254,1,471,149,322,0.31634819532908703,0.6836518046709129
970393341232893952,0,35,35,0,1.0,0.0
1072420014,1,506,74,432,0.14624505928853754,0.8537549407114624
1187984262,0,195,195,0,1.0,0.0
116992194,1,135,37,98,0.2740740740740741,0.725925925925926
1247734901987778562,0,426,426,0,1.0,0.0
4861707902,1,617,76,541,0.12317666126418152,0.8768233387358185
91946980,0,373,366,7,0.9812332439678284,0.01876675603217158
850012024549642241,1,1000,146,854,0.146,0.854
2986310019,0,1000,987,13,0.987,0.013
1373653330845601796,1,1000,43,957,0.043,0.957
3903353667,0,147,147,0,1.0,0.0
1378531392049545219,1,36,7,29,0.19444444444444445,0.8055555555555556
227197688,0,1000,982,18,0.982,0.018
909150538830434305,1,334,38,296,0.11377245508982035,0.8862275449101796
1451198583202484242,0,70,70,0,1.0,0.0
1351969003153965056,1,97,26,71,0.26804123711340205,0.7319587628865979
965456360925220865,0,140,139,1,0.9928571428571429,0.007142857142857143
3568879695,1,999,73,926,0.07307307307307308,0.9269269269269269
2717629097,0,901,886,15,0.9833518312985572,0.016648168701442843
554744670,1,577,47,530,0.08145580589254767,0.9185441941074524
257072227,0,999,985,14,0.985985985985986,0.014014014014014014
1392448842,1,1000,121,879,0.121,0.879
2523629816,0,1000,980,20,0.98,0.02
904098141322010625,1,847,82,765,0.09681227863046045,0.9031877213695395
1267910468242411521,0,195,194,1,0.9948717948717949,0.005128205128205128
386867244,1,271,67,204,0.24723247232472326,0.7527675276752768
14865935,0,408,375,33,0.9191176470588235,0.08088235294117647
1127391480136511489,1,223,107,116,0.4798206278026906,0.5201793721973094
87019958,0,163,161,2,0.9877300613496932,0.012269938650306749
726544945847345153,1,418,11,407,0.02631578947368421,0.9736842105263158
460725056,0,28,28,0,1.0,0.0
1027346923,1,702,34,668,0.04843304843304843,0.9515669515669516
329816287,0,65,64,1,0.9846153846153847,0.015384615384615385
2796759269,1,381,23,358,0.06036745406824147,0.9396325459317585
888536081871785984,0,521,458,63,0.8790786948176583,0.12092130518234165
1079173474084683776,1,406,44,362,0.10837438423645321,0.8916256157635468
1488622969807319040,0,1000,961,39,0.961,0.039
2330625649,1,1000,233,767,0.233,0.767
42387612,0,716,616,100,0.8603351955307262,0.13966480446927373
1260731588591173633,1,56,5,51,0.08928571428571429,0.9107142857142857
130172635,0,828,827,1,0.998792270531401,0.0012077294685990338
1046799566086049793,1,145,26,119,0.1793103448275862,0.8206896551724138
1019705295856128000,0,159,146,13,0.9182389937106918,0.08176100628930817
945205958891966464,1,229,12,217,0.05240174672489083,0.9475982532751092
1182515778509246464,0,97,96,1,0.9896907216494846,0.010309278350515464
1648278583,1,845,68,777,0.08047337278106509,0.919526627218935
61079014,0,992,974,18,0.9818548387096774,0.018145161290322582
229229910,1,1000,152,848,0.152,0.848
912413285923860481,0,1000,992,8,0.992,0.008
855556309,1,326,28,298,0.08588957055214724,0.9141104294478528
1063921924676378624,0,106,105,1,0.9905660377358491,0.009433962264150943
1303620714881339393,1,187,61,126,0.32620320855614976,0.6737967914438503
781191209125498881,1,1000,380,620,0.38,0.62
13333382,0,320,320,0,1.0,0.0
883565473752907776,1,339,20,319,0.058997050147492625,0.9410029498525073
986597800015253505,0,741,720,21,0.97165991902834,0.02834008097165992
113454356,1,908,40,868,0.04405286343612335,0.9559471365638766
1014911916550979585,0,308,308,0,1.0,0.0
3015775985,1,599,194,405,0.32387312186978295,0.676126878130217
19877828,0,695,689,6,0.9913669064748202,0.008633093525179856
2787325076,1,315,34,281,0.10793650793650794,0.8920634920634921
132598956,0,471,466,5,0.9893842887473461,0.010615711252653927
278119320,1,261,66,195,0.25287356321839083,0.7471264367816092
1486574597956767749,0,105,105,0,1.0,0.0
3195221126,1,1000,108,892,0.108,0.892
547991683,0,534,531,3,0.9943820224719101,0.0056179775280898875
2369910387,1,200,37,163,0.185,0.815
486854660,0,493,492,1,0.9979716024340771,0.002028397565922921
789243535346270208,1,1000,145,855,0.145,0.855
3026463548,0,117,115,2,0.9829059829059829,0.017094017094017096
741939613552381952,1,1000,60,940,0.06,0.94
4093693900,0,392,392,0,1.0,0.0
2715810639,1,492,30,462,0.06097560975609756,0.9390243902439024
458764398,0,247,246,1,0.9959514170040485,0.004048582995951417
32187305,1,205,35,170,0.17073170731707318,0.8292682926829268
4214820914,0,486,479,7,0.98559670781893,0.01440329218106996
789638384020926464,1,544,21,523,0.03860294117647059,0.9613970588235294
2162018952,0,131,131,0,1.0,0.0
367428458,1,409,77,332,0.1882640586797066,0.8117359413202934
1361883710384177155,0,1000,777,223,0.777,0.223
1393763636221513728,1,504,248,256,0.49206349206349204,0.5079365079365079
1278438653430292480,0,560,560,0,1.0,0.0
1097311762863529985,1,873,117,756,0.13402061855670103,0.865979381443299
4855342678,0,1000,868,132,0.868,0.132
1269861265595224066,1,912,134,778,0.14692982456140352,0.8530701754385965
1054521813202583552,1,598,82,516,0.13712374581939799,0.862876254180602
1157695451157549056,0,346,341,5,0.9855491329479769,0.014450867052023121
185778973,1,201,30,171,0.14925373134328357,0.8507462686567164
50027400,0,61,59,2,0.9672131147540983,0.03278688524590164
15792634,1,324,108,216,0.3333333333333333,0.6666666666666666
172622715,0,1000,980,20,0.98,0.02
34064629,1,518,41,477,0.07915057915057915,0.9208494208494209
955205229741449218,0,23,23,0,1.0,0.0
1490184677843427332,1,149,29,120,0.19463087248322147,0.8053691275167785
892790886953648128,0,116,114,2,0.9827586206896551,0.017241379310344827
1506681800,1,349,27,322,0.07736389684813753,0.9226361031518625
120459837,0,581,529,52,0.9104991394148021,0.08950086058519793
902172240061583361,1,217,12,205,0.055299539170506916,0.9447004608294931
1593815396,0,62,60,2,0.967741935483871,0.03225806451612903
4558201032,0,999,998,1,0.998998998998999,0.001001001001001001
1190664084322234368,1,1000,137,863,0.137,0.863
474196415,0,353,296,57,0.8385269121813032,0.16147308781869688
2337641714,1,290,34,256,0.11724137931034483,0.8827586206896552
1434535335241867264,0,77,77,0,1.0,0.0
967690721552551937,1,12,2,10,0.16666666666666666,0.8333333333333334
1278717664123326464,0,1000,999,1,0.999,0.001
30224597,1,427,26,401,0.06088992974238876,0.9391100702576113
1311106358423498752,0,490,417,73,0.8510204081632653,0.1489795918367347
16710659,1,413,130,283,0.31476997578692495,0.6852300242130751
415247341,0,167,167,0,1.0,0.0
1208377935192825856,1,923,261,662,0.28277356446370533,0.7172264355362947
1462319952992485380,0,1000,999,1,0.999,0.001
1438990167419744256,1,114,6,108,0.05263157894736842,0.9473684210526315
1069840336346730496,0,1000,846,154,0.846,0.154
240936780,1,478,32,446,0.06694560669456066,0.9330543933054394
4330046593,0,729,726,3,0.9958847736625515,0.00411522633744856
1005869928719769602,1,449,29,420,0.0645879732739421,0.9354120267260579
329892154,0,534,527,7,0.9868913857677902,0.013108614232209739
164457947,1,824,46,778,0.055825242718446605,0.9441747572815534
1397587698458710019,0,71,71,0,1.0,0.0
3673666519,1,320,36,284,0.1125,0.8875
871197881188986883,0,245,238,7,0.9714285714285714,0.02857142857142857
2852646109,1,823,22,801,0.026731470230862697,0.9732685297691372
22777340,0,1000,816,184,0.816,0.184
39121569,1,112,16,96,0.14285714285714285,0.8571428571428571
1070965194959003648,0,883,787,96,0.8912797281993206,0.1087202718006795
1072977354778120192,1,83,24,59,0.2891566265060241,0.7108433734939759
160315910,0,313,308,5,0.9840255591054313,0.01597444089456869
228858969,1,981,68,913,0.06931702344546381,0.9306829765545361
24129549,0,51,50,1,0.9803921568627451,0.0196078431372549
191220617,1,1000,23,977,0.023,0.977
951605519252209664,0,763,749,14,0.981651376146789,0.01834862385321101
61569807,1,589,104,485,0.1765704584040747,0.8234295415959253
1957639807,0,58,57,1,0.9827586206896551,0.017241379310344827
2353962242,1,1000,201,799,0.201,0.799
49194625,1,242,46,196,0.19008264462809918,0.8099173553719008
448582805,0,1000,993,7,0.993,0.007
1322964444,1,1000,114,886,0.114,0.886
1168581789801013249,0,1000,983,17,0.983,0.017
774750269540229121,1,82,9,73,0.10975609756097561,0.8902439024390244
68069598,0,794,758,36,0.9546599496221663,0.04534005037783375
795703792104706050,1,176,16,160,0.09090909090909091,0.9090909090909091
783452840,0,796,688,108,0.864321608040201,0.135678391959799
2663873092,1,1000,14,986,0.014,0.986
189372836,0,524,510,14,0.9732824427480916,0.026717557251908396
949863324107329537,1,635,3,632,0.004724409448818898,0.9952755905511811
18907179,0,513,513,0,1.0,0.0
6719372,1,1000,42,958,0.042,0.958
1364704300253933568,0,591,578,13,0.9780033840947546,0.021996615905245348
396882379,1,1000,144,856,0.144,0.856
269925098,0,139,139,0,1.0,0.0
1414148423046115332,1,1000,226,774,0.226,0.774
2728836068,0,109,109,0,1.0,0.0
881651845835390976,1,366,46,320,0.12568306010928962,0.8743169398907104
74765620,0,766,747,19,0.9751958224543081,0.024804177545691905
1172952130652557312,1,821,75,746,0.09135200974421437,0.9086479902557856
2691644815,0,1000,883,117,0.883,0.117
1370100564164509708,0,669,669,0,1.0,0.0
3361817169,1,285,57,228,0.2,0.8
1849852646,0,1000,999,1,0.999,0.001
884846176511684608,1,143,5,138,0.03496503496503497,0.965034965034965
1223622850340380678,0,109,107,2,0.981651376146789,0.01834862385321101
456165773,1,256,15,241,0.05859375,0.94140625
1313590220437164033,0,1000,966,34,0.966,0.034
12565522,1,814,66,748,0.08108108108108109,0.918918918918919
2919029732,0,147,147,0,1.0,0.0
1125226870679769088,1,179,18,161,0.1005586592178771,0.8994413407821229
258078111,0,361,345,16,0.9556786703601108,0.0443213296398892
882983449891680260,1,1000,25,975,0.025,0.975
4910976497,0,159,157,2,0.9874213836477987,0.012578616352201259
202450180,1,677,64,613,0.09453471196454949,0.9054652880354506
157090230,0,1000,982,18,0.982,0.018
2186952504,1,375,28,347,0.07466666666666667,0.9253333333333333
1512230737675792402,0,188,179,9,0.9521276595744681,0.047872340425531915
1215267680791539712,1,170,10,160,0.058823529411764705,0.9411764705882353
18431751,0,1000,950,50,0.95,0.05
1218959023489204224,1,553,12,541,0.0216998191681736,0.9783001808318263
150538931,0,543,543,0,1.0,0.0
117626623,1,339,26,313,0.07669616519174041,0.9233038348082596
709544358618537984,0,53,53,0,1.0,0.0
17775166,1,332,57,275,0.1716867469879518,0.8283132530120482
309634011,0,289,285,4,0.986159169550173,0.01384083044982699
1264536175416692737,1,1000,215,785,0.215,0.785
39585951,0,362,353,9,0.9751381215469613,0.024861878453038673
559903913,1,616,156,460,0.2532467532467532,0.7467532467532467
1252675485852749824,0,315,313,2,0.9936507936507937,0.006349206349206349
19980498,1,1000,253,747,0.253,0.747
912453168,0,109,108,1,0.9908256880733946,0.009174311926605505
3297790245,1,1000,173,827,0.173,0.827
64623747,0,1000,1000,0,1.0,0.0
904847613630881792,1,1000,274,726,0.274,0.726
2851475905,0,276,273,3,0.9891304347826086,0.010869565217391304
78218179,1,1000,211,789,0.211,0.789
34023003,0,996,942,54,0.9457831325301205,0.05421686746987952
975068738310549505,1,961,49,912,0.05098855359001041,0.9490114464099896
754819374326751232,0,676,588,88,0.8698224852071006,0.1301775147928994
58403659,1,748,164,584,0.2192513368983957,0.7807486631016043
1178292452551221249,1,983,262,721,0.26653102746693796,0.7334689725330621
1183147767914385409,0,146,143,3,0.9794520547945206,0.02054794520547945
2842014620,1,911,291,620,0.3194291986827662,0.6805708013172338
109060568,0,968,956,12,0.987603305785124,0.012396694214876033
560115120,1,373,61,312,0.16353887399463807,0.8364611260053619
1444890575463931912,0,368,367,1,0.9972826086956522,0.002717391304347826
885849898104442882,1,962,145,817,0.15072765072765074,0.8492723492723493
40806183,0,384,383,1,0.9973958333333334,0.0026041666666666665
148710472,1,35,4,31,0.11428571428571428,0.8857142857142857
1193877227471024128,0,12,12,0,1.0,0.0
844721576532684802,1,171,18,153,0.10526315789473684,0.8947368421052632
158112257,0,456,456,0,1.0,0.0
21446666,1,1000,192,808,0.192,0.808
353191633,0,696,684,12,0.9827586206896551,0.017241379310344827
1237185392,1,1000,69,931,0.069,0.931
960637659814289408,0,145,145,0,1.0,0.0
408187758,1,816,185,631,0.2267156862745098,0.7732843137254902
1229938915341107200,0,1000,918,82,0.918,0.082
2760160275,1,366,56,310,0.15300546448087432,0.8469945355191257
1268332337332285442,0,242,239,3,0.987603305785124,0.012396694214876033
253849166,1,438,42,396,0.0958904109589041,0.9041095890410958
701448409,0,447,442,5,0.9888143176733781,0.011185682326621925
3616163176,1,312,39,273,0.125,0.875
3294010800,0,278,275,3,0.9892086330935251,0.01079136690647482
1178305882066698242,1,838,91,747,0.10859188544152745,0.8914081145584726
74025549,0,1000,979,21,0.979,0.021
1318636895249846279,1,161,37,124,0.22981366459627328,0.7701863354037267
1656241903,0,385,384,1,0.9974025974025974,0.0025974025974025974
1949589800,1,1000,64,936,0.064,0.936
934829491217580033,0,290,245,45,0.8448275862068966,0.15517241379310345
2768626505,1,1000,87,913,0.087,0.913
784476288660672512,0,89,89,0,1.0,0.0
1328319385,1,770,330,440,0.42857142857142855,0.5714285714285714
43593075,0,719,670,49,0.9318497913769124,0.06815020862308763
1894907965,1,970,187,783,0.19278350515463918,0.8072164948453608
200727553,0,1000,964,36,0.964,0.036
1102582830016724994,1,296,35,261,0.11824324324324324,0.8817567567567568
755772829577076737,0,34,34,0,1.0,0.0
4342111888,1,965,215,750,0.22279792746113988,0.7772020725388601
1480349725744267266,0,258,258,0,1.0,0.0
981270318990807040,1,1000,102,898,0.102,0.898
4552307128,0,268,266,2,0.9925373134328358,0.007462686567164179
19863271,1,732,111,621,0.15163934426229508,0.8483606557377049
846070922129764352,0,428,402,26,0.9392523364485982,0.06074766355140187
23546907,1,901,170,731,0.18867924528301888,0.8113207547169812
364545095,0,281,268,13,0.9537366548042705,0.046263345195729534
875437628899729409,1,771,34,737,0.04409857328145266,0.9559014267185474
2994787188,0,59,58,1,0.9830508474576272,0.01694915254237288
1223470518910668800,1,669,32,637,0.04783258594917788,0.9521674140508222
2818451390,0,551,535,16,0.9709618874773139,0.029038112522686024
959163617156399104,1,766,23,743,0.030026109660574413,0.9699738903394256
1516440033871671297,0,26,26,0,1.0,0.0
20804453,1,833,44,789,0.05282112845138055,0.9471788715486195
60608510,0,540,515,25,0.9537037037037037,0.046296296296296294
1898786257,1,668,149,519,0.22305389221556887,0.7769461077844312
380329947,0,91,91,0,1.0,0.0
1505615392840077316,0,2,2,0,1.0,0.0
4325972713,1,364,47,317,0.12912087912087913,0.8708791208791209
936067290147192834,0,208,207,1,0.9951923076923077,0.004807692307692308
9589602,1,971,97,874,0.09989701338825953,0.9001029866117405
3394739057,0,155,155,0,1.0,0.0
78236338,1,273,54,219,0.1978021978021978,0.8021978021978022
251368748,0,1000,984,16,0.984,0.016
1479247371586326529,1,158,44,114,0.27848101265822783,0.7215189873417721
1345451440375033859,0,307,303,4,0.9869706840390879,0.013029315960912053
285320418,1,1000,125,875,0.125,0.875
1358238054390124544,0,205,205,0,1.0,0.0
1338986132592275458,1,37,11,26,0.2972972972972973,0.7027027027027027
223575480,0,139,136,3,0.9784172661870504,0.02158273381294964
541815981,1,1000,123,877,0.123,0.877
208239666,0,1000,993,7,0.993,0.007
152150549,1,755,118,637,0.1562913907284768,0.8437086092715231
1099020640554835970,0,575,565,10,0.9826086956521739,0.017391304347826087
1331127248062214144,1,99,3,96,0.030303030303030304,0.9696969696969697
1422036369560555520,0,7,7,0,1.0,0.0
4508635163,1,457,68,389,0.1487964989059081,0.8512035010940919
754751466523340800,0,774,772,2,0.9974160206718347,0.002583979328165375
144516340,1,130,14,116,0.1076923076923077,0.8923076923076924
23264062,0,1000,959,41,0.959,0.041
814945170852630528,1,186,34,152,0.1827956989247312,0.8172043010752689
1624751936,0,979,976,3,0.9969356486210419,0.0030643513789581204
1009810939,0,401,351,50,0.8753117206982544,0.12468827930174564
1270043830981554180,1,1000,43,957,0.043,0.957
1263298260258693120,0,81,81,0,1.0,0.0
804935910340988928,1,1000,175,825,0.175,0.825
207373530,0,492,450,42,0.9146341463414634,0.08536585365853659
1509603336638631951,1,39,5,34,0.1282051282051282,0.8717948717948718
1427981538,0,99,97,2,0.9797979797979798,0.020202020202020204
15480369,1,1000,37,963,0.037,0.963
2148127302,0,205,197,8,0.9609756097560975,0.03902439024390244
1486025702969327617,1,523,22,501,0.04206500956022945,0.9579349904397706
895613363945971713,0,609,606,3,0.9950738916256158,0.0049261083743842365
2937231855,1,841,7,834,0.008323424494649227,0.9916765755053508
900735932051185664,0,560,551,9,0.9839285714285714,0.01607142857142857
1005049087652052993,1,370,5,365,0.013513513513513514,0.9864864864864865
827299062374346753,0,447,416,31,0.930648769574944,0.06935123042505593
1489627809320509442,1,45,15,30,0.3333333333333333,0.6666666666666666
1340406146000183298,0,992,987,5,0.9949596774193549,0.005040322580645161
989996862,1,317,34,283,0.10725552050473186,0.8927444794952681
347345543,0,1000,950,50,0.95,0.05
2949015606,1,808,38,770,0.04702970297029703,0.9529702970297029
703459659001290752,0,14,14,0,1.0,0.0
14592636,1,108,11,97,0.10185185185185185,0.8981481481481481
1210833680593121282,0,71,71,0,1.0,0.0
1007146387618836486,1,170,28,142,0.16470588235294117,0.8352941176470589
4880067480,0,146,145,1,0.9931506849315068,0.00684931506849315
1495079856073105409,1,46,7,39,0.15217391304347827,0.8478260869565217
979090726737862657,0,92,87,5,0.9456521739130435,0.05434782608695652
1352727741536362497,1,174,21,153,0.1206896551724138,0.8793103448275862
1160739140071129089,0,132,122,10,0.9242424242424242,0.07575757575757576
2421165642,1,268,17,251,0.06343283582089553,0.9365671641791045
269375339,0,999,958,41,0.958958958958959,0.04104104104104104
3559665077,1,1000,209,791,0.209,0.791
1498771499490021378,0,308,298,10,0.9675324675324676,0.032467532467532464
1092472700092801024,1,1000,31,969,0.031,0.969
202181793,0,455,448,7,0.9846153846153847,0.015384615384615385
1337490517672673282,0,69,69,0,1.0,0.0
257641068,1,281,55,226,0.19572953736654805,0.8042704626334519
1396528676443987971,0,21,21,0,1.0,0.0
810960838844678145,1,93,5,88,0.053763440860215055,0.946236559139785
220002430,0,130,130,0,1.0,0.0
942956663807541248,1,1000,245,755,0.245,0.755
1409674599411892226,0,1000,994,6,0.994,0.006
940325220,1,922,68,854,0.0737527114967462,0.9262472885032538
14320616,0,1000,975,25,0.975,0.025
932007969880977409,1,349,84,265,0.24068767908309455,0.7593123209169055
274275682,0,261,257,4,0.9846743295019157,0.01532567049808429
16972446,1,1000,156,844,0.156,0.844
3087658289,0,484,482,2,0.9958677685950413,0.004132231404958678
3382980881,1,612,42,570,0.06862745098039216,0.9313725490196079
22668051,0,862,814,48,0.9443155452436195,0.05568445475638051
3364286894,1,643,149,494,0.2317262830482115,0.7682737169517885
102751218,0,158,157,1,0.9936708860759493,0.006329113924050633
709538622,1,1000,226,774,0.226,0.774
1451757032013504514,0,1000,997,3,0.997,0.003
1229120874952806401,1,104,7,97,0.0673076923076923,0.9326923076923077
912548832818421761,0,126,125,1,0.9920634920634921,0.007936507936507936
46323530,1,999,269,730,0.26926926926926925,0.7307307307307307
1222597640,0,1000,935,65,0.935,0.065
1532446200,0,84,82,2,0.9761904761904762,0.023809523809523808
112617749,1,766,129,637,0.16840731070496084,0.8315926892950392
1095897652506607622,0,79,79,0,1.0,0.0
2974746682,1,1000,41,959,0.041,0.959
791342443639767040,0,1000,999,1,0.999,0.001
1473460800492908548,1,27,1,26,0.037037037037037035,0.9629629629629629
43165749,0,1000,988,12,0.988,0.012
3190400203,1,1000,97,903,0.097,0.903
1369027321483698176,0,431,416,15,0.9651972157772621,0.03480278422273782
1169843001935286274,1,396,73,323,0.18434343434343434,0.8156565656565656
2896895866,0,172,172,0,1.0,0.0
3282116480,1,289,35,254,0.12110726643598616,0.8788927335640139
1343591331659186176,0,519,515,4,0.9922928709055877,0.007707129094412331
1035444684,1,568,36,532,0.06338028169014084,0.9366197183098591
1045407108802519040,0,604,578,26,0.956953642384106,0.04304635761589404
1041126270510219265,1,305,22,283,0.07213114754098361,0.9278688524590164
3138551525,0,549,549,0,1.0,0.0
2424867828,1,206,28,178,0.13592233009708737,0.8640776699029126
1221820608,0,1000,986,14,0.986,0.014
1192003193921654784,1,1000,124,876,0.124,0.876
1346838220043153408,0,444,443,1,0.9977477477477478,0.0022522522522522522
1069814370107039745,1,256,62,194,0.2421875,0.7578125
1519274659157614595,0,15,15,0,1.0,0.0
1352757913727725569,1,59,21,38,0.3559322033898305,0.6440677966101694
1289648916,0,68,67,1,0.9852941176470589,0.014705882352941176
90942642,1,445,49,396,0.1101123595505618,0.8898876404494382
2896278103,0,1000,758,242,0.758,0.242
1489111952471298052,1,10,1,9,0.1,0.9
1281569710979592192,0,125,125,0,1.0,0.0
2930077763,1,1000,247,753,0.247,0.753
4626518607,0,1000,986,14,0.986,0.014
48719964,1,1000,219,781,0.219,0.781
606724679,0,628,488,140,0.7770700636942676,0.2229299363057325
24531879,1,472,51,421,0.10805084745762712,0.8919491525423728
567476989,0,699,695,4,0.994277539341917,0.005722460658082976
903416557824552960,1,191,10,181,0.05235602094240838,0.9476439790575916
325353293,0,174,172,2,0.9885057471264368,0.011494252873563218
902949545079865345,1,142,7,135,0.04929577464788732,0.9507042253521126
1481394837178003467,0,155,154,1,0.9935483870967742,0.0064516129032258064
20183259,1,579,84,495,0.14507772020725387,0.8549222797927462
548249488,0,411,410,1,0.9975669099756691,0.0024330900243309003
855881398154035200,1,851,116,735,0.136310223266745,0.863689776733255
2767819062,0,985,981,4,0.9959390862944163,0.0040609137055837565
1025622525722722304,1,823,104,719,0.12636695018226002,0.8736330498177399
1179871077415055360,0,109,97,12,0.8899082568807339,0.11009174311926606
1223037074,1,884,166,718,0.18778280542986425,0.8122171945701357
862804333037060096,0,892,811,81,0.9091928251121076,0.09080717488789238
3168568331,1,118,25,93,0.211864406779661,0.788135593220339
145802117,0,862,860,2,0.9976798143851509,0.002320185614849188
45652941,1,115,5,110,0.043478260869565216,0.9565217391304348
168944784,0,178,125,53,0.702247191011236,0.29775280898876405
4839479067,1,1000,381,619,0.381,0.619
1130200201313042432,0,355,354,1,0.9971830985915493,0.0028169014084507044
16900616,1,479,59,420,0.12317327766179541,0.8768267223382046
25035741,0,999,995,4,0.995995995995996,0.004004004004004004
1473745784587923460,1,471,47,424,0.09978768577494693,0.9002123142250531
953741774790545408,0,206,200,6,0.970873786407767,0.02912621359223301
213480967,0,429,422,7,0.9836829836829837,0.016317016317016316
1317699273409089537,1,459,13,446,0.02832244008714597,0.971677559912854
1492908612028665863,0,1000,1000,0,1.0,0.0
763904,1,1000,139,861,0.139,0.861
19052073,0,470,463,7,0.9851063829787234,0.014893617021276596
1185370269528940545,0,151,151,0,1.0,0.0
3285961033,1,1000,100,900,0.1,0.9
3153575598,0,77,77,0,1.0,0.0
55963855,1,454,36,418,0.07929515418502203,0.920704845814978
805397674073718784,0,6,6,0,1.0,0.0
972291943,1,213,38,175,0.1784037558685446,0.8215962441314554
1211310164214611969,0,1000,1000,0,1.0,0.0
1307713914650660865,1,200,5,195,0.025,0.975
717814339642777604,0,52,52,0,1.0,0.0
1335606667,0,172,171,1,0.9941860465116279,0.005813953488372093
32924011,1,1000,181,819,0.181,0.819
2402562253,0,293,278,15,0.9488054607508533,0.051194539249146756
37138910,1,344,14,330,0.040697674418604654,0.9593023255813954
1262875034902835202,0,20,19,1,0.95,0.05
1207536125411307520,1,324,87,237,0.26851851851851855,0.7314814814814815
1223691128,0,307,292,15,0.9511400651465798,0.048859934853420196
1087145700067028993,1,136,11,125,0.08088235294117647,0.9191176470588235
984977341616013312,0,260,255,5,0.9807692307692307,0.019230769230769232
3254886349,1,1000,113,887,0.113,0.887
1326002140914003968,0,4,4,0,1.0,0.0
1471532353424134157,1,4,0,4,0.0,1.0
872811736780480512,1,134,28,106,0.208955223880597,0.7910447761194029
389682374,0,999,907,92,0.9079079079079079,0.0920920920920921
1161789356,1,999,79,920,0.07907907907907907,0.9209209209209209
223204918,0,762,755,7,0.9908136482939632,0.009186351706036745
1254886738385940480,1,130,3,127,0.023076923076923078,0.9769230769230769
988590704120262656,0,393,392,1,0.9974554707379135,0.002544529262086514
836015749206454273,1,160,4,156,0.025,0.975
1419440732159438852,0,1000,849,151,0.849,0.151
1459062740853604352,1,664,13,651,0.01957831325301205,0.9804216867469879
1427337975428489223,0,53,53,0,1.0,0.0
4486140676,1,1000,99,901,0.099,0.901
1125211980535554048,0,192,185,7,0.9635416666666666,0.036458333333333336
2933098658,1,557,25,532,0.04488330341113106,0.9551166965888689
32815250,0,988,952,36,0.9635627530364372,0.03643724696356275
508132180,1,386,22,364,0.05699481865284974,0.9430051813471503
45112208,0,498,497,1,0.9979919678714859,0.002008032128514056
495606002,1,247,37,210,0.14979757085020243,0.8502024291497976
40563151,0,1000,991,9,0.991,0.009
826974173423624193,1,183,27,156,0.14754098360655737,0.8524590163934426
298780392,0,237,235,2,0.9915611814345991,0.008438818565400843
1478981199787741184,1,116,16,100,0.13793103448275862,0.8620689655172413
1485767863818461187,0,62,62,0,1.0,0.0
408048367,1,1000,46,954,0.046,0.954
1973174790,0,655,579,76,0.8839694656488549,0.11603053435114503
771586242060226560,1,238,33,205,0.13865546218487396,0.8613445378151261
876404300,0,493,491,2,0.9959432048681541,0.004056795131845842
876142999385845760,1,146,22,124,0.1506849315068493,0.8493150684931506
57644730,0,999,893,106,0.8938938938938938,0.1061061061061061
187643410,1,253,30,223,0.11857707509881422,0.8814229249011858
1247835608,0,29,27,2,0.9310344827586207,0.06896551724137931
1399799221432336386,1,272,64,208,0.23529411764705882,0.7647058823529411
1472464224127438856,0,153,153,0,1.0,0.0
1135763904896929795,1,441,63,378,0.14285714285714285,0.8571428571428571
1479796486246309889,0,37,35,2,0.9459459459459459,0.05405405405405406
569585081,1,400,19,381,0.0475,0.9525
181821606,0,74,73,1,0.9864864864864865,0.013513513513513514
803647975000080384,1,999,59,940,0.05905905905905906,0.9409409409409409
1231450283223339009,0,473,455,18,0.9619450317124736,0.03805496828752643
979468713375162368,1,126,13,113,0.10317460317460317,0.8968253968253969
374733689,0,609,609,0,1.0,0.0
1144062491095265280,1,436,20,416,0.045871559633027525,0.9541284403669725
2562689720,0,925,918,7,0.9924324324324324,0.0075675675675675675
3774921435,1,346,37,309,0.1069364161849711,0.8930635838150289
340735582,0,1000,1000,0,1.0,0.0
972355807059763200,1,566,152,414,0.26855123674911663,0.7314487632508834
350661848,0,62,62,0,1.0,0.0
1536005071338721280,1,216,58,158,0.26851851851851855,0.7314814814814815
1018191639179923457,0,351,294,57,0.8376068376068376,0.1623931623931624
1031584452,1,284,14,270,0.04929577464788732,0.9507042253521126
437262954,0,540,537,3,0.9944444444444445,0.005555555555555556
946092500472811520,1,1000,92,908,0.092,0.908
946930224,0,166,158,8,0.9518072289156626,0.04819277108433735
1265657347374043136,1,252,34,218,0.1349206349206349,0.8650793650793651
2903323030,0,1000,990,10,0.99,0.01
1262904309223579651,1,1000,1,999,0.001,0.999
37584424,0,305,303,2,0.9934426229508196,0.006557377049180328
837849968438308864,1,1000,108,892,0.108,0.892
2721160462,0,209,208,1,0.9952153110047847,0.004784688995215311
3434209089,1,237,33,204,0.13924050632911392,0.8607594936708861
3464906473,0,169,169,0,1.0,0.0
1343129036835319808,1,660,246,414,0.37272727272727274,0.6272727272727273
77278795,0,249,249,0,1.0,0.0
3730489457,1,148,14,134,0.0945945945945946,0.9054054054054054
17978048,0,950,912,38,0.96,0.04
981683575,1,340,30,310,0.08823529411764706,0.9117647058823529
393051900,0,288,284,4,0.9861111111111112,0.013888888888888888
3377292388,1,293,25,268,0.08532423208191127,0.9146757679180887
1328067163006136320,0,1,1,0,1.0,0.0
837782599846281221,1,447,72,375,0.1610738255033557,0.8389261744966443
705076426463059968,0,348,345,3,0.9913793103448276,0.008620689655172414
965663487039975424,0,70,68,2,0.9714285714285714,0.02857142857142857
747573210867204097,1,306,40,266,0.13071895424836602,0.869281045751634
387954703,0,285,278,7,0.9754385964912281,0.02456140350877193
996794239534157824,1,999,90,909,0.09009009009009009,0.9099099099099099
1228936084215783425,0,1000,936,64,0.936,0.064
28507193,1,887,91,796,0.10259301014656144,0.8974069898534386
1252686449616486401,0,209,209,0,1.0,0.0
3035975251,1,923,46,877,0.04983748645720477,0.9501625135427952
573217931,0,375,373,2,0.9946666666666667,0.005333333333333333
256685244,1,1000,93,907,0.093,0.907
14057149,0,343,331,12,0.9650145772594753,0.03498542274052478
44816408,1,1000,17,983,0.017,0.983
905949782249791490,0,517,517,0,1.0,0.0
1227634762874900480,1,651,96,555,0.14746543778801843,0.8525345622119815
308143201,0,99,99,0,1.0,0.0
812798530444214272,1,1000,94,906,0.094,0.906
2985106513,0,1000,965,35,0.965,0.035
22310138,1,999,61,938,0.06106106106106106,0.938938938938939
993517966586138625,0,156,155,1,0.9935897435897436,0.00641025641025641
846521396763267072,1,931,110,821,0.11815252416756176,0.8818474758324383
1321531244325310465,0,1000,999,1,0.999,0.001
809193815936335872,1,459,65,394,0.14161220043572983,0.8583877995642701
463072104,0,85,82,3,0.9647058823529412,0.03529411764705882
1082386366053281792,1,62,1,61,0.016129032258064516,0.9838709677419355
2381047772,0,650,529,121,0.8138461538461539,0.18615384615384614
1398573670734303235,1,73,16,57,0.2191780821917808,0.7808219178082192
1402214452766908424,1,412,15,397,0.03640776699029126,0.9635922330097088
2931566170,0,233,137,96,0.5879828326180258,0.41201716738197425
14504217,1,599,177,422,0.29549248747913187,0.7045075125208681
826273569961189377,0,892,805,87,0.9024663677130045,0.09753363228699552
2989091749,1,233,15,218,0.06437768240343347,0.9356223175965666
48482815,0,236,235,1,0.9957627118644068,0.00423728813559322
1277591121619607552,1,1000,204,796,0.204,0.796
872497830782312449,0,596,595,1,0.9983221476510067,0.0016778523489932886
323519785,1,518,39,479,0.07528957528957529,0.9247104247104247
25882361,0,226,224,2,0.9911504424778761,0.008849557522123894
32256633,1,135,14,121,0.1037037037037037,0.8962962962962963
1259036421672837121,0,201,200,1,0.9950248756218906,0.004975124378109453
1093782025,1,878,63,815,0.07175398633257403,0.928246013667426
426642710,0,947,929,18,0.9809926082365364,0.01900739176346357
20029272,1,906,208,698,0.22958057395143489,0.7704194260485652
2966741349,0,400,347,53,0.8675,0.1325
1056750114,1,999,113,886,0.11311311311311312,0.8868868868868869
2189109673,0,1000,941,59,0.941,0.059
18529689,1,743,115,628,0.15477792732166892,0.845222072678331
1491873311537696773,0,93,93,0,1.0,0.0
2357275826,1,245,9,236,0.036734693877551024,0.963265306122449
879039726,0,19,19,0,1.0,0.0
1189252648152768513,1,125,31,94,0.248,0.752
430521813,0,223,223,0,1.0,0.0
34400506,1,1000,281,719,0.281,0.719
2542822464,0,284,226,58,0.795774647887324,0.20422535211267606
319130635,1,402,30,372,0.07462686567164178,0.9253731343283582
109353519,0,477,476,1,0.9979035639412998,0.0020964360587002098
900427687084281856,1,1000,121,879,0.121,0.879
44807550,0,955,953,2,0.9979057591623036,0.0020942408376963353
18924979,1,909,117,792,0.12871287128712872,0.8712871287128713
1267967728582684672,1,94,11,83,0.11702127659574468,0.8829787234042553
41242598,0,1000,973,27,0.973,0.027
812809035674189825,1,207,25,182,0.12077294685990338,0.8792270531400966
575711333,0,1000,950,50,0.95,0.05
820733192021966848,1,319,77,242,0.2413793103448276,0.7586206896551724
3024284876,0,143,143,0,1.0,0.0
2343871932,1,1000,230,770,0.23,0.77
863974201,0,1000,980,20,0.98,0.02
1436793162375344133,1,1000,66,934,0.066,0.934
1164356441920155648,0,243,236,7,0.9711934156378601,0.02880658436213992
353540817,1,523,63,460,0.12045889101338432,0.8795411089866156
153557484,0,1000,989,11,0.989,0.011
3234519367,1,750,159,591,0.212,0.788
1305274813708197889,0,245,237,8,0.9673469387755103,0.0326530612244898
14864376,1,286,42,244,0.14685314685314685,0.8531468531468531
1077328763388641282,1,1000,139,861,0.139,0.861
1330932541,0,277,255,22,0.9205776173285198,0.07942238267148015
172085616,1,1000,234,766,0.234,0.766
196468249,0,350,344,6,0.9828571428571429,0.017142857142857144
1432503447908012033,1,422,170,252,0.4028436018957346,0.5971563981042654
346315533,0,553,553,0,1.0,0.0
2392881661,1,610,98,512,0.16065573770491803,0.839344262295082
855833909715763205,0,261,260,1,0.9961685823754789,0.0038314176245210726
214324977,1,445,68,377,0.15280898876404495,0.8471910112359551
1525883680417271815,0,47,46,1,0.9787234042553191,0.02127659574468085
1227315122655440904,1,83,6,77,0.07228915662650602,0.927710843373494
125416441,0,47,47,0,1.0,0.0
1638685994,1,1000,93,907,0.093,0.907
79089685,0,539,535,4,0.9925788497217068,0.0074211502782931356
494900443,1,354,92,262,0.2598870056497175,0.7401129943502824
915309102,0,402,389,13,0.9676616915422885,0.03233830845771144
283279325,1,728,114,614,0.1565934065934066,0.8434065934065934
2854090646,1,697,140,557,0.20086083213773315,0.7991391678622669
19872519,0,995,904,91,0.9085427135678392,0.0914572864321608
2529049537,1,234,4,230,0.017094017094017096,0.9829059829059829
16559034,0,375,373,2,0.9946666666666667,0.005333333333333333
1177017263108612096,1,309,49,260,0.15857605177993528,0.8414239482200647
43827532,0,50,43,7,0.86,0.14
2537347287,1,152,8,144,0.05263157894736842,0.9473684210526315
333607565,0,306,306,0,1.0,0.0
1175103646050279424,1,59,7,52,0.11864406779661017,0.8813559322033898
1266730954703482880,0,233,233,0,1.0,0.0
1462881611863654401,1,129,31,98,0.24031007751937986,0.7596899224806202
1037098286224629760,0,88,88,0,1.0,0.0
293299616,1,497,41,456,0.08249496981891348,0.9175050301810865
1249524156758024193,0,100,100,0,1.0,0.0
4055270183,1,238,53,185,0.22268907563025211,0.7773109243697479
404456608,0,102,102,0,1.0,0.0
928879203906285568,1,436,26,410,0.05963302752293578,0.9403669724770642
3302911100,0,307,293,14,0.9543973941368078,0.04560260586319218
138232574,1,273,4,269,0.014652014652014652,0.9853479853479854
228796988,0,988,940,48,0.951417004048583,0.048582995951417005
353932554,1,937,88,849,0.09391675560298826,0.9060832443970117
1057077599229362176,0,188,179,9,0.9521276595744681,0.047872340425531915
1369754431886090253,1,220,69,151,0.31363636363636366,0.6863636363636364
1504831124924735492,0,129,129,0,1.0,0.0
21724236,1,342,40,302,0.11695906432748537,0.8830409356725146
500630623,0,605,603,2,0.996694214876033,0.003305785123966942
494726320,1,850,66,784,0.07764705882352942,0.9223529411764706
1462097779774349320,0,184,182,2,0.9891304347826086,0.010869565217391304
1487986635480440838,1,48,7,41,0.14583333333333334,0.8541666666666666
917832112400748546,0,672,653,19,0.9717261904761905,0.028273809523809524
1461294548911489026,1,709,125,584,0.1763046544428773,0.8236953455571228
17648905,0,351,349,2,0.9943019943019943,0.005698005698005698
1300899863471829002,1,170,17,153,0.1,0.9
74688225,0,58,58,0,1.0,0.0
1358303342,1,544,47,497,0.08639705882352941,0.9136029411764706
91021093,1,1000,30,970,0.03,0.97
378267764,0,272,271,1,0.9963235294117647,0.003676470588235294
223643668,1,1000,155,845,0.155,0.845
35058879,0,94,87,7,0.925531914893617,0.07446808510638298
7760582,1,1000,526,474,0.526,0.474
1243028777355169792,0,388,385,3,0.9922680412371134,0.007731958762886598
767075914005876737,0,124,116,8,0.9354838709677419,0.06451612903225806
527150012,1,887,172,715,0.1939120631341601,0.8060879368658399
1476735846736928768,0,118,108,10,0.9152542372881356,0.0847457627118644
1073279493337432064,1,70,10,60,0.14285714285714285,0.8571428571428571
54609419,0,207,195,12,0.9420289855072463,0.057971014492753624
1147022292192550912,1,119,7,112,0.058823529411764705,0.9411764705882353
1501065267622789120,0,75,75,0,1.0,0.0
722982200073805825,1,148,19,129,0.12837837837837837,0.8716216216216216
341387562,0,447,443,4,0.9910514541387024,0.008948545861297539
316524917,1,928,134,794,0.14439655172413793,0.8556034482758621
44308033,0,1000,995,5,0.995,0.005
38030935,0,1000,1000,0,1.0,0.0
2996163912,1,1000,305,695,0.305,0.695
3272515105,0,126,126,0,1.0,0.0
1355634216,1,366,9,357,0.02459016393442623,0.9754098360655737
1343739258327199744,0,368,368,0,1.0,0.0
401089862,1,534,208,326,0.3895131086142322,0.6104868913857678
1063120692248363010,0,200,199,1,0.995,0.005
1408589515820781571,1,501,127,374,0.25349301397205587,0.7465069860279441
29249504,0,193,184,9,0.9533678756476683,0.046632124352331605
1092569065078456321,1,69,1,68,0.014492753623188406,0.9855072463768116
1357871567062110211,0,92,92,0,1.0,0.0
1286529472813047809,1,666,70,596,0.10510510510510511,0.8948948948948949
1324346891149234179,0,119,118,1,0.9915966386554622,0.008403361344537815
15275342,1,696,68,628,0.09770114942528736,0.9022988505747126
338178787,0,393,393,0,1.0,0.0
927666682134491136,1,281,61,220,0.21708185053380782,0.7829181494661922
1385587677601452036,0,122,122,0,1.0,0.0
1115776434730143744,1,938,253,685,0.2697228144989339,0.7302771855010661
1229228230500143105,0,31,30,1,0.967741935483871,0.03225806451612903
857045664093556736,1,1000,194,806,0.194,0.806
1430787637116289026,0,218,215,3,0.9862385321100917,0.013761467889908258
1304916391934472193,1,175,17,158,0.09714285714285714,0.9028571428571428
1270201161006505985,0,349,347,2,0.994269340974212,0.0057306590257879654
41047462,1,382,42,340,0.1099476439790576,0.8900523560209425
11601942,0,1000,832,168,0.832,0.168
969221436752703488,1,646,97,549,0.15015479876160992,0.8498452012383901
2925241207,0,556,554,2,0.9964028776978417,0.0035971223021582736
2999675910,1,731,89,642,0.12175102599179206,0.8782489740082079
1278637603,0,1000,977,23,0.977,0.023
1409700460185989120,1,246,20,226,0.08130081300813008,0.9186991869918699
1457968194564591619,0,44,44,0,1.0,0.0
1018966078247096320,1,34,15,19,0.4411764705882353,0.5588235294117647
290836404,0,999,982,17,0.982982982982983,0.01701701701701702
1266160195371220992,1,259,102,157,0.3938223938223938,0.6061776061776062
3024427479,0,411,395,16,0.9610705596107056,0.038929440389294405
1320277696593657857,1,158,10,148,0.06329113924050633,0.9367088607594937
898316946441207808,0,798,794,4,0.9949874686716792,0.005012531328320802
1131320506496557056,1,249,27,222,0.10843373493975904,0.891566265060241
395698479,0,682,675,7,0.9897360703812317,0.010263929618768328
1187367811393437698,1,923,195,728,0.2112676056338028,0.7887323943661971
1214926029640232961,0,147,146,1,0.9931972789115646,0.006802721088435374
1267234566919598088,1,238,36,202,0.15126050420168066,0.8487394957983193
901613827644588032,0,83,81,2,0.9759036144578314,0.024096385542168676
824975972034154496,1,1000,40,960,0.04,0.96
780996456572456960,0,633,626,7,0.9889415481832543,0.011058451816745656
483380753,1,713,35,678,0.04908835904628331,0.9509116409537167
2898055326,0,1000,931,69,0.931,0.069
1721103228,1,824,52,772,0.06310679611650485,0.9368932038834952
3452326035,0,522,522,0,1.0,0.0
16220735,1,516,48,468,0.09302325581395349,0.9069767441860465
1646841313,0,360,360,0,1.0,0.0
818990337309941762,1,612,56,556,0.0915032679738562,0.9084967320261438
3065469622,0,739,731,8,0.9891745602165088,0.010825439783491205
1099073392706080774,1,200,30,170,0.15,0.85
1143189259534262272,0,1000,981,19,0.981,0.019
1080199557999460352,1,148,33,115,0.22297297297297297,0.777027027027027
1435686776245456898,0,465,426,39,0.9161290322580645,0.08387096774193549
36058678,1,746,178,568,0.2386058981233244,0.7613941018766756
1165056845435875335,0,93,93,0,1.0,0.0
1208309655769899009,1,677,127,550,0.18759231905465287,0.8124076809453471
1526620589976391681,0,733,731,2,0.9972714870395635,0.002728512960436562
57997226,1,1000,271,729,0.271,0.729
1080569777683345408,0,94,94,0,1.0,0.0
1283115297231327232,1,88,4,84,0.045454545454545456,0.9545454545454546
29864099,0,204,199,5,0.9754901960784313,0.024509803921568627
1139626734150705158,1,1000,282,718,0.282,0.718
330433289,0,478,448,30,0.9372384937238494,0.06276150627615062
98171356,1,1000,117,883,0.117,0.883
1427380219095228421,0,247,245,2,0.9919028340080972,0.008097165991902834
38447262,1,800,149,651,0.18625,0.81375
189640100,0,1000,996,4,0.996,0.004
12367852,1,92,13,79,0.14130434782608695,0.8586956521739131
1225431153613660162,0,1000,993,7,0.993,0.007
890951942482079748,1,824,155,669,0.18810679611650485,0.8118932038834952
2645213199,0,560,541,19,0.9660714285714286,0.033928571428571426
824485553257091072,1,1000,104,896,0.104,0.896
114481037,0,65,65,0,1.0,0.0
1220989277288517635,1,752,92,660,0.12234042553191489,0.8776595744680851
4075943843,0,146,141,5,0.9657534246575342,0.03424657534246575
42318878,1,1000,18,982,0.018,0.982
15360831,0,584,546,38,0.934931506849315,0.06506849315068493
1462134934232084485,1,33,1,32,0.030303030303030304,0.9696969696969697
3291839138,0,335,335,0,1.0,0.0
981045752,1,798,42,756,0.05263157894736842,0.9473684210526315
777298973170073600,0,346,345,1,0.9971098265895953,0.002890173410404624
1581896533,1,630,96,534,0.1523809523809524,0.8476190476190476
764770692,0,958,957,1,0.9989561586638831,0.0010438413361169101
1336343552079564803,1,171,40,131,0.23391812865497075,0.7660818713450293
1530584935572062208,0,145,139,6,0.9586206896551724,0.041379310344827586
26876793,1,958,85,873,0.08872651356993737,0.9112734864300627
254722394,0,1000,997,3,0.997,0.003
808079265120026624,1,886,221,665,0.24943566591422123,0.7505643340857788
1262880199,0,975,966,9,0.9907692307692307,0.009230769230769232
545997922,1,843,54,789,0.06405693950177936,0.9359430604982206
2880238274,0,105,98,7,0.9333333333333333,0.06666666666666667
28063899,1,269,18,251,0.06691449814126393,0.9330855018587361
25676048,0,1000,977,23,0.977,0.023
1392951004174376964,1,1000,146,854,0.146,0.854
1222686962,0,902,884,18,0.9800443458980045,0.019955654101995565
497477784,1,743,279,464,0.3755047106325707,0.6244952893674294
1091518251367124993,0,885,850,35,0.96045197740113,0.03954802259887006
101977833,1,416,32,384,0.07692307692307693,0.9230769230769231
75631257,0,292,290,2,0.9931506849315068,0.00684931506849315
2680157564,1,178,11,167,0.06179775280898876,0.9382022471910112
1304872002008821760,0,276,276,0,1.0,0.0
435542855,1,171,8,163,0.04678362573099415,0.9532163742690059
755624623438528512,0,1000,998,2,0.998,0.002
535407388,1,406,14,392,0.034482758620689655,0.9655172413793104
115675512,0,1000,781,219,0.781,0.219
59929465,1,131,38,93,0.2900763358778626,0.7099236641221374
2658475964,0,580,578,2,0.996551724137931,0.0034482758620689655
1835977448,1,218,15,203,0.06880733944954129,0.9311926605504587
470221826,0,163,157,6,0.9631901840490797,0.03680981595092025
1646174076,1,1000,23,977,0.023,0.977
274618739,0,1000,969,31,0.969,0.031
991831802963689472,1,968,85,883,0.0878099173553719,0.9121900826446281
713164566381797378,0,129,116,13,0.8992248062015504,0.10077519379844961
1204526230483226624,1,778,304,474,0.390745501285347,0.609254498714653
1170516792726446082,0,434,417,17,0.9608294930875576,0.03917050691244239
927057902707163136,1,375,40,335,0.10666666666666667,0.8933333333333333
3625278436,0,789,789,0,1.0,0.0
408200527,1,712,39,673,0.054775280898876406,0.9452247191011236
23296501,0,1000,998,2,0.998,0.002
481331346,1,449,40,409,0.08908685968819599,0.910913140311804
1522041253604564994,0,32,32,0,1.0,0.0
1542314695,1,276,24,252,0.08695652173913043,0.9130434782608695
1519018093506301953,0,744,739,5,0.9932795698924731,0.006720430107526882
1004142841008754688,1,1000,162,838,0.162,0.838
1462368906,0,1000,933,67,0.933,0.067
984322658530545664,1,143,34,109,0.23776223776223776,0.7622377622377622
304669084,0,307,307,0,1.0,0.0
299653704,1,1000,204,796,0.204,0.796
88698464,0,443,433,10,0.9774266365688488,0.022573363431151242
3177352486,1,35,13,22,0.37142857142857144,0.6285714285714286
33076869,0,312,298,14,0.9551282051282052,0.04487179487179487
1269781963021398018,1,442,188,254,0.4253393665158371,0.5746606334841629
2177124119,0,775,771,4,0.9948387096774194,0.005161290322580645
1142657867066929152,1,651,139,512,0.21351766513056836,0.7864823348694316
37990995,0,987,975,12,0.9878419452887538,0.0121580547112462
932050540539789312,1,125,21,104,0.168,0.832
1363485599223660546,0,402,397,5,0.9875621890547264,0.012437810945273632
784786697745817601,1,287,9,278,0.0313588850174216,0.9686411149825784
1016717821932425218,0,469,454,15,0.9680170575692963,0.031982942430703626
860663952694538240,1,1000,6,994,0.006,0.994
1012096797655777280,0,417,415,2,0.9952038369304557,0.004796163069544364
18735212,1,1000,63,937,0.063,0.937
2424500887,0,507,498,9,0.9822485207100592,0.01775147928994083
1439725342990782464,1,162,30,132,0.18518518518518517,0.8148148148148148
6264172,0,689,670,19,0.9724238026124818,0.027576197387518143
1620421393,1,63,13,50,0.20634920634920634,0.7936507936507936
372410276,0,1000,999,1,0.999,0.001
3592456096,1,1000,305,695,0.305,0.695
3005249498,1,1000,35,965,0.035,0.965
1245012924,0,386,382,4,0.9896373056994818,0.010362694300518135
1417687888943357954,1,74,12,62,0.16216216216216217,0.8378378378378378
196174548,0,1000,870,130,0.87,0.13
860188999658348544,1,309,31,278,0.10032362459546926,0.8996763754045307
743761720846389249,0,1000,997,3,0.997,0.003
893876011,1,170,14,156,0.08235294117647059,0.9176470588235294
2175110855,0,1000,930,70,0.93,0.07
41052290,1,280,19,261,0.06785714285714285,0.9321428571428572
24747336,0,221,209,12,0.9457013574660633,0.05429864253393665
1436183425988300804,1,412,151,261,0.36650485436893204,0.633495145631068
715175244,0,526,456,70,0.8669201520912547,0.13307984790874525
916008501050318853,0,1000,991,9,0.991,0.009
61714805,1,1000,123,877,0.123,0.877
348046872,0,488,481,7,0.985655737704918,0.014344262295081968
341304134,1,441,48,393,0.10884353741496598,0.891156462585034
153828228,0,979,979,0,1.0,0.0
1315389362511785987,0,149,145,4,0.9731543624161074,0.026845637583892617
893326592734265345,1,105,29,76,0.2761904761904762,0.7238095238095238
19620476,0,276,266,10,0.9637681159420289,0.036231884057971016
1188213211142742016,1,284,75,209,0.2640845070422535,0.7359154929577465
3318033083,0,590,588,2,0.9966101694915255,0.003389830508474576
2730337686,1,1000,115,885,0.115,0.885
1474117430821675018,0,730,715,15,0.9794520547945206,0.02054794520547945
1064658433,1,310,79,231,0.25483870967741934,0.7451612903225806
902738046,0,806,805,1,0.9987593052109182,0.0012406947890818859
14549893,1,1000,268,732,0.268,0.732
2936379992,0,474,473,1,0.9978902953586498,0.002109704641350211
344962780,1,225,55,170,0.24444444444444444,0.7555555555555555
1036263329340243968,0,171,170,1,0.9941520467836257,0.005847953216374269
1314656918,1,1000,170,830,0.17,0.83
2817586549,0,5,5,0,1.0,0.0
1469030011726352388,1,1000,219,781,0.219,0.781
2231102795,0,267,266,1,0.9962546816479401,0.003745318352059925
1107945786,1,84,7,77,0.08333333333333333,0.9166666666666666
469776303,0,205,202,3,0.9853658536585366,0.014634146341463415
708514483702996994,1,232,18,214,0.07758620689655173,0.9224137931034483
102262901,0,1000,920,80,0.92,0.08
1346113744812838912,1,659,120,539,0.18209408194233687,0.8179059180576631
2714081174,0,588,579,9,0.9846938775510204,0.015306122448979591
397398864,1,627,14,613,0.022328548644338118,0.9776714513556619
780269431,0,1000,952,48,0.952,0.048
1003329251632820224,1,874,14,860,0.016018306636155607,0.9839816933638444
898958150,0,146,146,0,1.0,0.0
967436188536659968,1,134,5,129,0.03731343283582089,0.9626865671641791
311891077,0,25,25,0,1.0,0.0
47169767,1,1000,144,856,0.144,0.856
1537739461777317889,0,45,42,3,0.9333333333333333,0.06666666666666667
1134235602772213760,1,271,82,189,0.3025830258302583,0.6974169741697417
793232910316896256,0,40,39,1,0.975,0.025
1496801787939942402,0,146,146,0,1.0,0.0
88985700,1,829,21,808,0.025331724969843185,0.9746682750301568
1447028076836233219,0,101,89,12,0.8811881188118812,0.1188118811881188
950651119,1,1000,92,908,0.092,0.908
242577946,0,1000,951,49,0.951,0.049
1286496032377810944,1,128,12,116,0.09375,0.90625
1220434580014096384,0,53,53,0,1.0,0.0
878052285728702465,1,1000,298,702,0.298,0.702
52542621,0,693,689,4,0.9942279942279942,0.005772005772005772
2690989873,1,519,68,451,0.13102119460500963,0.8689788053949904
2891317151,0,555,551,4,0.9927927927927928,0.007207207207207207
1368365406,1,995,322,673,0.3236180904522613,0.6763819095477387
1274206014167035904,0,223,191,32,0.8565022421524664,0.14349775784753363
2967296263,0,298,296,2,0.9932885906040269,0.006711409395973154
913660530,1,615,22,593,0.03577235772357724,0.9642276422764228
827318648427597825,0,158,158,0,1.0,0.0
18136809,1,1000,219,781,0.219,0.781
908321432505110530,0,288,288,0,1.0,0.0
871914652686594050,1,519,64,455,0.1233140655105973,0.8766859344894027
911407303047467008,0,206,204,2,0.9902912621359223,0.009708737864077669
1391192709759700992,1,268,53,215,0.19776119402985073,0.8022388059701493
87618152,0,385,383,2,0.9948051948051948,0.005194805194805195
17905327,1,1000,158,842,0.158,0.842
192279913,0,1000,926,74,0.926,0.074
1499204747487633410,1,23,2,21,0.08695652173913043,0.9130434782608695
148468718,0,1000,784,216,0.784,0.216
2572812377,1,1000,238,762,0.238,0.762
1047277413753937922,0,305,304,1,0.9967213114754099,0.003278688524590164
2311029627,1,312,67,245,0.21474358974358973,0.7852564102564102
44868391,0,251,233,18,0.9282868525896414,0.07171314741035857
1385059551880298497,1,394,51,343,0.12944162436548223,0.8705583756345178
35889463,0,1000,991,9,0.991,0.009
345221768,1,616,48,568,0.07792207792207792,0.922077922077922
71652842,0,1000,995,5,0.995,0.005
1621778341,1,923,217,706,0.23510292524377033,0.7648970747562297
214218730,0,87,87,0,1.0,0.0
631471533,1,1000,91,909,0.091,0.909
1300888301268733957,0,88,88,0,1.0,0.0
186676802,1,1000,125,875,0.125,0.875
254869749,0,1000,995,5,0.995,0.005
1105619284858933248,0,1000,967,33,0.967,0.033
1445598770759016449,1,352,59,293,0.16761363636363635,0.8323863636363636
45139332,0,376,371,5,0.9867021276595744,0.013297872340425532
1370438474835320834,0,75,73,2,0.9733333333333334,0.02666666666666667
1510757320107646985,1,140,12,128,0.08571428571428572,0.9142857142857143
733547074826838017,1,472,21,451,0.04449152542372881,0.9555084745762712
1472623945,0,709,693,16,0.9774330042313117,0.022566995768688293
2422408256,1,561,35,526,0.062388591800356503,0.9376114081996435
1456250191799992331,0,200,194,6,0.97,0.03
197313522,1,187,17,170,0.09090909090909091,0.9090909090909091
51136953,0,698,696,2,0.997134670487106,0.0028653295128939827
1426491639451713538,1,151,36,115,0.23841059602649006,0.7615894039735099
1510784596253753350,0,140,140,0,1.0,0.0
1922100336,1,482,105,377,0.21784232365145229,0.7821576763485477
907077702,0,1000,995,5,0.995,0.005
1100945195439439872,1,225,44,181,0.19555555555555557,0.8044444444444444
1571850235,0,142,141,1,0.9929577464788732,0.007042253521126761
1614449065,1,133,17,116,0.12781954887218044,0.8721804511278195
1128468848909398016,0,1000,952,48,0.952,0.048
1358116247305555968,1,97,12,85,0.12371134020618557,0.8762886597938144
1131588455656505344,0,251,251,0,1.0,0.0
988276381371940865,1,64,1,63,0.015625,0.984375
66881845,0,132,131,1,0.9924242424242424,0.007575757575757576
1026684187569532934,1,613,40,573,0.06525285481239804,0.9347471451876019
1221474544789213184,0,11,11,0,1.0,0.0
1322286695203500032,1,1000,86,914,0.086,0.914
20107532,0,1000,959,41,0.959,0.041
430204744,1,1000,227,773,0.227,0.773
299825559,0,655,651,4,0.9938931297709923,0.0061068702290076335
715649743,1,171,33,138,0.19298245614035087,0.8070175438596491
1107229822743445504,0,1000,799,201,0.799,0.201
794527141,1,1000,53,947,0.053,0.947
287452569,0,380,366,14,0.9631578947368421,0.03684210526315789
4662651569,1,146,26,120,0.1780821917808219,0.821917808219178
2730428506,0,327,326,1,0.9969418960244648,0.0030581039755351682
1284982557742858248,1,196,71,125,0.3622448979591837,0.6377551020408163
341286098,0,1000,995,5,0.995,0.005
14181949,1,128,18,110,0.140625,0.859375
544010495,0,49,49,0,1.0,0.0
25580833,1,50,5,45,0.1,0.9
2476120203,0,674,674,0,1.0,0.0
1023399618862833664,1,283,13,270,0.045936395759717315,0.9540636042402827
1617268405,0,705,703,2,0.9971631205673759,0.0028368794326241137
1287994057,1,501,162,339,0.32335329341317365,0.6766467065868264
24641989,0,723,708,15,0.979253112033195,0.02074688796680498
1301016461473800193,1,1000,450,550,0.45,0.55
300945133,0,494,493,1,0.9979757085020243,0.0020242914979757085
256528781,1,1000,50,950,0.05,0.95
15303494,0,1000,984,16,0.984,0.016
578402918,1,693,23,670,0.03318903318903319,0.9668109668109668
1394284677809131524,0,92,92,0,1.0,0.0
110772080,1,1000,305,695,0.305,0.695
879413588624105472,0,400,395,5,0.9875,0.0125
989337438232367104,1,605,39,566,0.06446280991735537,0.9355371900826446
3310063619,0,380,378,2,0.9947368421052631,0.005263157894736842
1410984612604440577,1,364,107,257,0.29395604395604397,0.7060439560439561
124921609,0,627,582,45,0.9282296650717703,0.07177033492822966
24360067,1,1000,85,915,0.085,0.915
711026569,0,12,12,0,1.0,0.0
1121928257673342976,1,224,20,204,0.08928571428571429,0.9107142857142857
825409913660776449,0,72,68,4,0.9444444444444444,0.05555555555555555
830930780759023616,1,543,66,477,0.12154696132596685,0.8784530386740331
128702366,0,1000,988,12,0.988,0.012
2746828021,1,998,135,863,0.13527054108216433,0.8647294589178357
862343523277963264,0,1000,973,27,0.973,0.027
563257615,1,359,18,341,0.05013927576601671,0.9498607242339833
1215178986860548096,0,899,676,223,0.7519466073414905,0.24805339265850945
2820553645,1,945,179,766,0.18941798941798943,0.8105820105820106
1387635371316547589,0,48,48,0,1.0,0.0
267863034,1,652,47,605,0.07208588957055215,0.9279141104294478
1259226698509430785,0,174,173,1,0.9942528735632183,0.005747126436781609
4538189955,1,246,10,236,0.04065040650406504,0.959349593495935
20905775,0,311,304,7,0.977491961414791,0.022508038585209004
856468487761481728,1,1000,55,945,0.055,0.945
979105938303959040,0,1000,988,12,0.988,0.012
18084285,1,152,42,110,0.27631578947368424,0.7236842105263158
1255055844,0,310,310,0,1.0,0.0
777251315235819520,1,506,31,475,0.06126482213438735,0.9387351778656127
968738634663940097,0,130,123,7,0.9461538461538461,0.05384615384615385
2915144258,1,93,11,82,0.11827956989247312,0.8817204301075269
472120309,0,146,146,0,1.0,0.0
1308553645563285505,1,983,172,811,0.17497456765005087,0.8250254323499492
765369557401866240,0,462,448,14,0.9696969696969697,0.030303030303030304
952553133812588545,1,201,5,196,0.024875621890547265,0.9751243781094527
349900684,0,725,708,17,0.976551724137931,0.023448275862068966
884334036885393408,1,1000,442,558,0.442,0.558
45331487,0,1000,995,5,0.995,0.005
612662362,1,1000,78,922,0.078,0.922
19694483,0,806,772,34,0.9578163771712159,0.04218362282878412
21653643,1,557,48,509,0.08617594254937164,0.9138240574506283
1122943756041445381,0,443,441,2,0.9954853273137697,0.004514672686230248
1250930819323002880,1,114,10,104,0.08771929824561403,0.9122807017543859
2415294752,0,38,37,1,0.9736842105263158,0.02631578947368421
414925335,1,551,60,491,0.1088929219600726,0.8911070780399274
962067750683209729,0,685,685,0,1.0,0.0
30151307,1,1000,37,963,0.037,0.963
23501342,0,355,352,3,0.9915492957746479,0.008450704225352112
1079099751126036480,1,331,95,236,0.28700906344410876,0.7129909365558912
1487126411299201033,0,1000,993,7,0.993,0.007
446718024,1,287,12,275,0.041811846689895474,0.9581881533101045
14272403,0,436,422,14,0.9678899082568807,0.03211009174311927
974046536664604672,1,288,59,229,0.2048611111111111,0.7951388888888888
31230071,0,298,284,14,0.9530201342281879,0.04697986577181208
2553759020,1,1000,155,845,0.155,0.845
1123669074414854146,0,272,264,8,0.9705882352941176,0.029411764705882353
344289682,1,1000,86,914,0.086,0.914
2209588285,0,1000,986,14,0.986,0.014
230303794,1,988,89,899,0.09008097165991903,0.909919028340081
2843078559,0,247,246,1,0.9959514170040485,0.004048582995951417
24928189,1,817,74,743,0.09057527539779682,0.9094247246022031
813973967908335616,0,50,50,0,1.0,0.0
16505174,1,1000,79,921,0.079,0.921
776263068963770373,0,328,326,2,0.9939024390243902,0.006097560975609756
1490878922036158467,1,777,52,725,0.06692406692406692,0.9330759330759331
1029571481313914880,0,76,70,6,0.9210526315789473,0.07894736842105263
184611744,1,748,63,685,0.08422459893048129,0.9157754010695187
3400888907,0,350,348,2,0.9942857142857143,0.005714285714285714
382504012,1,142,31,111,0.21830985915492956,0.7816901408450704
707417457699344384,0,865,843,22,0.9745664739884393,0.025433526011560695
922234784579047425,1,602,143,459,0.23754152823920266,0.7624584717607974
868623914615832576,0,1000,765,235,0.765,0.235
2800255093,1,1000,124,876,0.124,0.876
864645051871252480,0,326,323,3,0.99079754601227,0.009202453987730062
1100820325296685056,1,1000,94,906,0.094,0.906
1087035581027311617,0,1000,999,1,0.999,0.001
42619335,1,491,76,415,0.15478615071283094,0.845213849287169
947908293267263490,0,436,436,0,1.0,0.0
1377655071538745349,1,212,76,136,0.3584905660377358,0.6415094339622641
1107111396649500672,0,345,339,6,0.9826086956521739,0.017391304347826087
785988273453862912,1,481,27,454,0.056133056133056136,0.9438669438669439
3192441577,0,4,4,0,1.0,0.0
904833143995289600,1,580,36,544,0.06206896551724138,0.9379310344827586
265815093,0,1000,1000,0,1.0,0.0
434547908,1,845,128,717,0.1514792899408284,0.8485207100591716
16383211,0,1000,958,42,0.958,0.042
243482951,1,1000,57,943,0.057,0.943
1089787957,0,1000,969,31,0.969,0.031
4844351337,1,1000,424,576,0.424,0.576
186994694,0,222,220,2,0.990990990990991,0.009009009009009009
20006771,1,1000,306,694,0.306,0.694
172206890,0,147,113,34,0.7687074829931972,0.23129251700680273
868538224368603136,1,970,314,656,0.3237113402061856,0.6762886597938145
1032967810178330624,0,133,133,0,1.0,0.0
784875958683758592,1,811,55,756,0.06781750924784218,0.9321824907521579
22579057,0,265,252,13,0.9509433962264151,0.04905660377358491
1014063005305192448,1,447,93,354,0.2080536912751678,0.7919463087248322
2222369367,0,113,113,0,1.0,0.0
1636936250,1,498,21,477,0.04216867469879518,0.9578313253012049
1346552658270814209,0,203,200,3,0.9852216748768473,0.014778325123152709
707981623443255296,1,1000,63,937,0.063,0.937
1203187414241464321,0,751,723,28,0.96271637816245,0.037283621837549935
280761808,1,546,55,491,0.10073260073260074,0.8992673992673993
1318755293384249344,0,29,27,2,0.9310344827586207,0.06896551724137931
1290993216,1,909,157,752,0.17271727172717272,0.8272827282728272
1016648163078344704,0,260,259,1,0.9961538461538462,0.0038461538461538464
2972412586,1,234,28,206,0.11965811965811966,0.8803418803418803
2941812064,0,184,184,0,1.0,0.0
1128059132408365056,1,73,5,68,0.0684931506849315,0.9315068493150684
972576469024112641,0,118,108,10,0.9152542372881356,0.0847457627118644
1469793471984652288,1,306,47,259,0.15359477124183007,0.8464052287581699
966909877263130624,0,169,151,18,0.893491124260355,0.10650887573964497
1211476508994195457,1,855,118,737,0.13801169590643275,0.8619883040935673
251724741,0,108,108,0,1.0,0.0
1385980640,1,361,15,346,0.04155124653739612,0.9584487534626038
814712925164224512,0,58,58,0,1.0,0.0
216126673,1,1000,261,739,0.261,0.739
1385362711345876998,0,122,122,0,1.0,0.0
323642910,1,261,50,211,0.19157088122605365,0.8084291187739464
1273409312698834944,0,390,390,0,1.0,0.0
1113257880524869632,1,197,5,192,0.025380710659898477,0.9746192893401016
1415739188821913603,0,94,93,1,0.9893617021276596,0.010638297872340425
266743513,1,1000,212,788,0.212,0.788
937421030099947520,0,1000,1000,0,1.0,0.0
1134230842387996672,1,98,11,87,0.11224489795918367,0.8877551020408163
1480435807995502592,0,64,64,0,1.0,0.0
1033554497400983554,1,666,104,562,0.15615615615615616,0.8438438438438438
1145104663420817408,0,117,117,0,1.0,0.0
592601543,1,842,146,696,0.17339667458432304,0.8266033254156769
329277343,1,269,8,261,0.02973977695167286,0.9702602230483272
748493094,0,1000,993,7,0.993,0.007
2592325153,1,1000,96,904,0.096,0.904
45732426,0,413,411,2,0.9951573849878934,0.004842615012106538
1052994516,1,863,124,739,0.1436848203939745,0.8563151796060255
815663287253639168,0,610,601,9,0.9852459016393442,0.014754098360655738
704067252673314817,1,341,65,276,0.1906158357771261,0.8093841642228738
804922354107383808,0,512,485,27,0.947265625,0.052734375
1044449982126981120,1,1000,103,897,0.103,0.897
912440093637562368,0,155,154,1,0.9935483870967742,0.0064516129032258064
1273648073798029312,1,1000,146,854,0.146,0.854
2910114783,0,34,34,0,1.0,0.0
256344514,1,308,8,300,0.025974025974025976,0.974025974025974
733381412024385537,0,275,264,11,0.96,0.04
33860779,1,999,125,874,0.12512512512512514,0.8748748748748749
1219818014335307776,0,228,228,0,1.0,0.0
734823716249567233,1,999,332,667,0.33233233233233234,0.6676676676676677
3439120917,1,602,101,501,0.16777408637873753,0.8322259136212624
52341879,0,879,879,0,1.0,0.0
3177014041,1,816,70,746,0.0857843137254902,0.9142156862745098
1505060984402198528,0,247,245,2,0.9919028340080972,0.008097165991902834
1032698815155978240,1,1000,111,889,0.111,0.889
1364592068555849730,0,556,550,6,0.9892086330935251,0.01079136690647482
1210561634,1,144,15,129,0.10416666666666667,0.8958333333333334
1942880142,0,306,306,0,1.0,0.0
1356848616510394368,1,179,35,144,0.19553072625698323,0.8044692737430168
34295457,0,546,523,23,0.9578754578754579,0.04212454212454213
109173792,1,607,64,543,0.10543657331136738,0.8945634266886326
2326141092,0,556,521,35,0.9370503597122302,0.06294964028776978
15613458,1,1000,56,944,0.056,0.944
1231659769775247362,0,628,627,1,0.9984076433121019,0.0015923566878980893
4719604050,1,930,140,790,0.15053763440860216,0.8494623655913979
2242615434,0,1000,985,15,0.985,0.015
875689837323595783,1,115,15,100,0.13043478260869565,0.8695652173913043
1066746012444831745,0,1000,918,82,0.918,0.082
1544669298,1,538,92,446,0.17100371747211895,0.828996282527881
1339688264756834304,0,1,1,0,1.0,0.0
994710976200171521,1,31,7,24,0.22580645161290322,0.7741935483870968
1505591233615482880,0,34,34,0,1.0,0.0
1371974016936767490,1,68,10,58,0.14705882352941177,0.8529411764705882
65407602,0,151,151,0,1.0,0.0
332955509,0,521,498,23,0.9558541266794626,0.044145873320537425
497380568,1,1000,155,845,0.155,0.845
63306281,0,778,772,6,0.9922879177377892,0.007712082262210797
1011407416125153280,1,359,62,297,0.17270194986072424,0.8272980501392758
2216940896,0,149,149,0,1.0,0.0
1380593806957928450,1,234,53,181,0.2264957264957265,0.7735042735042735
1479292750172352512,0,266,249,17,0.9360902255639098,0.06390977443609022
4175047109,1,1000,95,905,0.095,0.905
1334922685231542281,0,38,38,0,1.0,0.0
1325401967531798528,1,251,58,193,0.23107569721115537,0.7689243027888446
1628314597,0,236,234,2,0.9915254237288136,0.00847457627118644
7174332,1,1000,130,870,0.13,0.87
3495523714,0,997,983,14,0.9859578736208626,0.014042126379137413
21695166,1,1000,179,821,0.179,0.821
850375016,0,186,186,0,1.0,0.0
2742457686,1,302,57,245,0.18874172185430463,0.8112582781456954
34389811,0,1000,999,1,0.999,0.001
3678223754,1,788,68,720,0.08629441624365482,0.9137055837563451
1343620358709137408,0,320,307,13,0.959375,0.040625
4789750995,1,360,50,310,0.1388888888888889,0.8611111111111112
419000144,0,779,774,5,0.993581514762516,0.006418485237483954
938265504493588481,1,1000,273,727,0.273,0.727
1325599560673144839,0,531,530,1,0.9981167608286252,0.0018832391713747645
205273598,1,219,35,184,0.1598173515981735,0.8401826484018264
899794294772555777,0,293,288,5,0.9829351535836177,0.017064846416382253
748390264549613570,1,103,14,89,0.13592233009708737,0.8640776699029126
1401276704002347012,0,18,18,0,1.0,0.0
845385473770115073,1,66,3,63,0.045454545454545456,0.9545454545454546
1195129692,0,1000,930,70,0.93,0.07
749479923811627008,1,728,129,599,0.1771978021978022,0.8228021978021978
50867191,0,290,280,10,0.9655172413793104,0.034482758620689655
1343260920043094016,1,701,123,578,0.1754636233951498,0.8245363766048502
728446707571154945,0,29,29,0,1.0,0.0
1430342020720115714,1,1000,266,734,0.266,0.734
542947108,0,470,463,7,0.9851063829787234,0.014893617021276596
1071894149958373376,1,863,37,826,0.04287369640787949,0.9571263035921205
233021519,0,1000,998,2,0.998,0.002
509068263,1,166,20,146,0.12048192771084337,0.8795180722891566
255817847,0,442,438,4,0.9909502262443439,0.00904977375565611
1306548482845454337,1,52,6,46,0.11538461538461539,0.8846153846153846
2788834092,0,81,75,6,0.9259259259259259,0.07407407407407407
1699497367,1,344,76,268,0.22093023255813954,0.7790697674418605
1518697838913466368,0,15,14,1,0.9333333333333333,0.06666666666666667
716823426233606144,1,41,1,40,0.024390243902439025,0.975609756097561
1009672144161083392,0,1000,956,44,0.956,0.044
22189774,1,333,49,284,0.14714714714714713,0.8528528528528528
54641697,0,1000,979,21,0.979,0.021
1378937721897447429,1,222,27,195,0.12162162162162163,0.8783783783783784
1446943362335055878,0,115,114,1,0.991304347826087,0.008695652173913044
1148411833042104320,1,70,26,44,0.37142857142857144,0.6285714285714286
209829837,0,738,730,8,0.989159891598916,0.01084010840108401
1270800635495976960,1,86,0,86,0.0,1.0
3301224835,0,772,761,11,0.9857512953367875,0.014248704663212436
1502866035174608899,1,133,40,93,0.3007518796992481,0.6992481203007519
1115654861549330432,0,523,521,2,0.9961759082217974,0.0038240917782026767
1265411747072131072,1,96,21,75,0.21875,0.78125
356312146,0,1000,996,4,0.996,0.004
279134156,1,987,215,772,0.21783181357649442,0.7821681864235056
22214271,0,1000,937,63,0.937,0.063
1011069162456641536,1,1000,71,929,0.071,0.929
421121346,0,246,244,2,0.991869918699187,0.008130081300813009
1510381041575473156,1,45,8,37,0.17777777777777778,0.8222222222222222
3692678479,0,326,324,2,0.9938650306748467,0.006134969325153374
1313722500103262213,1,272,33,239,0.1213235294117647,0.8786764705882353
1487966757948166146,0,1000,1000,0,1.0,0.0
175105413,1,549,79,470,0.14389799635701275,0.8561020036429873
14869061,0,290,273,17,0.9413793103448276,0.05862068965517241
1100182047178526720,1,321,19,302,0.059190031152647975,0.940809968847352
212320023,0,278,276,2,0.9928057553956835,0.007194244604316547
976929733383475201,1,582,62,520,0.10652920962199312,0.8934707903780069
362901719,0,295,187,108,0.6338983050847458,0.36610169491525424
100684324,1,791,17,774,0.021491782553729456,0.9785082174462706
15291495,0,1000,902,98,0.902,0.098
18834220,1,992,131,861,0.13205645161290322,0.8679435483870968
2569435660,0,401,399,2,0.9950124688279302,0.004987531172069825
1430387964,1,1000,73,927,0.073,0.927
20327104,0,313,302,11,0.9648562300319489,0.03514376996805112
1182014755688632322,1,1000,156,844,0.156,0.844
1531109761348943877,0,28,28,0,1.0,0.0
963365737,0,548,544,4,0.9927007299270073,0.0072992700729927005
15978308,1,658,31,627,0.04711246200607903,0.952887537993921
1384339066733273102,0,431,416,15,0.9651972157772621,0.03480278422273782
796876350736965632,1,42,4,38,0.09523809523809523,0.9047619047619048
429372112,0,181,177,4,0.9779005524861878,0.022099447513812154
152762762,1,1000,191,809,0.191,0.809
884459755346853888,0,184,178,6,0.967391304347826,0.03260869565217391
1544821975,1,662,252,410,0.3806646525679758,0.6193353474320241
4589737815,0,789,773,16,0.9797211660329531,0.020278833967046894
2557534440,1,999,83,916,0.08308308308308308,0.9169169169169169
1126817431,0,274,274,0,1.0,0.0
408216558,1,111,29,82,0.26126126126126126,0.7387387387387387
720693512992260096,0,222,222,0,1.0,0.0
630527536,1,1000,141,859,0.141,0.859
1475324354418208770,0,2,2,0,1.0,0.0
59519728,1,1000,45,955,0.045,0.955
2813475842,0,798,792,6,0.9924812030075187,0.007518796992481203
539416768,1,1000,112,888,0.112,0.888
822711970264649728,0,1000,990,10,0.99,0.01
1502864821154287617,1,280,10,270,0.03571428571428571,0.9642857142857143
909611544639528961,0,332,328,4,0.9879518072289156,0.012048192771084338
154421336,1,141,39,102,0.2765957446808511,0.723404255319149
3313890304,0,262,262,0,1.0,0.0
17981074,1,1000,108,892,0.108,0.892
401920004,0,81,81,0,1.0,0.0
2931519714,1,457,16,441,0.0350109409190372,0.9649890590809628
49797820,0,176,176,0,1.0,0.0
1135253530040836096,1,844,113,731,0.1338862559241706,0.8661137440758294
3655958175,0,1000,998,2,0.998,0.002
172114790,0,1000,997,3,0.997,0.003
333161311,1,307,73,234,0.23778501628664495,0.762214983713355
470759329,0,311,310,1,0.9967845659163987,0.003215434083601286
2760172957,1,228,21,207,0.09210526315789473,0.9078947368421053
1373420518456500228,0,813,799,14,0.982779827798278,0.017220172201722016
968728970,1,214,40,174,0.18691588785046728,0.8130841121495327
699988098592018432,0,1000,943,57,0.943,0.057
934268192440180737,1,110,24,86,0.21818181818181817,0.7818181818181819
1242604418,0,1000,994,6,0.994,0.006
724964443,1,851,71,780,0.08343125734430082,0.9165687426556992
1642140085,0,675,673,2,0.997037037037037,0.002962962962962963
1461233498,1,203,25,178,0.12315270935960591,0.8768472906403941
1011008340367953920,0,1000,993,7,0.993,0.007
947988410286985216,1,578,153,425,0.2647058823529412,0.7352941176470589
3112397631,0,688,673,15,0.9781976744186046,0.02180232558139535
3968498902,1,1000,242,758,0.242,0.758
1355806963,0,249,228,21,0.9156626506024096,0.08433734939759036
895951,1,1000,205,795,0.205,0.795
769214912824537089,0,651,628,23,0.9646697388632872,0.03533026113671275
434612408,1,303,20,283,0.066006600660066,0.933993399339934
1292482879,0,78,78,0,1.0,0.0
951192234682023938,1,620,156,464,0.25161290322580643,0.7483870967741936
475374803,0,296,248,48,0.8378378378378378,0.16216216216216217
882551683,1,1000,226,774,0.226,0.774
4901337477,0,125,125,0,1.0,0.0
336328303,1,999,73,926,0.07307307307307308,0.9269269269269269
1255163854948098048,0,1000,961,39,0.961,0.039
1265747462649720832,1,35,18,17,0.5142857142857142,0.4857142857142857
1320614268,0,773,750,23,0.9702457956015524,0.029754204398447608
832597482,1,235,66,169,0.28085106382978725,0.7191489361702128
142887096,0,224,224,0,1.0,0.0
23536317,1,581,79,502,0.1359724612736661,0.8640275387263339
2312257488,0,152,151,1,0.993421052631579,0.006578947368421052
4771054194,1,240,7,233,0.029166666666666667,0.9708333333333333
1509538229950857218,0,29,29,0,1.0,0.0
769599806,1,587,23,564,0.039182282793867124,0.9608177172061328
747282654119112710,1,381,77,304,0.2020997375328084,0.7979002624671916
805129467811262465,0,410,409,1,0.9975609756097561,0.0024390243902439024
1462464738823180291,1,62,11,51,0.1774193548387097,0.8225806451612904
1052218392898392064,0,745,720,25,0.9664429530201343,0.03355704697986577
49197924,1,423,32,391,0.07565011820330969,0.9243498817966903
549713651,0,196,182,14,0.9285714285714286,0.07142857142857142
1143215088834240513,1,351,29,322,0.08262108262108261,0.9173789173789174
1534542198066368513,0,888,885,3,0.9966216216216216,0.0033783783783783786
2257954556,1,393,9,384,0.022900763358778626,0.9770992366412213
25737626,0,1000,971,29,0.971,0.029
1625885552,1,730,210,520,0.2876712328767123,0.7123287671232876
15718458,0,764,684,80,0.8952879581151832,0.10471204188481675
1097339795364298752,1,377,40,337,0.10610079575596817,0.8938992042440318
1257596288025137152,0,437,420,17,0.9610983981693364,0.038901601830663615
1001963328900599808,1,913,84,829,0.09200438116100766,0.9079956188389924
2850875886,0,1000,994,6,0.994,0.006
10668,1,1000,146,854,0.146,0.854
56057430,1,759,66,693,0.08695652173913043,0.9130434782608695
927963823721668608,0,310,310,0,1.0,0.0
734324101,1,147,36,111,0.24489795918367346,0.7551020408163265
949504595469856769,0,75,74,1,0.9866666666666667,0.013333333333333334
1692573972,1,260,39,221,0.15,0.85
1471392383266918406,0,1,1,0,1.0,0.0
134116613,1,1000,133,867,0.133,0.867
2354286936,0,537,532,5,0.9906890130353817,0.00931098696461825
1106775079,1,399,32,367,0.08020050125313283,0.9197994987468672
2573763875,0,49,44,5,0.8979591836734694,0.10204081632653061
3142832617,1,1000,333,667,0.333,0.667
1487761627273302018,0,23,23,0,1.0,0.0
13292022,0,1000,866,134,0.866,0.134
965696575895871489,1,27,1,26,0.037037037037037035,0.9629629629629629
243329031,0,246,242,4,0.983739837398374,0.016260162601626018
29323331,1,1000,62,938,0.062,0.938
2547003829,0,1000,958,42,0.958,0.042
1445257722,1,784,42,742,0.05357142857142857,0.9464285714285714
823627605723201537,0,1000,966,34,0.966,0.034
2745406359,1,301,50,251,0.16611295681063123,0.8338870431893688
4784135388,0,1000,983,17,0.983,0.017
20895134,1,1000,319,681,0.319,0.681
865349742037012482,0,98,95,3,0.9693877551020408,0.030612244897959183
347575182,1,265,39,226,0.1471698113207547,0.8528301886792453
1286401556477284352,0,200,175,25,0.875,0.125
2632889308,1,1000,68,932,0.068,0.932
15556644,0,473,467,6,0.9873150105708245,0.012684989429175475
1023239842602405889,1,1000,149,851,0.149,0.851
1220169718130147329,0,166,163,3,0.9819277108433735,0.018072289156626505
1365783312,1,1000,7,993,0.007,0.993
859685726769758209,0,185,177,8,0.9567567567567568,0.043243243243243246
622803573,1,488,27,461,0.055327868852459015,0.944672131147541
2337346694,1,1000,72,928,0.072,0.928
1261816855376941056,0,628,533,95,0.8487261146496815,0.15127388535031847
751826880,1,690,56,634,0.08115942028985507,0.9188405797101449
1415802926828642307,0,1000,999,1,0.999,0.001
80586295,1,120,17,103,0.14166666666666666,0.8583333333333333
1534938651905314816,0,14,14,0,1.0,0.0
1289413170897985537,1,412,32,380,0.07766990291262135,0.9223300970873787
357932461,0,1000,958,42,0.958,0.042
716841378404143104,1,825,311,514,0.37696969696969695,0.623030303030303
882665552619208704,0,797,797,0,1.0,0.0
211659450,1,1000,151,849,0.151,0.849
171601635,0,1000,962,38,0.962,0.038
717129452,1,1000,204,796,0.204,0.796
3281411298,0,212,212,0,1.0,0.0
4137039083,1,1000,213,787,0.213,0.787
1145494066727194624,0,277,274,3,0.9891696750902527,0.010830324909747292
1510789396617965568,1,86,16,70,0.18604651162790697,0.813953488372093
39064160,0,999,994,5,0.994994994994995,0.005005005005005005
1254459710914342913,1,986,171,815,0.17342799188640973,0.8265720081135902
1186318807960305664,0,1000,985,15,0.985,0.015
1454357288819564548,1,137,31,106,0.22627737226277372,0.7737226277372263
865266191627149313,0,235,231,4,0.9829787234042553,0.01702127659574468
3296672021,1,1000,67,933,0.067,0.933
1496831276032081924,0,1,1,0,1.0,0.0
458062927,0,360,351,9,0.975,0.025
100036519,1,1000,37,963,0.037,0.963
3010719436,0,1000,1000,0,1.0,0.0
710892613675696128,1,1000,309,691,0.309,0.691
17884090,0,1000,993,7,0.993,0.007
1069682077665234954,1,903,140,763,0.15503875968992248,0.8449612403100775
614235551,0,1000,999,1,0.999,0.001
1009139262753792000,1,1000,369,631,0.369,0.631
1499495554560237568,0,310,296,14,0.9548387096774194,0.04516129032258064
1508283636809932801,1,245,53,192,0.2163265306122449,0.7836734693877551
1210039964,0,954,954,0,1.0,0.0
17850597,1,628,82,546,0.1305732484076433,0.8694267515923567
721569199466942464,0,401,394,7,0.9825436408977556,0.017456359102244388
1357896422365007874,1,1000,181,819,0.181,0.819
40477520,0,73,73,0,1.0,0.0
767318226070011904,1,1000,231,769,0.231,0.769
3922167197,1,1000,66,934,0.066,0.934
366166871,0,415,410,5,0.9879518072289156,0.012048192771084338
818803357930455040,1,1000,98,902,0.098,0.902
66701696,0,1000,993,7,0.993,0.007
2265116430,1,119,9,110,0.07563025210084033,0.9243697478991597
199415433,0,1000,1000,0,1.0,0.0
26674908,1,1000,159,841,0.159,0.841
1063483723948150784,0,1000,981,19,0.981,0.019
567554045,1,593,33,560,0.05564924114671164,0.9443507588532883
91047480,0,192,186,6,0.96875,0.03125
902583662,1,1000,274,726,0.274,0.726
1244123744899137538,0,95,95,0,1.0,0.0
18308698,1,1000,118,882,0.118,0.882
41310527,0,170,170,0,1.0,0.0
3064676872,1,459,110,349,0.23965141612200436,0.7603485838779956
279793555,0,1000,914,86,0.914,0.086
1003038058218999813,1,255,4,251,0.01568627450980392,0.984313725490196
823034581901144064,0,278,276,2,0.9928057553956835,0.007194244604316547
1510402319145443332,1,298,20,278,0.06711409395973154,0.9328859060402684
1416560321045614592,0,11,11,0,1.0,0.0
2263747147,1,999,93,906,0.09309309309309309,0.9069069069069069
1285955501000458247,0,248,247,1,0.9959677419354839,0.004032258064516129
731373872,1,230,10,220,0.043478260869565216,0.9565217391304348
940338701770489856,0,162,160,2,0.9876543209876543,0.012345679012345678
1476355941717221376,1,79,4,75,0.05063291139240506,0.9493670886075949
2533598071,0,325,321,4,0.9876923076923076,0.012307692307692308
1524163461940269056,1,739,84,655,0.11366711772665765,0.8863328822733424
1420977439145144331,0,48,48,0,1.0,0.0
3309975241,1,812,50,762,0.06157635467980296,0.9384236453201971
1275671752966844416,0,242,242,0,1.0,0.0
4007114608,1,1000,39,961,0.039,0.961
1268703723020333057,0,511,460,51,0.9001956947162426,0.09980430528375733
25516829,1,991,94,897,0.09485368314833502,0.905146316851665
166322127,0,1000,1000,0,1.0,0.0
18609494,1,1000,180,820,0.18,0.82
38460940,0,88,86,2,0.9772727272727273,0.022727272727272728
2386664311,1,800,203,597,0.25375,0.74625
733035837206601728,1,52,1,51,0.019230769230769232,0.9807692307692307
953995202,0,408,404,4,0.9901960784313726,0.00980392156862745
121222342,1,595,71,524,0.11932773109243698,0.880672268907563
285622842,0,1000,969,31,0.969,0.031
1095915410,1,999,150,849,0.15015015015015015,0.8498498498498499
711435739196620801,0,621,617,4,0.9935587761674718,0.00644122383252818
3513489796,1,685,64,621,0.09343065693430656,0.9065693430656935
102202348,0,347,311,36,0.8962536023054755,0.1037463976945245
102164609,0,147,142,5,0.9659863945578231,0.034013605442176874
1493350063547899905,1,283,51,232,0.18021201413427562,0.8197879858657244
1262166745,0,581,576,5,0.9913941480206541,0.008605851979345954
1076678069413441541,1,294,78,216,0.2653061224489796,0.7346938775510204
1013602074263805952,0,8,8,0,1.0,0.0
968524606746386432,1,545,134,411,0.24587155963302754,0.7541284403669725
1513654931819044867,0,163,158,5,0.9693251533742331,0.03067484662576687
1658818628,1,198,21,177,0.10606060606060606,0.8939393939393939
1469408842731687953,0,85,75,10,0.8823529411764706,0.11764705882352941
999039434627665920,1,1000,145,855,0.145,0.855
1456955243057516552,0,1000,999,1,0.999,0.001
3333575746,1,162,18,144,0.1111111111111111,0.8888888888888888
139924330,0,341,322,19,0.9442815249266863,0.05571847507331378
972691729190137856,1,77,0,77,0.0,1.0
584543374,0,711,706,5,0.9929676511954993,0.007032348804500703
219178102,1,399,42,357,0.10526315789473684,0.8947368421052632
65748024,0,285,285,0,1.0,0.0
1289253083495583746,1,392,108,284,0.2755102040816326,0.7244897959183674
341728470,0,325,324,1,0.9969230769230769,0.003076923076923077
392254971,1,1000,85,915,0.085,0.915
47840089,0,1000,990,10,0.99,0.01
20735369,1,1000,269,731,0.269,0.731
33348029,0,1000,992,8,0.992,0.008
22519967,1,459,107,352,0.23311546840958605,0.7668845315904139
925802888462512128,0,54,54,0,1.0,0.0
1072261375093866496,1,319,56,263,0.1755485893416928,0.8244514106583072
313448786,0,512,499,13,0.974609375,0.025390625
1167789254350651392,1,190,20,170,0.10526315789473684,0.8947368421052632
15521025,0,699,674,25,0.9642346208869814,0.0357653791130186
336930739,1,1000,168,832,0.168,0.832
76836782,0,1000,822,178,0.822,0.178
1293522584869507072,1,187,19,168,0.10160427807486631,0.8983957219251337
322488317,0,674,672,2,0.9970326409495549,0.002967359050445104
319417229,1,541,7,534,0.012939001848428836,0.9870609981515711
835573221718130690,0,200,200,0,1.0,0.0
1362253083292536832,1,342,103,239,0.30116959064327486,0.6988304093567251
1432606588221595649,0,949,945,4,0.9957850368809273,0.004214963119072708
16842165,1,1000,196,804,0.196,0.804
68437080,0,720,720,0,1.0,0.0
11161852,1,1000,137,863,0.137,0.863
375748711,0,312,311,1,0.9967948717948718,0.003205128205128205
10185992,1,441,115,326,0.26077097505668934,0.7392290249433107
972649975464198144,0,816,764,52,0.9362745098039216,0.06372549019607843
15323767,1,768,152,616,0.19791666666666666,0.8020833333333334
1239540635452882944,0,645,643,2,0.9968992248062015,0.0031007751937984496
355620160,1,605,167,438,0.27603305785123966,0.7239669421487603
1402519818,0,135,128,7,0.9481481481481482,0.05185185185185185
701391068,1,234,34,200,0.1452991452991453,0.8547008547008547
704889246621044736,0,5,5,0,1.0,0.0
1382657790,1,744,46,698,0.06182795698924731,0.9381720430107527
1395644162154848257,0,66,60,6,0.9090909090909091,0.09090909090909091
873342851320397824,1,370,46,324,0.12432432432432433,0.8756756756756757
1087523104199528451,1,91,8,83,0.08791208791208792,0.9120879120879121
187961134,0,291,280,11,0.9621993127147767,0.037800687285223365
1072424983857573890,1,735,141,594,0.19183673469387755,0.8081632653061225
1491833581374693377,0,21,21,0,1.0,0.0
3225538782,1,165,10,155,0.06060606060606061,0.9393939393939394
704086659709714432,1,1000,144,856,0.144,0.856
880480054895136768,0,624,602,22,0.9647435897435898,0.035256410256410256
1487779035363094528,1,102,18,84,0.17647058823529413,0.8235294117647058
2979703661,0,669,667,2,0.9970104633781763,0.0029895366218236174
1225102114684227589,1,1000,214,786,0.214,0.786
713121813912494081,0,1000,939,61,0.939,0.061
17918649,1,164,24,140,0.14634146341463414,0.8536585365853658
1225289844450000897,0,109,109,0,1.0,0.0
562459019,1,230,10,220,0.043478260869565216,0.9565217391304348
3351394151,0,476,455,21,0.9558823529411765,0.04411764705882353
570315173,1,1000,117,883,0.117,0.883
1598911699,0,496,496,0,1.0,0.0
892964462617137156,1,350,22,328,0.06285714285714286,0.9371428571428572
908588864,0,296,290,6,0.9797297297297297,0.02027027027027027
736726015439949824,1,315,60,255,0.19047619047619047,0.8095238095238095
1426993833657602049,0,650,642,8,0.9876923076923076,0.012307692307692308
553056081,1,999,114,885,0.11411411411411411,0.8858858858858859
27101481,0,31,28,3,0.9032258064516129,0.0967741935483871
1253052604336222210,1,208,76,132,0.36538461538461536,0.6346153846153846
1355699754085310465,0,642,639,3,0.9953271028037384,0.004672897196261682
1245075448134086661,1,143,16,127,0.11188811188811189,0.8881118881118881
959159097726787584,0,444,443,1,0.9977477477477478,0.0022522522522522522
40557308,1,52,4,48,0.07692307692307693,0.9230769230769231
37855624,0,393,353,40,0.8982188295165394,0.10178117048346055
1529886338199302150,1,48,7,41,0.14583333333333334,0.8541666666666666
71065561,0,690,674,16,0.9768115942028985,0.02318840579710145
18496297,1,916,104,812,0.11353711790393013,0.8864628820960698
190062882,0,286,285,1,0.9965034965034965,0.0034965034965034965
34025330,1,1000,294,706,0.294,0.706
52467505,0,919,914,5,0.9945593035908596,0.00544069640914037
880670547306303488,1,357,8,349,0.022408963585434174,0.9775910364145658
9687202,0,127,124,3,0.9763779527559056,0.023622047244094488
1069305891260899335,1,348,66,282,0.1896551724137931,0.8103448275862069
63284862,0,1000,968,32,0.968,0.032
4919842461,1,1000,127,873,0.127,0.873
25335619,0,161,159,2,0.9875776397515528,0.012422360248447204
1081183639956668417,1,437,27,410,0.06178489702517163,0.9382151029748284
1150076212238270467,0,151,131,20,0.8675496688741722,0.13245033112582782
3000454338,1,216,28,188,0.12962962962962962,0.8703703703703703
1519366828144807937,0,173,170,3,0.9826589595375722,0.017341040462427744
780511742,1,644,49,595,0.07608695652173914,0.9239130434782609
2444387707,0,617,615,2,0.9967585089141004,0.0032414910858995136
90653062,1,330,22,308,0.06666666666666667,0.9333333333333333
42519438,0,60,60,0,1.0,0.0
1042208653527396352,1,1000,203,797,0.203,0.797
1427112120286580738,0,340,340,0,1.0,0.0
2350912046,1,381,94,287,0.24671916010498687,0.7532808398950132
328247355,0,415,413,2,0.9951807228915662,0.004819277108433735
829037127098888198,1,918,188,730,0.2047930283224401,0.7952069716775599
821386438105329664,0,289,279,10,0.9653979238754326,0.03460207612456748
1138296017475002369,1,768,137,631,0.17838541666666666,0.8216145833333334
423530536,0,209,204,5,0.9760765550239234,0.023923444976076555
967934877566869504,1,449,14,435,0.031180400890868598,0.9688195991091314
330188310,0,697,693,4,0.994261119081779,0.005738880918220947
988930393758945280,1,104,10,94,0.09615384615384616,0.9038461538461539
1088328286961160192,0,162,160,2,0.9876543209876543,0.012345679012345678
1020478975423008768,1,1000,60,940,0.06,0.94
614583265,0,780,770,10,0.9871794871794872,0.01282051282051282
21535442,1,1000,64,936,0.064,0.936
1232020538614173696,0,1000,962,38,0.962,0.038
2273702845,1,920,106,814,0.11521739130434783,0.8847826086956522
43236142,0,218,216,2,0.9908256880733946,0.009174311926605505
412763525,1,708,63,645,0.08898305084745763,0.9110169491525424
804898187404316672,0,160,157,3,0.98125,0.01875
942541982542581799,1,666,147,519,0.22072072072072071,0.7792792792792793
1455651452286902275,0,593,590,3,0.9949409780775716,0.00505902192242833
1059759480,1,305,19,286,0.06229508196721312,0.9377049180327869
485206190,0,1000,961,39,0.961,0.039
1465942705146667009,1,30,1,29,0.03333333333333333,0.9666666666666667
1265080182534217730,0,29,29,0,1.0,0.0
31539054,1,1000,161,839,0.161,0.839
150131113,0,77,76,1,0.987012987012987,0.012987012987012988
2723960330,1,639,60,579,0.09389671361502347,0.9061032863849765
1356589938473652227,0,146,146,0,1.0,0.0
20623125,1,1000,97,903,0.097,0.903
780460218346070017,0,1000,965,35,0.965,0.035
2521820178,1,204,14,190,0.06862745098039216,0.9313725490196079
1414436080712101889,0,347,315,32,0.9077809798270894,0.09221902017291066
126845208,1,1000,173,827,0.173,0.827
166376193,0,300,300,0,1.0,0.0
1095527261829283840,1,310,43,267,0.13870967741935483,0.8612903225806452
3560848337,0,59,59,0,1.0,0.0
1000971800,1,290,49,241,0.16896551724137931,0.8310344827586207
2407689158,0,120,113,7,0.9416666666666667,0.058333333333333334
956180234583158785,1,1000,73,927,0.073,0.927
2825435126,0,34,33,1,0.9705882352941176,0.029411764705882353
1838422747,1,45,2,43,0.044444444444444446,0.9555555555555556
1391107556,0,75,75,0,1.0,0.0
16004177,1,1000,200,800,0.2,0.8
788083016,0,1000,941,59,0.941,0.059
1326442266156818432,1,67,9,58,0.13432835820895522,0.8656716417910447
16285290,0,205,203,2,0.9902439024390244,0.00975609756097561
1406480859419529219,1,90,11,79,0.12222222222222222,0.8777777777777778
1301023282066464768,0,508,502,6,0.9881889763779528,0.011811023622047244
68233335,1,870,153,717,0.17586206896551723,0.8241379310344827
1247782475897507840,0,61,61,0,1.0,0.0
996154574,1,1000,106,894,0.106,0.894
314371757,0,458,446,12,0.9737991266375546,0.026200873362445413
1473199963,1,1000,154,846,0.154,0.846
1316929854189850626,1,275,3,272,0.01090909090909091,0.9890909090909091
290565270,0,589,550,39,0.933786078098472,0.06621392190152801
402304890,1,1000,183,817,0.183,0.817
1086774033885077505,0,858,806,52,0.9393939393939394,0.06060606060606061
4868225032,1,183,14,169,0.07650273224043716,0.9234972677595629
463296814,0,109,109,0,1.0,0.0
1174364849846898688,1,298,13,285,0.0436241610738255,0.9563758389261745
1394158421683974151,0,64,63,1,0.984375,0.015625
1380662024393392136,1,5,1,4,0.2,0.8
599322590,0,984,974,10,0.9898373983739838,0.01016260162601626
18955381,1,560,107,453,0.19107142857142856,0.8089285714285714
913808711084396545,0,45,45,0,1.0,0.0
2380916207,1,228,24,204,0.10526315789473684,0.8947368421052632
199935371,0,1000,999,1,0.999,0.001
1196565710685835264,1,1000,183,817,0.183,0.817
976663507721736197,0,1000,997,3,0.997,0.003
1186227881736687616,1,84,18,66,0.21428571428571427,0.7857142857142857
882743340248125440,1,108,2,106,0.018518518518518517,0.9814814814814815
1513901281445826566,0,1000,884,116,0.884,0.116
4852197680,1,290,23,267,0.07931034482758621,0.9206896551724137
1340077547732819968,0,73,72,1,0.9863013698630136,0.0136986301369863
1042616300000894979,1,343,41,302,0.119533527696793,0.880466472303207
1387127286646853634,1,546,45,501,0.08241758241758242,0.9175824175824175
1093684029382115328,0,179,179,0,1.0,0.0
1361503353348489221,1,301,20,281,0.0664451827242525,0.9335548172757475
29881721,1,1000,35,965,0.035,0.965
282753317,0,492,492,0,1.0,0.0
931171767158222848,1,115,16,99,0.1391304347826087,0.8608695652173913
1469059545112580096,0,31,31,0,1.0,0.0
1663824296,1,614,11,603,0.017915309446254073,0.9820846905537459
975946311328395265,0,70,63,7,0.9,0.1
1195654238208028672,1,365,35,330,0.0958904109589041,0.9041095890410958
14416404,1,866,79,787,0.09122401847575058,0.9087759815242494
174929804,0,746,739,7,0.9906166219839142,0.00938337801608579
1250550899816067073,1,226,36,190,0.1592920353982301,0.8407079646017699
31076263,0,132,129,3,0.9772727272727273,0.022727272727272728
895577472154050561,1,276,60,216,0.21739130434782608,0.782608695652174
1374015203034161156,0,298,288,10,0.9664429530201343,0.03355704697986577
950091403157213184,1,1000,134,866,0.134,0.866
1615912874,0,261,258,3,0.9885057471264368,0.011494252873563218
1348677998988374024,1,694,256,438,0.3688760806916426,0.6311239193083573
1426290877224337411,0,1000,912,88,0.912,0.088
1095808998677319683,1,116,11,105,0.09482758620689655,0.9051724137931034
1087199121419710465,0,55,54,1,0.9818181818181818,0.01818181818181818
1166187637562126342,1,351,96,255,0.27350427350427353,0.7264957264957265
2732458231,1,1000,62,938,0.062,0.938
982079909269995520,0,209,206,3,0.9856459330143541,0.014354066985645933
111680446,1,1000,180,820,0.18,0.82
715163058,0,62,61,1,0.9838709677419355,0.016129032258064516
14619135,1,1000,336,664,0.336,0.664
1022083495949160448,0,269,267,2,0.9925650557620818,0.007434944237918215
279781141,1,1000,145,855,0.145,0.855
1957631510,0,339,336,3,0.9911504424778761,0.008849557522123894
52462094,1,1000,128,872,0.128,0.872
1265377911772712966,0,40,40,0,1.0,0.0
704157601697820672,1,1000,47,953,0.047,0.953
1334549643754172418,0,22,21,1,0.9545454545454546,0.045454545454545456
16274684,1,1000,34,966,0.034,0.966
3355322243,0,504,496,8,0.9841269841269841,0.015873015873015872
164829531,0,629,629,0,1.0,0.0
1004012672965324800,0,166,166,0,1.0,0.0
770628086,1,938,46,892,0.04904051172707889,0.9509594882729211
1068888403,1,161,13,148,0.08074534161490683,0.9192546583850931
976238490240409600,1,181,10,171,0.055248618784530384,0.9447513812154696
1179036865044856832,0,98,96,2,0.9795918367346939,0.02040816326530612
1255213890574495744,1,587,101,486,0.17206132879045996,0.82793867120954
1432824503931838465,0,58,58,0,1.0,0.0
819557040003678208,1,1000,159,841,0.159,0.841
14422294,0,587,556,31,0.9471890971039182,0.05281090289608177
34993742,1,747,147,600,0.19678714859437751,0.8032128514056225
825876389626773504,0,390,389,1,0.9974358974358974,0.002564102564102564
386843237,1,1000,127,873,0.127,0.873
1379646439,0,1000,891,109,0.891,0.109
742517076766511104,1,1000,101,899,0.101,0.899
2209770656,0,938,918,20,0.9786780383795309,0.021321961620469083
984147877906743296,1,1000,182,818,0.182,0.818
490065927,0,1000,966,34,0.966,0.034
982171920111042565,1,402,73,329,0.18159203980099503,0.818407960199005
828306027728760833,0,1000,985,15,0.985,0.015
19764985,1,1000,115,885,0.115,0.885
176639973,0,771,728,43,0.9442282749675746,0.055771725032425425
780494564830416896,1,206,46,160,0.22330097087378642,0.7766990291262136
2291694943,0,300,275,25,0.9166666666666666,0.08333333333333333
1345161871855398917,1,25,2,23,0.08,0.92
3145641139,0,372,366,6,0.9838709677419355,0.016129032258064516
2402777088,1,919,39,880,0.042437431991294884,0.9575625680087051
2900464977,0,214,209,5,0.9766355140186916,0.02336448598130841
122862293,1,820,83,737,0.10121951219512196,0.8987804878048781
302664461,0,1000,997,3,0.997,0.003
23031942,1,514,79,435,0.15369649805447472,0.8463035019455253
4890143317,0,176,176,0,1.0,0.0
17665907,1,311,78,233,0.2508038585209003,0.7491961414790996
2364656623,0,1000,998,2,0.998,0.002
21528657,1,253,19,234,0.07509881422924901,0.924901185770751
1090666033873149952,0,493,488,5,0.9898580121703854,0.010141987829614604
827241289632579584,1,1000,139,861,0.139,0.861
566501348,0,162,160,2,0.9876543209876543,0.012345679012345678
2281614738,1,319,6,313,0.018808777429467086,0.9811912225705329
1861590403,0,443,416,27,0.9390519187358917,0.060948081264108354
19057893,1,1000,139,861,0.139,0.861
1166690008566239232,0,159,156,3,0.9811320754716981,0.018867924528301886
1345437217,1,420,42,378,0.1,0.9
1452443465577598988,0,68,67,1,0.9852941176470589,0.014705882352941176
3222009323,1,1000,60,940,0.06,0.94
1128578562,0,479,479,0,1.0,0.0
3020997106,1,336,17,319,0.050595238095238096,0.9494047619047619
757094148721741826,0,1000,969,31,0.969,0.031
1075056241603428353,1,295,1,294,0.003389830508474576,0.9966101694915255
1076857955910332416,0,1000,964,36,0.964,0.036
99017098,1,539,25,514,0.04638218923933209,0.9536178107606679
2604931381,0,1000,994,6,0.994,0.006
1234039401900101632,1,287,68,219,0.23693379790940766,0.7630662020905923
380030695,0,384,379,5,0.9869791666666666,0.013020833333333334
702180042,1,405,57,348,0.14074074074074075,0.8592592592592593
1125262988309561345,0,38,38,0,1.0,0.0
36463791,1,1000,48,952,0.048,0.952
3142237901,0,291,287,4,0.9862542955326461,0.013745704467353952
1338367376128000000,1,204,32,172,0.1568627450980392,0.8431372549019608
1892380622,0,218,203,15,0.9311926605504587,0.06880733944954129
18152133,1,358,48,310,0.1340782122905028,0.8659217877094972
3269327598,0,201,192,9,0.9552238805970149,0.04477611940298507
799344947065397248,1,599,142,457,0.2370617696160267,0.7629382303839732
172207948,0,1000,985,15,0.985,0.015
1660469036,1,1000,93,907,0.093,0.907
141433791,0,428,408,20,0.9532710280373832,0.04672897196261682
1194416331950444544,1,45,1,44,0.022222222222222223,0.9777777777777777
1014211343983886337,0,53,53,0,1.0,0.0
1187188393295466498,1,926,104,822,0.11231101511879049,0.8876889848812095
237332507,0,1000,984,16,0.984,0.016
1206265657,1,165,10,155,0.06060606060606061,0.9393939393939394
915658747959181312,0,249,244,5,0.9799196787148594,0.020080321285140562
1150255814537613312,1,26,4,22,0.15384615384615385,0.8461538461538461
848471234,0,870,868,2,0.9977011494252873,0.0022988505747126436
2828773543,1,999,116,883,0.11611611611611612,0.8838838838838838
1197340247669051403,0,100,99,1,0.99,0.01
2861736940,1,1000,177,823,0.177,0.823
315676103,0,1000,974,26,0.974,0.026
3198210522,1,616,24,592,0.03896103896103896,0.961038961038961
1052712787451867136,0,34,34,0,1.0,0.0
898005620174934017,1,319,61,258,0.19122257053291536,0.8087774294670846
178003759,1,878,81,797,0.09225512528473805,0.907744874715262
412010486,0,1000,986,14,0.986,0.014
1482068823360491520,1,108,37,71,0.3425925925925926,0.6574074074074074
2432196471,0,1000,982,18,0.982,0.018
215078809,1,1000,351,649,0.351,0.649
3400991507,0,71,68,3,0.9577464788732394,0.04225352112676056
752212802761359360,1,181,9,172,0.049723756906077346,0.9502762430939227
422793592,0,202,196,6,0.9702970297029703,0.0297029702970297
1069766134231003136,1,78,26,52,0.3333333333333333,0.6666666666666666
1375018532270968833,0,1000,997,3,0.997,0.003
4036851258,1,980,148,832,0.1510204081632653,0.8489795918367347
2389591831,0,1000,975,25,0.975,0.025
772485124768329728,1,1000,241,759,0.241,0.759
981242613792759808,0,440,439,1,0.9977272727272727,0.0022727272727272726
130698697,1,673,113,560,0.16790490341753342,0.8320950965824666
298862066,0,42,41,1,0.9761904761904762,0.023809523809523808
17786218,1,313,16,297,0.051118210862619806,0.9488817891373802
1432197974851932163,0,28,28,0,1.0,0.0
506855940,1,404,33,371,0.08168316831683169,0.9183168316831684
1274057385162596352,0,135,133,2,0.9851851851851852,0.014814814814814815
346168475,1,1000,36,964,0.036,0.964
234923962,0,630,613,17,0.973015873015873,0.026984126984126985
3279089144,1,773,152,621,0.19663648124191463,0.8033635187580854
3198310227,0,345,345,0,1.0,0.0
157723884,1,932,164,768,0.1759656652360515,0.8240343347639485
297588085,0,70,68,2,0.9714285714285714,0.02857142857142857
2822535211,1,499,136,363,0.2725450901803607,0.7274549098196392
1106769743581728768,0,122,119,3,0.9754098360655737,0.02459016393442623
1508505608533778445,1,1000,40,960,0.04,0.96
28110995,0,132,131,1,0.9924242424242424,0.007575757575757576
1114999064473612288,1,646,102,544,0.15789473684210525,0.8421052631578947
1116169810784731142,0,455,439,16,0.9648351648351648,0.035164835164835165
1327686552068165638,1,284,80,204,0.28169014084507044,0.7183098591549296
1419957519506571267,0,1000,984,16,0.984,0.016
796899494243823618,1,1000,83,917,0.083,0.917
16359552,0,969,965,4,0.9958720330237358,0.0041279669762641896
25639611,1,695,37,658,0.053237410071942444,0.9467625899280575
205876156,0,91,91,0,1.0,0.0
706315219883036672,1,195,6,189,0.03076923076923077,0.9692307692307692
1159795357930442752,0,554,548,6,0.9891696750902527,0.010830324909747292
1056700634760658945,1,377,37,340,0.09814323607427056,0.9018567639257294
1480706162131542016,0,36,36,0,1.0,0.0
3314278709,1,260,77,183,0.29615384615384616,0.7038461538461539
27034944,0,765,720,45,0.9411764705882353,0.058823529411764705
814133751450112000,1,144,10,134,0.06944444444444445,0.9305555555555556
1355600323,0,1000,995,5,0.995,0.005
179870243,1,278,53,225,0.1906474820143885,0.8093525179856115
858020493235855360,0,50,50,0,1.0,0.0
95438800,1,135,1,134,0.007407407407407408,0.9925925925925926
1441200198,0,472,461,11,0.9766949152542372,0.023305084745762712
1138293822948032513,1,737,63,674,0.08548168249660787,0.9145183175033921
523925837,0,420,415,5,0.9880952380952381,0.011904761904761904
1004376458104590336,1,878,89,789,0.10136674259681093,0.8986332574031891
136364721,0,1000,988,12,0.988,0.012
764646176,1,605,86,519,0.14214876033057852,0.8578512396694215
215807657,0,390,381,9,0.9769230769230769,0.023076923076923078
1492053500133478401,1,200,55,145,0.275,0.725
94617067,0,141,139,2,0.9858156028368794,0.014184397163120567
217458029,1,642,143,499,0.22274143302180685,0.7772585669781932
242942828,0,209,206,3,0.9856459330143541,0.014354066985645933
1146221743,1,1000,229,771,0.229,0.771
113177886,0,1000,996,4,0.996,0.004
37503584,1,855,90,765,0.10526315789473684,0.8947368421052632
1391454266183897090,0,96,96,0,1.0,0.0
1215470130907549697,1,319,34,285,0.10658307210031348,0.8934169278996865
370993959,0,915,915,0,1.0,0.0
328753969,1,355,26,329,0.07323943661971831,0.9267605633802817
713047702251044864,0,241,225,16,0.9336099585062241,0.06639004149377593
1388988129579872259,1,409,79,330,0.19315403422982885,0.8068459657701712
1484132394185732102,0,215,211,4,0.9813953488372092,0.018604651162790697
982065412643975168,1,985,232,753,0.23553299492385787,0.7644670050761422
25118708,0,99,96,3,0.9696969696969697,0.030303030303030304
1126959459312521216,1,660,180,480,0.2727272727272727,0.7272727272727273
516425670,0,1000,998,2,0.998,0.002
1259604932375703552,1,403,52,351,0.12903225806451613,0.8709677419354839
1406348310349238275,0,121,121,0,1.0,0.0
1397184967881408526,1,1000,82,918,0.082,0.918
1461528068477140993,0,43,43,0,1.0,0.0
1470867821659934732,1,232,96,136,0.41379310344827586,0.5862068965517241
2178590226,0,293,293,0,1.0,0.0
807750665954947072,1,999,60,939,0.06006006006006006,0.93993993993994
734630551399899137,0,20,16,4,0.8,0.2
1205951360262295552,1,326,63,263,0.19325153374233128,0.8067484662576687
3246492061,0,1000,864,136,0.864,0.136
1033391946,1,1000,65,935,0.065,0.935
2367204264,0,607,606,1,0.9983525535420099,0.0016474464579901153
2841486784,1,623,71,552,0.11396468699839486,0.8860353130016051
1278136367109857280,0,1000,998,2,0.998,0.002
1269147486561714177,1,121,8,113,0.06611570247933884,0.9338842975206612
115064079,0,100,100,0,1.0,0.0
1190658860,0,492,492,0,1.0,0.0
3413564675,1,1000,85,915,0.085,0.915
33052775,0,1000,983,17,0.983,0.017
347512898,1,1000,163,837,0.163,0.837
529325201,0,1000,999,1,0.999,0.001
1484054643470737414,1,246,0,246,0.0,1.0
3303081572,0,1000,996,4,0.996,0.004
2716133578,1,501,78,423,0.15568862275449102,0.844311377245509
2472601854,0,1000,962,38,0.962,0.038
1893571578,1,33,19,14,0.5757575757575758,0.42424242424242425
1180716197530279936,0,838,832,6,0.9928400954653938,0.007159904534606206
587978363,1,538,51,487,0.09479553903345725,0.9052044609665427
3121261588,1,744,60,684,0.08064516129032258,0.9193548387096774
1466111029,0,28,28,0,1.0,0.0
1259644527951974401,1,88,20,68,0.22727272727272727,0.7727272727272727
932311192005152769,0,1000,977,23,0.977,0.023
975395619497041920,1,153,66,87,0.43137254901960786,0.5686274509803921
1440717572815523845,0,51,51,0,1.0,0.0
203668826,1,1000,21,979,0.021,0.979
842022299515654145,0,78,77,1,0.9871794871794872,0.01282051282051282
1427572742,1,1000,81,919,0.081,0.919
220761151,0,1000,908,92,0.908,0.092
1297740168825274368,1,153,33,120,0.21568627450980393,0.7843137254901961
974759187807846400,0,414,413,1,0.9975845410628019,0.0024154589371980675
897674127510708226,0,201,187,14,0.9303482587064676,0.06965174129353234
1180173357762916352,1,532,98,434,0.18421052631578946,0.8157894736842105
1505977060925317121,0,135,133,2,0.9851851851851852,0.014814814814814815
2824406367,1,336,33,303,0.09821428571428571,0.9017857142857143
179561598,0,295,288,7,0.976271186440678,0.023728813559322035
1287433593661390850,1,98,29,69,0.29591836734693877,0.7040816326530612
760261762771922944,0,13,10,3,0.7692307692307693,0.23076923076923078
21876574,1,1000,70,930,0.07,0.93
1377014574382206983,0,65,65,0,1.0,0.0
1435085169375985666,1,348,5,343,0.014367816091954023,0.985632183908046
2886380524,0,1000,999,1,0.999,0.001
1471389492384653317,1,434,6,428,0.013824884792626729,0.9861751152073732
1649632987,0,1000,914,86,0.914,0.086
49983283,1,1000,154,846,0.154,0.846
1077245566541852673,0,114,107,7,0.9385964912280702,0.06140350877192982
3224636743,1,110,47,63,0.42727272727272725,0.5727272727272728
1437901617618165771,0,226,225,1,0.995575221238938,0.004424778761061947
2848571,1,1000,145,855,0.145,0.855
2857299243,0,108,108,0,1.0,0.0
174837339,1,639,53,586,0.08294209702660407,0.917057902973396
1134115121893187584,0,70,70,0,1.0,0.0
462030428,1,790,55,735,0.06962025316455696,0.930379746835443
968600788489654272,0,801,784,17,0.978776529338327,0.02122347066167291
487779307,1,688,203,485,0.29505813953488375,0.7049418604651163
719280713,0,519,517,2,0.9961464354527938,0.0038535645472061657
2157653305,1,565,63,502,0.11150442477876106,0.8884955752212389
1271289856598003714,0,83,80,3,0.963855421686747,0.03614457831325301
1162312433098207233,1,118,31,87,0.2627118644067797,0.7372881355932204
142908538,0,338,335,3,0.9911242603550295,0.008875739644970414
1191171095812091904,1,1000,311,689,0.311,0.689
1355934770450993153,0,721,720,1,0.9986130374479889,0.0013869625520110957
3018373536,1,1000,89,911,0.089,0.911
1377603029940240388,0,1000,1000,0,1.0,0.0
1557130188,1,578,200,378,0.3460207612456747,0.6539792387543253
36758447,0,999,995,4,0.995995995995996,0.004004004004004004
930582195474968576,1,465,68,397,0.14623655913978495,0.853763440860215
1309740982586417158,0,447,412,35,0.9217002237136466,0.07829977628635347
259253975,1,336,18,318,0.05357142857142857,0.9464285714285714
823733563631792128,0,93,92,1,0.989247311827957,0.010752688172043012
354899977,1,1000,96,904,0.096,0.904
260075362,0,216,213,3,0.9861111111111112,0.013888888888888888
949082922908311552,1,1000,75,925,0.075,0.925
440417291,0,155,152,3,0.9806451612903225,0.01935483870967742
1328689687,1,183,17,166,0.09289617486338798,0.907103825136612
1482878987760279555,0,174,173,1,0.9942528735632183,0.005747126436781609
282332101,1,361,26,335,0.07202216066481995,0.9279778393351801
432563620,0,1000,1000,0,1.0,0.0
1509277039307763723,1,76,4,72,0.05263157894736842,0.9473684210526315
1459263177368158212,0,1000,957,43,0.957,0.043
1449219987021905921,1,149,28,121,0.18791946308724833,0.8120805369127517
1519730081249169413,0,791,771,20,0.9747155499367889,0.025284450063211124
1198473046199156737,1,529,53,476,0.1001890359168242,0.8998109640831758
3366853361,0,1000,981,19,0.981,0.019
1237149925223342080,1,86,11,75,0.12790697674418605,0.872093023255814
15921173,0,1000,968,32,0.968,0.032
1066082226,1,1000,107,893,0.107,0.893
27277202,0,1000,965,35,0.965,0.035
1285295129834803200,1,395,83,312,0.21012658227848102,0.789873417721519
833421823572258816,0,1000,967,33,0.967,0.033
4317366314,1,584,225,359,0.3852739726027397,0.6147260273972602
106249403,0,1000,992,8,0.992,0.008
1459380795248762880,1,506,28,478,0.05533596837944664,0.9446640316205533
3047544482,0,146,134,12,0.9178082191780822,0.0821917808219178
34521084,1,587,1,586,0.0017035775127768314,0.9982964224872232
186640097,0,1000,1000,0,1.0,0.0
817516473585311744,1,828,78,750,0.09420289855072464,0.9057971014492754
805528680655187970,0,70,70,0,1.0,0.0
3293201980,1,147,15,132,0.10204081632653061,0.8979591836734694
1393375963,0,557,497,60,0.8922800718132855,0.10771992818671454
244403453,1,1000,114,886,0.114,0.886
1050091900433309698,0,832,827,5,0.9939903846153846,0.006009615384615385
2169196056,1,999,65,934,0.06506506506506507,0.934934934934935
317778166,0,854,786,68,0.9203747072599532,0.07962529274004684
1196417756,1,742,221,521,0.29784366576819404,0.7021563342318059
1382184301,0,180,180,0,1.0,0.0
1069729076951175168,1,867,190,677,0.21914648212226068,0.7808535178777394
959992776887808000,0,825,812,13,0.9842424242424243,0.01575757575757576
2903265702,1,391,139,252,0.3554987212276215,0.6445012787723785
85393617,0,987,982,5,0.9949341438703141,0.005065856129685917
327589518,1,1000,55,945,0.055,0.945
3120097836,0,227,227,0,1.0,0.0
2800219310,1,867,234,633,0.2698961937716263,0.7301038062283737
435763220,0,770,770,0,1.0,0.0
397755964,1,148,23,125,0.1554054054054054,0.8445945945945946
15612214,0,229,222,7,0.9694323144104804,0.03056768558951965
14773788,1,1000,219,781,0.219,0.781
1483972602402164741,0,4,4,0,1.0,0.0
771636535665897472,0,180,180,0,1.0,0.0
1013296771525513217,1,526,19,507,0.03612167300380228,0.9638783269961977
45682282,0,1000,997,3,0.997,0.003
16982489,1,311,15,296,0.04823151125401929,0.9517684887459807
787305367566848000,0,185,184,1,0.9945945945945946,0.005405405405405406
1202342094246776832,1,1000,88,912,0.088,0.912
1434312077519249417,0,30,30,0,1.0,0.0
1199544429201240064,1,120,14,106,0.11666666666666667,0.8833333333333333
3291382674,0,1000,998,2,0.998,0.002
512776587,1,609,39,570,0.06403940886699508,0.9359605911330049
2710521590,0,693,679,14,0.9797979797979798,0.020202020202020204
817633040948072449,1,582,47,535,0.08075601374570447,0.9192439862542955
700729751401443328,0,1000,873,127,0.873,0.127
1223053394455277569,0,248,248,0,1.0,0.0
1197935263344975874,1,641,26,615,0.0405616224648986,0.9594383775351014
796174235571920896,0,71,69,2,0.971830985915493,0.028169014084507043
932791328118902784,1,101,12,89,0.1188118811881188,0.8811881188118812
755077322,0,215,213,2,0.9906976744186047,0.009302325581395349
275205099,1,909,103,806,0.11331133113311331,0.8866886688668867
759691885,0,543,543,0,1.0,0.0
33283336,1,422,101,321,0.23933649289099526,0.7606635071090048
1461091256306708482,1,12,3,9,0.25,0.75
486100280,0,458,457,1,0.9978165938864629,0.002183406113537118
857391259283066881,1,1000,117,883,0.117,0.883
2443615013,0,61,60,1,0.9836065573770492,0.01639344262295082
820422179250642945,1,659,55,604,0.0834597875569044,0.9165402124430956
1007881104349540352,0,158,157,1,0.9936708860759493,0.006329113924050633
1495933829059686402,1,50,4,46,0.08,0.92
3399346222,0,355,350,5,0.9859154929577465,0.014084507042253521
757218927026049025,1,203,9,194,0.04433497536945813,0.9556650246305419
1262521698605322241,0,240,229,11,0.9541666666666667,0.04583333333333333
2366625402,1,318,84,234,0.2641509433962264,0.7358490566037735
1330257411559612418,0,837,837,0,1.0,0.0
1202649602492645379,1,377,47,330,0.1246684350132626,0.8753315649867374
1171095485173653505,0,1000,903,97,0.903,0.097
1372972211569631242,1,293,78,215,0.26621160409556316,0.7337883959044369
401037111,0,1000,997,3,0.997,0.003
1323691871147859970,1,455,22,433,0.04835164835164835,0.9516483516483516
585528669,0,616,582,34,0.9448051948051948,0.05519480519480519
736631424090918912,1,1000,226,774,0.226,0.774
256118433,0,657,648,9,0.9863013698630136,0.0136986301369863
1004774185762205696,1,212,13,199,0.06132075471698113,0.9386792452830188
2716163422,0,810,731,79,0.9024691358024691,0.09753086419753086
2428526126,1,606,189,417,0.3118811881188119,0.6881188118811881
580444695,0,676,675,1,0.9985207100591716,0.0014792899408284023
15349002,1,1000,146,854,0.146,0.854
51294553,0,108,106,2,0.9814814814814815,0.018518518518518517
1668621860,1,474,2,472,0.004219409282700422,0.9957805907172996
954938404772503552,0,205,196,9,0.9560975609756097,0.04390243902439024
4734140833,1,197,17,180,0.08629441624365482,0.9137055837563451
1484722237123006467,0,85,78,7,0.9176470588235294,0.08235294117647059
1538013474529214464,1,42,11,31,0.2619047619047619,0.7380952380952381
70492881,0,203,202,1,0.9950738916256158,0.0049261083743842365
1176305780171128832,1,1000,227,773,0.227,0.773
195576006,0,1000,950,50,0.95,0.05
1918239216,1,329,39,290,0.11854103343465046,0.8814589665653495
21772155,0,1000,932,68,0.932,0.068
1482943596,1,1000,82,918,0.082,0.918
1115628960392474627,0,901,867,34,0.9622641509433962,0.03773584905660377
2889952679,0,154,154,0,1.0,0.0
1504574475790073859,1,28,3,25,0.10714285714285714,0.8928571428571429
1465448389248790535,0,1000,997,3,0.997,0.003
31303856,1,1000,88,912,0.088,0.912
1519434599990009858,0,56,56,0,1.0,0.0
1397626964,0,1000,990,10,0.99,0.01
1239184787631374336,1,1000,62,938,0.062,0.938
989888989447491584,0,204,198,6,0.9705882352941176,0.029411764705882353
1457718661133766664,1,2,0,2,0.0,1.0
1276723438669967360,0,107,102,5,0.9532710280373832,0.04672897196261682
1188227232788930560,1,217,37,180,0.17050691244239632,0.8294930875576036
2391750408,0,745,743,2,0.9973154362416108,0.0026845637583892616
926473255,1,1000,115,885,0.115,0.885
257090223,0,373,372,1,0.9973190348525469,0.002680965147453083
800566861574205440,1,822,58,764,0.0705596107055961,0.9294403892944039
523842098,0,377,377,0,1.0,0.0
1374428234629091328,1,246,10,236,0.04065040650406504,0.959349593495935
82972180,0,983,950,33,0.9664292980671414,0.0335707019328586
892814091441520640,1,1000,124,876,0.124,0.876
3167059294,0,1000,952,48,0.952,0.048
1513955839467573249,1,247,51,196,0.20647773279352227,0.7935222672064778
903051971183169536,0,61,60,1,0.9836065573770492,0.01639344262295082
2208462271,1,277,51,226,0.18411552346570398,0.8158844765342961
1090573088406814720,0,1000,1000,0,1.0,0.0
27707284,1,1000,96,904,0.096,0.904
1136097378711330818,0,46,45,1,0.9782608695652174,0.021739130434782608
1518279768789168130,1,82,22,60,0.2682926829268293,0.7317073170731707
4155786149,0,1000,961,39,0.961,0.039
143983992,1,1000,115,885,0.115,0.885
1042148377205645312,0,1000,913,87,0.913,0.087
1412523231236526082,1,27,7,20,0.25925925925925924,0.7407407407407407
148952756,0,624,622,2,0.9967948717948718,0.003205128205128205
1531537012917927937,1,14,5,9,0.35714285714285715,0.6428571428571429
118855578,0,406,396,10,0.9753694581280788,0.024630541871921183
1164677726927806468,1,278,71,207,0.25539568345323743,0.7446043165467626
76141715,0,1000,999,1,0.999,0.001
31076980,1,445,11,434,0.024719101123595506,0.9752808988764045
881997335504408576,1,1000,252,748,0.252,0.748
714959219,0,810,741,69,0.9148148148148149,0.08518518518518518
752951478600409089,1,851,245,606,0.2878965922444183,0.7121034077555817
3051867052,0,956,939,17,0.9822175732217573,0.01778242677824268
1052046611147251712,1,216,32,184,0.14814814814814814,0.8518518518518519
386927051,0,657,546,111,0.8310502283105022,0.1689497716894977
1123060987022721024,1,1000,164,836,0.164,0.836
850152059970215941,0,769,769,0,1.0,0.0
739257750962638848,1,928,295,633,0.31788793103448276,0.6821120689655172
1256690711807717376,0,999,991,8,0.991991991991992,0.008008008008008008
3456486026,1,156,22,134,0.14102564102564102,0.8589743589743589
983586984793812992,1,268,21,247,0.07835820895522388,0.9216417910447762
1084895924,0,17,17,0,1.0,0.0
923385722278641665,1,1000,144,856,0.144,0.856
35564269,0,666,664,2,0.996996996996997,0.003003003003003003
426150577,1,497,6,491,0.012072434607645875,0.9879275653923542
874366290,0,1000,980,20,0.98,0.02
467773911,0,262,255,7,0.9732824427480916,0.026717557251908396
10562282,1,1000,155,845,0.155,0.845
1478415193088667650,0,570,534,36,0.9368421052631579,0.06315789473684211
886434189079449601,1,1000,91,909,0.091,0.909
1568901074,1,189,18,171,0.09523809523809523,0.9047619047619048
3279319062,0,166,158,8,0.9518072289156626,0.04819277108433735
3336203338,1,1000,219,781,0.219,0.781
3119254757,0,1000,999,1,0.999,0.001
18469276,1,1000,91,909,0.091,0.909
1010682984045907968,0,915,909,6,0.9934426229508196,0.006557377049180328
235436858,1,243,72,171,0.2962962962962963,0.7037037037037037
183487429,0,366,363,3,0.9918032786885246,0.00819672131147541
1046979071492722688,1,262,24,238,0.0916030534351145,0.9083969465648855
2978921,0,1000,957,43,0.957,0.043
1176180781758197760,1,428,39,389,0.0911214953271028,0.9088785046728972
153976739,1,185,27,158,0.14594594594594595,0.8540540540540541
46574038,0,565,542,23,0.95929203539823,0.04070796460176991
16068552,1,708,246,462,0.3474576271186441,0.652542372881356
1257095437934346242,0,81,79,2,0.9753086419753086,0.024691358024691357
967103167807795200,1,275,38,237,0.13818181818181818,0.8618181818181818
26752156,0,1000,957,43,0.957,0.043
2796186797,1,1000,51,949,0.051,0.949
1084158065878974464,0,1000,917,83,0.917,0.083
924474775791177728,1,80,16,64,0.2,0.8
1227576127402729473,0,194,189,5,0.9742268041237113,0.02577319587628866
1901724373,1,498,47,451,0.09437751004016064,0.9056224899598394
1888688684,0,741,733,8,0.9892037786774629,0.010796221322537112
482647636,1,112,18,94,0.16071428571428573,0.8392857142857143
899780652354093057,0,361,356,5,0.9861495844875346,0.013850415512465374
2234882588,1,468,29,439,0.06196581196581197,0.938034188034188
987404764093779968,0,228,219,9,0.9605263157894737,0.039473684210526314
739906676,1,173,30,143,0.17341040462427745,0.8265895953757225
1166173494863904769,0,763,763,0,1.0,0.0
112735605,1,883,89,794,0.10079275198187995,0.89920724801812
1268255290480381953,0,193,193,0,1.0,0.0
1198782069494734848,1,833,100,733,0.12004801920768307,0.879951980792317
1362451615584837633,0,1,1,0,1.0,0.0
4034128035,1,167,24,143,0.1437125748502994,0.8562874251497006
1418970663877029897,0,249,211,38,0.8473895582329317,0.15261044176706828
956304771148853253,1,129,4,125,0.031007751937984496,0.9689922480620154
278151814,0,893,892,1,0.9988801791713325,0.0011198208286674132
921064848468926466,1,497,42,455,0.08450704225352113,0.9154929577464789
606768197,0,599,593,6,0.989983305509182,0.01001669449081803
218030850,1,999,52,947,0.05205205205205205,0.9479479479479479
953409850805051392,0,177,174,3,0.9830508474576272,0.01694915254237288
21964296,0,880,846,34,0.9613636363636363,0.038636363636363635
958520210255998976,1,296,41,255,0.13851351351351351,0.8614864864864865
1513550400380678146,0,73,73,0,1.0,0.0
1032821195547336705,1,1000,106,894,0.106,0.894
1240271339237388288,0,368,354,14,0.9619565217391305,0.03804347826086957
417563475,1,823,105,718,0.1275820170109356,0.8724179829890644
217958382,0,1000,988,12,0.988,0.012
18743108,1,762,24,738,0.031496062992125984,0.968503937007874
17907248,0,452,398,54,0.8805309734513275,0.11946902654867257
1432626050337591299,1,1000,2,998,0.002,0.998
894620821292961794,0,274,268,6,0.9781021897810219,0.021897810218978103
2363629904,1,321,3,318,0.009345794392523364,0.9906542056074766
2482977831,0,375,343,32,0.9146666666666666,0.08533333333333333
30796397,1,398,118,280,0.2964824120603015,0.7035175879396985
2759531856,0,123,114,9,0.926829268292683,0.07317073170731707
831000575126810624,1,601,134,467,0.22296173044925124,0.7770382695507487
1492652953588674560,0,111,111,0,1.0,0.0
1395995087947980802,1,785,99,686,0.12611464968152866,0.8738853503184714
2860434625,0,1000,993,7,0.993,0.007
1102602477965316096,1,536,57,479,0.10634328358208955,0.8936567164179104
751033283371294721,0,192,191,1,0.9947916666666666,0.005208333333333333
1072540577852354560,1,477,89,388,0.18658280922431866,0.8134171907756813
711291605068746753,0,1000,896,104,0.896,0.104
741978839614656512,1,606,170,436,0.28052805280528054,0.7194719471947195
338025510,0,572,526,46,0.9195804195804196,0.08041958041958042
1276491602,1,420,35,385,0.08333333333333333,0.9166666666666666
1311462947319959565,0,398,397,1,0.9974874371859297,0.002512562814070352
3058275783,1,355,14,341,0.03943661971830986,0.9605633802816902
159347548,0,60,59,1,0.9833333333333333,0.016666666666666666
923625781800177664,1,597,207,390,0.34673366834170855,0.6532663316582915
1094078926236864512,1,530,242,288,0.45660377358490567,0.5433962264150943
1495508066451787779,0,128,127,1,0.9921875,0.0078125
732994515389190146,1,467,62,405,0.13276231263383298,0.867237687366167
3938817913,0,212,210,2,0.9905660377358491,0.009433962264150943
397021148,1,1000,268,732,0.268,0.732
322903297,0,819,818,1,0.9987789987789988,0.001221001221001221
783693974070448129,1,317,26,291,0.08201892744479496,0.917981072555205
772297674540273664,0,449,449,0,1.0,0.0
904574179520991234,1,221,40,181,0.18099547511312217,0.8190045248868778
1667601751,0,1000,999,1,0.999,0.001
3243622192,1,1000,213,787,0.213,0.787
1421853356826447875,0,123,123,0,1.0,0.0
16646842,1,368,41,327,0.11141304347826086,0.8885869565217391
25076062,0,1000,995,5,0.995,0.005
1118667426135076864,1,34,5,29,0.14705882352941177,0.8529411764705882
126625909,1,718,198,520,0.2757660167130919,0.724233983286908
20204051,0,1000,967,33,0.967,0.033
2395168532,1,1000,282,718,0.282,0.718
1032822586969706496,0,164,162,2,0.9878048780487805,0.012195121951219513
1163486191737561089,1,1000,205,795,0.205,0.795
988177679118749697,0,198,192,6,0.9696969696969697,0.030303030303030304
1366679925533462529,1,1000,35,965,0.035,0.965
2421019884,0,300,294,6,0.98,0.02
102471004,1,761,123,638,0.1616294349540079,0.8383705650459922
714417558682619904,0,108,108,0,1.0,0.0
3106939163,1,1000,167,833,0.167,0.833
29024938,0,247,246,1,0.9959514170040485,0.004048582995951417
14386519,1,831,86,745,0.10348977135980746,0.8965102286401926
1249704700405878785,0,607,602,5,0.9917627677100495,0.008237232289950576
1335721477568512001,1,467,85,382,0.18201284796573874,0.8179871520342612
1347251845492690944,0,139,139,0,1.0,0.0
1411301858250039297,0,472,470,2,0.9957627118644068,0.00423728813559322
711696341047480320,1,1000,231,769,0.231,0.769
31175433,0,577,574,3,0.9948006932409013,0.005199306759098787
1016151052511477761,1,1000,184,816,0.184,0.816
1480317784848543748,0,87,87,0,1.0,0.0
1304735426234597378,1,130,21,109,0.16153846153846155,0.8384615384615385
3200003177,0,373,373,0,1.0,0.0
981711352518594560,1,258,21,237,0.08139534883720931,0.9186046511627907
1493363880151633924,0,16,15,1,0.9375,0.0625
77653123,1,974,207,767,0.21252566735112938,0.7874743326488707
38877346,0,1000,982,18,0.982,0.018
2234114533,1,1000,188,812,0.188,0.812
1353222354453884929,0,924,891,33,0.9642857142857143,0.03571428571428571
1471391384,1,1000,81,919,0.081,0.919
1486837018298572800,0,11,11,0,1.0,0.0
1085533659489284102,1,332,90,242,0.2710843373493976,0.7289156626506024
306946569,1,1000,86,914,0.086,0.914
274194778,0,297,296,1,0.9966329966329966,0.003367003367003367
952357145479122946,1,221,17,204,0.07692307692307693,0.9230769230769231
363116069,0,286,277,9,0.9685314685314685,0.03146853146853147
1175842232076787718,1,812,157,655,0.1933497536945813,0.8066502463054187
164781084,0,1000,988,12,0.988,0.012
621302716,1,1000,171,829,0.171,0.829
967432801078390784,0,484,478,6,0.987603305785124,0.012396694214876033
1442269604185665537,1,146,25,121,0.17123287671232876,0.8287671232876712
1019156396284227584,0,23,23,0,1.0,0.0
1339601428579540992,1,185,22,163,0.11891891891891893,0.8810810810810811
297971782,0,1000,979,21,0.979,0.021
1120280678262804481,1,135,37,98,0.2740740740740741,0.725925925925926
780108225462964224,0,857,787,70,0.9183197199533255,0.08168028004667445
1037076503828283392,1,257,59,198,0.22957198443579765,0.7704280155642024
1537828921156243456,0,156,152,4,0.9743589743589743,0.02564102564102564
145055167,1,406,43,363,0.10591133004926108,0.8940886699507389
1501314564268433410,0,37,37,0,1.0,0.0
1239878074289680385,1,1000,143,857,0.143,0.857
3411556697,0,1000,997,3,0.997,0.003
37277024,0,364,345,19,0.9478021978021978,0.0521978021978022
194154141,1,718,59,659,0.08217270194986072,0.9178272980501393
1148667772123189248,0,300,297,3,0.99,0.01
14330240,1,959,145,814,0.15119916579770595,0.848800834202294
2161795109,0,452,439,13,0.9712389380530974,0.028761061946902654
3040776444,1,1000,59,941,0.059,0.941
1069926021825220608,0,288,287,1,0.9965277777777778,0.003472222222222222
1198784328903380992,1,385,31,354,0.08051948051948052,0.9194805194805195
925159100257849345,0,1000,986,14,0.986,0.014
3652057644,1,490,46,444,0.09387755102040816,0.9061224489795918
1381641385053450240,0,218,217,1,0.9954128440366973,0.0045871559633027525
39758998,1,1000,66,934,0.066,0.934
36159713,1,1000,120,880,0.12,0.88
73761483,0,278,278,0,1.0,0.0
720613328679264257,1,385,48,337,0.12467532467532468,0.8753246753246753
3070547491,0,1000,975,25,0.975,0.025
985929958554992640,1,990,97,893,0.09797979797979799,0.902020202020202
40075165,1,421,64,357,0.15201900237529692,0.8479809976247031
1428837242,0,999,990,9,0.990990990990991,0.009009009009009009
746246935,1,659,174,485,0.26403641881638845,0.7359635811836115
103459728,0,313,309,4,0.987220447284345,0.012779552715654952
1914758929,1,401,14,387,0.034912718204488775,0.9650872817955112
816161298165669889,0,362,348,14,0.9613259668508287,0.03867403314917127
1314037161407152128,1,75,11,64,0.14666666666666667,0.8533333333333334
1168243274135592960,0,1000,998,2,0.998,0.002
383318566,1,272,22,250,0.08088235294117647,0.9191176470588235
1351529582625652740,0,137,101,36,0.7372262773722628,0.26277372262773724
77405867,1,877,202,675,0.23033067274800456,0.7696693272519954
1023490731283902464,0,78,77,1,0.9871794871794872,0.01282051282051282
236699058,1,340,26,314,0.07647058823529412,0.9235294117647059
898340739289145344,0,336,333,3,0.9910714285714286,0.008928571428571428
1447730878826827776,0,1000,942,58,0.942,0.058
1094464635326132224,1,1000,156,844,0.156,0.844
1214719515025645568,0,1000,883,117,0.883,0.117
1653419612,1,323,12,311,0.03715170278637771,0.9628482972136223
1172251167721762816,0,450,450,0,1.0,0.0
941815266807304192,1,75,4,71,0.05333333333333334,0.9466666666666667
2776756342,0,317,317,0,1.0,0.0
140533921,1,1000,98,902,0.098,0.902
25513051,0,330,314,16,0.9515151515151515,0.048484848484848485
75913,1,1000,190,810,0.19,0.81
245076190,0,238,237,1,0.9957983193277311,0.004201680672268907
3316246782,1,291,35,256,0.12027491408934708,0.8797250859106529
758679284584108032,0,923,891,32,0.9653304442036836,0.03466955579631636
3039094535,1,206,34,172,0.1650485436893204,0.8349514563106796
823952045765894145,0,818,813,5,0.9938875305623472,0.006112469437652812
1050764030300827649,1,123,19,104,0.15447154471544716,0.8455284552845529
910278828567793664,0,65,65,0,1.0,0.0
1218080562,1,972,214,758,0.22016460905349794,0.779835390946502
199394691,0,957,952,5,0.9947753396029259,0.00522466039707419
1411110459793547265,1,1000,24,976,0.024,0.976
883123041605234689,1,361,21,340,0.05817174515235457,0.9418282548476454
780197950852964352,0,437,415,22,0.9496567505720824,0.05034324942791762
749986367032135680,0,236,223,13,0.9449152542372882,0.05508474576271186
1408441814995120128,1,322,37,285,0.11490683229813664,0.8850931677018633
1476364650581307393,0,133,133,0,1.0,0.0
1139282848957882368,1,406,47,359,0.11576354679802955,0.8842364532019704
331894525,0,359,354,5,0.9860724233983287,0.013927576601671309
356480053,1,1000,323,677,0.323,0.677
1401019455363334145,0,72,69,3,0.9583333333333334,0.041666666666666664
19525283,1,1000,70,930,0.07,0.93
18707799,0,1000,945,55,0.945,0.055
1541990941,1,1000,84,916,0.084,0.916
40757637,0,884,882,2,0.997737556561086,0.0022624434389140274
2449816464,1,272,76,196,0.27941176470588236,0.7205882352941176
263335777,0,184,179,5,0.9728260869565217,0.02717391304347826
1252792884,1,405,78,327,0.1925925925925926,0.8074074074074075
43726984,0,604,604,0,1.0,0.0
863582783800606721,1,626,100,526,0.1597444089456869,0.8402555910543131
1536204694330155008,0,75,75,0,1.0,0.0
63549367,1,441,34,407,0.07709750566893424,0.9229024943310657
481598786,0,601,597,4,0.9933444259567388,0.0066555740432612314
20327888,1,389,15,374,0.038560411311053984,0.961439588688946
1344397779574136832,0,56,56,0,1.0,0.0
1071415659689578497,1,331,68,263,0.2054380664652568,0.7945619335347432
1398460672850026497,1,1000,64,936,0.064,0.936
2457066985,0,13,13,0,1.0,0.0
16364933,1,1000,276,724,0.276,0.724
232292129,0,640,640,0,1.0,0.0
1466570430899052546,1,617,12,605,0.019448946515397084,0.9805510534846029
3229903797,0,515,491,24,0.9533980582524272,0.04660194174757282
1157419200832516097,1,1000,198,802,0.198,0.802
3148833914,0,157,157,0,1.0,0.0
40255740,1,1000,109,891,0.109,0.891
868540440793841664,0,552,549,3,0.9945652173913043,0.005434782608695652
1421886513692831744,0,180,173,7,0.9611111111111111,0.03888888888888889
1451516196453556237,1,549,46,503,0.08378870673952642,0.9162112932604736
529912434,0,829,827,2,0.9975874547647768,0.0024125452352231603
2322884314,1,294,14,280,0.047619047619047616,0.9523809523809523
1209638670690590720,0,95,83,12,0.8736842105263158,0.12631578947368421
2620942551,1,348,95,253,0.27298850574712646,0.7270114942528736
940235699793559552,0,1000,990,10,0.99,0.01
811494159559245825,1,255,52,203,0.20392156862745098,0.796078431372549
830455942303121408,0,310,289,21,0.932258064516129,0.06774193548387097
19470633,1,484,170,314,0.3512396694214876,0.6487603305785123
1352947891,0,210,209,1,0.9952380952380953,0.004761904761904762
16108965,1,319,59,260,0.18495297805642633,0.8150470219435737
958763075561230336,0,128,120,8,0.9375,0.0625
1352983120245530626,1,2,0,2,0.0,1.0
1193695385774112780,0,263,263,0,1.0,0.0
1211730971038371845,1,390,155,235,0.3974358974358974,0.6025641025641025
790694530970296324,0,115,115,0,1.0,0.0
882293208708915200,1,267,48,219,0.1797752808988764,0.8202247191011236
41441032,0,999,993,6,0.993993993993994,0.006006006006006006
1188104152234115073,1,46,5,41,0.10869565217391304,0.8913043478260869
1253393029,0,456,455,1,0.9978070175438597,0.0021929824561403508
1401549909065568259,1,280,9,271,0.03214285714285714,0.9678571428571429
818076848,0,907,803,104,0.8853362734288864,0.11466372657111357
5533512,1,552,58,494,0.10507246376811594,0.894927536231884
1623966727,0,1000,982,18,0.982,0.018
58389729,1,176,37,139,0.21022727272727273,0.7897727272727273
877726581577449472,0,1000,975,25,0.975,0.025
1479224930189389824,1,715,66,649,0.09230769230769231,0.9076923076923077
90636975,0,1000,1000,0,1.0,0.0
60212114,1,881,209,672,0.23723041997729852,0.7627695800227015
631434764,0,146,146,0,1.0,0.0
53709452,1,1000,247,753,0.247,0.753
1027341357411708929,0,45,43,2,0.9555555555555556,0.044444444444444446
285266310,1,1000,193,807,0.193,0.807
2440585880,0,1000,989,11,0.989,0.011
1411777922021703681,1,92,23,69,0.25,0.75
26511235,0,1000,940,60,0.94,0.06
1262126904,1,1000,98,902,0.098,0.902
1489941640051634176,0,1000,987,13,0.987,0.013
3688907775,1,1000,249,751,0.249,0.751
1290632655847874561,0,27,27,0,1.0,0.0
23830825,1,136,15,121,0.11029411764705882,0.8897058823529411
96057593,0,164,164,0,1.0,0.0
71641034,1,294,63,231,0.21428571428571427,0.7857142857142857
2811515106,0,1000,974,26,0.974,0.026
1142578194341666817,1,268,44,224,0.16417910447761194,0.835820895522388
703845939090358272,0,41,39,2,0.9512195121951219,0.04878048780487805
192606233,1,1000,165,835,0.165,0.835
1371103764078333960,0,6,5,1,0.8333333333333334,0.16666666666666666
1412330758769872896,1,119,4,115,0.03361344537815126,0.9663865546218487
53129232,0,584,583,1,0.9982876712328768,0.0017123287671232876
637248597,1,108,8,100,0.07407407407407407,0.9259259259259259
1394358676987727872,0,373,361,12,0.967828418230563,0.032171581769437
13540172,1,1000,89,911,0.089,0.911
2247008529,0,662,647,15,0.9773413897280967,0.022658610271903322
1309227610048659456,1,518,46,472,0.0888030888030888,0.9111969111969112
1058624678367875072,0,21,21,0,1.0,0.0
1301371904922652672,1,233,113,120,0.48497854077253216,0.5150214592274678
382061750,0,1000,971,29,0.971,0.029
894952509776834563,1,318,81,237,0.25471698113207547,0.7452830188679245
2602561826,0,609,578,31,0.9490968801313628,0.05090311986863711
2995287561,0,276,273,3,0.9891304347826086,0.010869565217391304
1243234746265522177,1,192,57,135,0.296875,0.703125
442853637,0,1000,993,7,0.993,0.007
911619744,1,208,6,202,0.028846153846153848,0.9711538461538461
287026585,0,861,854,7,0.991869918699187,0.008130081300813009
816832455541932032,1,126,3,123,0.023809523809523808,0.9761904761904762
1523370905346400256,0,419,419,0,1.0,0.0
420557183,1,1000,252,748,0.252,0.748
915083489640202240,0,415,397,18,0.9566265060240964,0.043373493975903614
793088654,1,1000,46,954,0.046,0.954
135518677,0,1000,982,18,0.982,0.018
20288750,0,1000,992,8,0.992,0.008
937482786969092096,1,1000,109,891,0.109,0.891
266840345,0,188,187,1,0.9946808510638298,0.005319148936170213
721465603,1,756,107,649,0.14153439153439154,0.8584656084656085
305352279,0,150,150,0,1.0,0.0
307778266,1,1000,32,968,0.032,0.968
926673397148368896,0,214,214,0,1.0,0.0
769603650180096000,1,695,191,504,0.27482014388489207,0.7251798561151079
1508885928437325824,0,94,93,1,0.9893617021276596,0.010638297872340425
1109689173236015104,1,156,40,116,0.2564102564102564,0.7435897435897436
15945952,0,1000,982,18,0.982,0.018
1104913649896845312,0,263,260,3,0.9885931558935361,0.011406844106463879
1395573377465782273,1,564,38,526,0.0673758865248227,0.9326241134751773
375717978,0,1000,979,21,0.979,0.021
2320270178,1,79,5,74,0.06329113924050633,0.9367088607594937
1464219845705220103,0,6,6,0,1.0,0.0
153905176,1,1000,55,945,0.055,0.945
827946336100155393,0,367,305,62,0.8310626702997275,0.16893732970027248
425231971,1,1000,118,882,0.118,0.882
75120585,0,415,410,5,0.9879518072289156,0.012048192771084338
1072940302254563333,1,289,13,276,0.04498269896193772,0.9550173010380623
713660597842280448,0,427,426,1,0.9976580796252927,0.00234192037470726
830049456,1,699,49,650,0.07010014306151645,0.9298998569384835
1474549867238330375,0,1000,999,1,0.999,0.001
1460626808366198787,1,67,3,64,0.04477611940298507,0.9552238805970149
352458831,0,736,708,28,0.9619565217391305,0.03804347826086957
1438543967944073218,1,24,13,11,0.5416666666666666,0.4583333333333333
1032430854658637829,0,181,177,4,0.9779005524861878,0.022099447513812154
1267826675833659396,1,876,123,753,0.1404109589041096,0.8595890410958904
925638582,0,1000,941,59,0.941,0.059
351005472,1,439,27,412,0.06150341685649203,0.9384965831435079
1432564860156534786,0,1000,998,2,0.998,0.002
1254695080184680448,1,978,279,699,0.2852760736196319,0.7147239263803681
1341756662,0,100,100,0,1.0,0.0
177387588,1,281,14,267,0.0498220640569395,0.9501779359430605
1391562873747480580,0,1000,996,4,0.996,0.004
177068335,1,802,103,699,0.128428927680798,0.871571072319202
760874411368951809,0,822,790,32,0.9610705596107056,0.038929440389294405
1000063758402715648,1,1000,274,726,0.274,0.726
2191190592,0,250,243,7,0.972,0.028
1356055323736383490,1,336,69,267,0.20535714285714285,0.7946428571428571
1239835579451228160,0,738,713,25,0.9661246612466124,0.03387533875338753
1255609843693518862,1,857,59,798,0.06884480746791131,0.9311551925320887
18894237,0,767,740,27,0.9647979139504563,0.035202086049543675
3329756505,1,1000,143,857,0.143,0.857
1026948877436547072,0,99,99,0,1.0,0.0
393005076,1,1000,55,945,0.055,0.945
991337422536499201,0,932,898,34,0.9635193133047211,0.03648068669527897
172063515,1,1000,69,931,0.069,0.931
366639053,0,259,257,2,0.9922779922779923,0.007722007722007722
1419715755621421062,1,346,81,265,0.23410404624277456,0.7658959537572254
1370766684890529796,0,110,100,10,0.9090909090909091,0.09090909090909091
125519576,1,1000,53,947,0.053,0.947
231176047,0,409,405,4,0.9902200488997555,0.009779951100244499
3267994399,1,501,89,412,0.17764471057884232,0.8223552894211577
114531195,0,254,248,6,0.9763779527559056,0.023622047244094488
62547973,1,341,48,293,0.14076246334310852,0.8592375366568915
69310314,0,710,706,4,0.9943661971830986,0.005633802816901409
1260772193878700033,1,630,71,559,0.1126984126984127,0.8873015873015873
1683001,0,172,166,6,0.9651162790697675,0.03488372093023256
840347118153957376,1,451,80,371,0.17738359201773837,0.8226164079822617
889603671683735553,0,947,891,56,0.9408658922914467,0.059134107708553325
991444696680550405,1,647,98,549,0.15146831530139104,0.848531684698609
761284972099440640,0,19,19,0,1.0,0.0
487839076,1,689,187,502,0.2714078374455733,0.7285921625544267
457088256,0,999,996,3,0.996996996996997,0.003003003003003003
1156259250810904576,1,712,23,689,0.032303370786516857,0.9676966292134831
1093702746098884613,0,722,721,1,0.9986149584487535,0.0013850415512465374
272985164,1,297,57,240,0.1919191919191919,0.8080808080808081
2148233600,0,34,33,1,0.9705882352941176,0.029411764705882353
1511993184460574722,1,151,19,132,0.12582781456953643,0.8741721854304636
1276174021705506817,0,149,149,0,1.0,0.0
4242633372,1,186,13,173,0.06989247311827956,0.9301075268817204
1082113449214251009,0,1000,873,127,0.873,0.127
1432139046738878470,1,29,5,24,0.1724137931034483,0.8275862068965517
1283818168125984769,0,831,660,171,0.7942238267148014,0.20577617328519857
1375041867176235009,1,678,46,632,0.06784660766961652,0.9321533923303835
16333278,0,932,849,83,0.9109442060085837,0.0890557939914163
1446591208541679616,1,38,1,37,0.02631578947368421,0.9736842105263158
832238994066964484,0,1000,973,27,0.973,0.027
853736102989090816,1,102,16,86,0.1568627450980392,0.8431372549019608
1058406136410525698,0,26,26,0,1.0,0.0
1109714636138385409,1,1000,193,807,0.193,0.807
761702678330302465,0,200,190,10,0.95,0.05
516161625,1,521,32,489,0.061420345489443376,0.9385796545105566
759738919340474368,0,96,95,1,0.9895833333333334,0.010416666666666666
1091019055207571456,1,1000,236,764,0.236,0.764
1182142014135115776,0,178,174,4,0.9775280898876404,0.02247191011235955
1248751193725247489,1,16,1,15,0.0625,0.9375
471442351,0,751,739,12,0.9840213049267643,0.015978695073235686
3271488859,1,1000,137,863,0.137,0.863
1094465311687041026,0,112,111,1,0.9910714285714286,0.008928571428571428
1507715889961046016,1,43,5,38,0.11627906976744186,0.8837209302325582
1360269734785253382,0,187,186,1,0.9946524064171123,0.0053475935828877
17624209,1,1000,276,724,0.276,0.724
1490338848987095046,0,109,109,0,1.0,0.0
1354628147447099392,1,258,47,211,0.1821705426356589,0.8178294573643411
1391390278913863681,0,49,39,10,0.7959183673469388,0.20408163265306123
1282840287505608704,1,442,94,348,0.21266968325791855,0.7873303167420814
836290483,0,377,354,23,0.9389920424403183,0.0610079575596817
1384373076817682434,1,1000,92,908,0.092,0.908
997096797779701761,0,68,68,0,1.0,0.0
84105147,1,637,128,509,0.20094191522762953,0.7990580847723705
1421164536430833668,0,62,62,0,1.0,0.0
2918888064,1,240,20,220,0.08333333333333333,0.9166666666666666
141799789,0,105,104,1,0.9904761904761905,0.009523809523809525
815088501779632130,1,301,25,276,0.08305647840531562,0.9169435215946844
934045438612619265,1,767,68,699,0.08865710560625815,0.9113428943937418
119275302,0,75,75,0,1.0,0.0
952910960,1,1000,98,902,0.098,0.902
1432374953693822982,0,66,66,0,1.0,0.0
2223845792,1,402,118,284,0.2935323383084577,0.7064676616915423
1570779457,0,338,336,2,0.9940828402366864,0.005917159763313609
467783663,1,83,5,78,0.060240963855421686,0.9397590361445783
1154508637542539264,0,427,371,56,0.8688524590163934,0.13114754098360656
1480721062866219009,1,67,13,54,0.19402985074626866,0.8059701492537313
37142427,0,148,136,12,0.918918918918919,0.08108108108108109
884243370,1,671,97,574,0.14456035767511177,0.8554396423248882
612982904,0,929,923,6,0.9935414424111948,0.006458557588805167
541199708,1,360,112,248,0.3111111111111111,0.6888888888888889
1140285706612477953,0,453,443,10,0.977924944812362,0.02207505518763797
2526250945,1,345,17,328,0.04927536231884058,0.9507246376811594
2264615117,0,380,377,3,0.9921052631578947,0.007894736842105263
34736711,1,617,23,594,0.03727714748784441,0.9627228525121556
21573620,0,708,659,49,0.9307909604519774,0.0692090395480226
1046946129894608896,0,299,299,0,1.0,0.0
336138275,1,838,24,814,0.028639618138424822,0.9713603818615751
738821081360793606,0,1000,995,5,0.995,0.005
3192674699,1,80,8,72,0.1,0.9
436512067,0,57,54,3,0.9473684210526315,0.05263157894736842
1105571979103363072,1,403,85,318,0.2109181141439206,0.7890818858560794
1113131475824795648,0,34,34,0,1.0,0.0
1098461972998152192,1,74,8,66,0.10810810810810811,0.8918918918918919
1089040074145034240,0,392,354,38,0.9030612244897959,0.09693877551020408
1726980391,1,1000,133,867,0.133,0.867
2157658932,0,68,68,0,1.0,0.0
2572271,1,646,114,532,0.17647058823529413,0.8235294117647058
3125323276,0,890,817,73,0.9179775280898876,0.08202247191011236
14407231,1,607,238,369,0.39209225700164746,0.6079077429983526
505286113,0,44,43,1,0.9772727272727273,0.022727272727272728
2913085740,1,1000,295,705,0.295,0.705
82567245,0,550,536,14,0.9745454545454545,0.025454545454545455
17300190,1,1000,82,918,0.082,0.918
37696048,0,783,783,0,1.0,0.0
251782188,1,1000,97,903,0.097,0.903
326792183,0,1000,932,68,0.932,0.068
356624255,1,332,12,320,0.03614457831325301,0.963855421686747
552797852,0,292,291,1,0.9965753424657534,0.003424657534246575
774409411838156800,1,465,80,385,0.17204301075268819,0.8279569892473119
1274635529271668736,0,112,105,7,0.9375,0.0625
994295684,1,252,47,205,0.1865079365079365,0.8134920634920635
1441118177421713417,0,122,113,9,0.9262295081967213,0.07377049180327869
1111704296075210752,1,257,48,209,0.1867704280155642,0.8132295719844358
90981965,0,242,241,1,0.9958677685950413,0.004132231404958678
1237309183914954752,1,565,50,515,0.08849557522123894,0.911504424778761
1277196875053973504,0,244,243,1,0.9959016393442623,0.004098360655737705
1081660373311332352,1,194,46,148,0.23711340206185566,0.7628865979381443
338145540,0,813,813,0,1.0,0.0
1247843260346667009,1,274,15,259,0.05474452554744526,0.9452554744525548
59891395,0,1000,977,23,0.977,0.023
2269892553,1,1000,102,898,0.102,0.898
178793121,0,452,452,0,1.0,0.0
1361751992473911297,1,1000,17,983,0.017,0.983
36529819,1,509,29,480,0.05697445972495088,0.9430255402750491
2920833038,0,1000,958,42,0.958,0.042
868855261,1,1000,103,897,0.103,0.897
1110264624815976448,0,25,22,3,0.88,0.12
1225927382025920512,0,1000,943,57,0.943,0.057
23885919,1,413,44,369,0.10653753026634383,0.8934624697336562
472579053,0,139,137,2,0.9856115107913669,0.014388489208633094
950198630786392065,1,267,45,222,0.16853932584269662,0.8314606741573034
1207076194702831622,0,113,112,1,0.9911504424778761,0.008849557522123894
1203335092313059328,1,1000,255,745,0.255,0.745
19134525,0,348,348,0,1.0,0.0
1038078452,1,642,60,582,0.09345794392523364,0.9065420560747663
113493986,0,699,668,31,0.9556509298998569,0.044349070100143065
778965568246296576,1,88,6,82,0.06818181818181818,0.9318181818181818
1446561506393477120,0,244,236,8,0.9672131147540983,0.03278688524590164
1134155895334682624,1,877,118,759,0.1345496009122007,0.8654503990877993
563846254,0,1000,997,3,0.997,0.003
16141388,1,1000,25,975,0.025,0.975
89366493,0,91,91,0,1.0,0.0
1457197127994683395,1,795,24,771,0.03018867924528302,0.969811320754717
807211969,0,141,141,0,1.0,0.0
3391173125,1,146,5,141,0.03424657534246575,0.9657534246575342
2861955316,0,479,478,1,0.9979123173277662,0.0020876826722338203
366352646,1,504,87,417,0.17261904761904762,0.8273809523809523
896238438323818497,0,799,725,74,0.9073842302878599,0.09261576971214018
28001785,1,1000,130,870,0.13,0.87
53762228,0,1000,959,41,0.959,0.041
722125724753072128,1,60,6,54,0.1,0.9
543841603,0,261,260,1,0.9961685823754789,0.0038314176245210726
3207544647,1,1000,50,950,0.05,0.95
514900588,0,423,422,1,0.9976359338061466,0.002364066193853428
62984708,1,1000,182,818,0.182,0.818
2248196535,0,536,535,1,0.9981343283582089,0.0018656716417910447
1739563170,1,1000,166,834,0.166,0.834
3717794416,0,401,388,13,0.9675810473815462,0.032418952618453865
1327068053658427397,1,287,8,279,0.027874564459930314,0.9721254355400697
2331075614,0,256,242,14,0.9453125,0.0546875
396136497,1,333,29,304,0.08708708708708708,0.9129129129129129
1188287444048908288,0,491,482,9,0.9816700610997964,0.018329938900203666
1362611329983541251,1,684,210,474,0.30701754385964913,0.6929824561403509
1478757160184131592,0,54,54,0,1.0,0.0
29995694,1,1000,112,888,0.112,0.888
2499327650,0,74,73,1,0.9864864864864865,0.013513513513513514
633410852,1,1000,158,842,0.158,0.842
1131593055994146816,0,723,721,2,0.9972337482710927,0.0027662517289073307
32103436,1,381,98,283,0.2572178477690289,0.7427821522309711
319990135,0,378,375,3,0.9920634920634921,0.007936507936507936
1000491433395150848,1,890,283,607,0.31797752808988766,0.6820224719101123
23872214,0,294,292,2,0.9931972789115646,0.006802721088435374
1354590451462889474,1,195,66,129,0.3384615384615385,0.6615384615384615
1178348587668905984,0,239,222,17,0.9288702928870293,0.07112970711297072
1253761796122574848,1,253,33,220,0.13043478260869565,0.8695652173913043
774821809577263104,0,1000,919,81,0.919,0.081
755948514266361856,1,1000,106,894,0.106,0.894
1069877815,0,1000,973,27,0.973,0.027
326473669,1,165,12,153,0.07272727272727272,0.9272727272727272
714644604130365440,1,432,22,410,0.05092592592592592,0.9490740740740741
473539828,0,414,410,4,0.9903381642512077,0.00966183574879227
238850180,1,1000,82,918,0.082,0.918
961353141269811201,0,145,138,7,0.9517241379310345,0.04827586206896552
2732798003,1,1000,74,926,0.074,0.926
22186263,0,374,374,0,1.0,0.0
40765733,1,1000,26,974,0.026,0.974
1447343607887794178,0,32,31,1,0.96875,0.03125
14467967,1,616,113,503,0.18344155844155843,0.8165584415584416
2539887022,0,1000,986,14,0.986,0.014
1411025832353599509,1,148,11,137,0.07432432432432433,0.9256756756756757
377720158,0,448,436,12,0.9732142857142857,0.026785714285714284
941484494879707136,1,327,98,229,0.2996941896024465,0.7003058103975535
1272396010732564480,0,1000,988,12,0.988,0.012
1481670778970017794,1,1000,196,804,0.196,0.804
65182550,0,16,16,0,1.0,0.0
445896499,1,636,44,592,0.06918238993710692,0.9308176100628931
811680997645414400,0,77,77,0,1.0,0.0
14070412,1,744,42,702,0.056451612903225805,0.9435483870967742
1393028442514501633,0,179,179,0,1.0,0.0
1525946139593396231,0,25,25,0,1.0,0.0
2753191016,1,519,60,459,0.11560693641618497,0.884393063583815
1126736005,0,99,98,1,0.98989898989899,0.010101010101010102
553887347,1,796,201,595,0.25251256281407036,0.7474874371859297
148568851,0,1000,977,23,0.977,0.023
1163742325,1,464,17,447,0.036637931034482756,0.9633620689655172
798571380719702016,0,247,247,0,1.0,0.0
4294406533,1,1000,131,869,0.131,0.869
891332305226223617,0,191,191,0,1.0,0.0
715520655882489859,1,173,35,138,0.2023121387283237,0.7976878612716763
1446130655432040450,0,706,696,10,0.9858356940509915,0.014164305949008499
1521382784,1,208,43,165,0.20673076923076922,0.7932692307692307
1546984772,1,1000,165,835,0.165,0.835
1406430286120992768,0,33,33,0,1.0,0.0
1528267884954234881,1,121,27,94,0.2231404958677686,0.7768595041322314
446612631,0,68,66,2,0.9705882352941176,0.029411764705882353
1358048512450187264,0,583,581,2,0.9965694682675815,0.003430531732418525
41496055,1,692,46,646,0.06647398843930635,0.9335260115606936
1339674407371993091,0,36,36,0,1.0,0.0
16644767,1,973,87,886,0.08941418293936279,0.9105858170606372
1599107035,0,119,119,0,1.0,0.0
16918537,1,1000,249,751,0.249,0.751
17848520,0,907,898,9,0.9900771775082691,0.009922822491730982
2364553446,1,1000,116,884,0.116,0.884
1520538939827920897,0,287,282,5,0.9825783972125436,0.017421602787456445
1059824534,1,1000,217,783,0.217,0.783
1105244494864281601,0,1000,978,22,0.978,0.022
2468311781,1,225,21,204,0.09333333333333334,0.9066666666666666
970928870286278658,0,157,151,6,0.9617834394904459,0.03821656050955414
14247370,1,1000,76,924,0.076,0.924
1418241224230715397,0,86,86,0,1.0,0.0
988502074240286720,1,705,51,654,0.07234042553191489,0.9276595744680851
3602978717,0,998,997,1,0.998997995991984,0.001002004008016032
320041942,1,588,37,551,0.06292517006802721,0.9370748299319728
49676730,0,248,246,2,0.9919354838709677,0.008064516129032258
3102195487,1,967,126,841,0.13029989658738367,0.8697001034126164
834218312640847873,0,1000,962,38,0.962,0.038
928361018727718912,1,343,31,312,0.09037900874635568,0.9096209912536443
1114611829282467840,0,441,425,16,0.963718820861678,0.036281179138321996
22076619,1,1000,108,892,0.108,0.892
1172669252,0,127,126,1,0.9921259842519685,0.007874015748031496
422829635,1,458,52,406,0.11353711790393013,0.8864628820960698
1392232775047008256,1,999,239,760,0.23923923923923923,0.7607607607607607
17784669,0,1000,960,40,0.96,0.04
147646942,1,1000,151,849,0.151,0.849
73812738,0,258,239,19,0.9263565891472868,0.07364341085271318
1466784973659291652,0,1000,984,16,0.984,0.016
1013883124298797056,1,351,127,224,0.36182336182336183,0.6381766381766382
67675340,0,229,220,9,0.9606986899563319,0.039301310043668124
1059537268283596800,1,218,33,185,0.15137614678899083,0.8486238532110092
1009965569670565888,0,224,210,14,0.9375,0.0625
887732933632512000,1,1000,232,768,0.232,0.768
16433250,0,1000,952,48,0.952,0.048
867409721900154880,1,572,91,481,0.1590909090909091,0.8409090909090909
851154354111303680,0,919,910,9,0.9902067464635473,0.009793253536452665
1344837934948630528,1,116,36,80,0.3103448275862069,0.6896551724137931
32280980,0,173,162,11,0.9364161849710982,0.06358381502890173
1929779360,1,968,77,891,0.07954545454545454,0.9204545454545454
165922867,0,662,661,1,0.9984894259818731,0.0015105740181268882
758015228210622465,1,669,72,597,0.10762331838565023,0.8923766816143498
2677218314,0,578,551,27,0.9532871972318339,0.04671280276816609
2818090903,1,297,33,264,0.1111111111111111,0.8888888888888888
2750709225,0,1000,1000,0,1.0,0.0
1408501857614508032,1,999,97,902,0.0970970970970971,0.9029029029029029
1027008084,0,4,4,0,1.0,0.0
841735390331572224,1,1000,230,770,0.23,0.77
1395199351564247057,0,44,43,1,0.9772727272727273,0.022727272727272728
1539705264,1,1000,47,953,0.047,0.953
378845051,0,841,833,8,0.990487514863258,0.009512485136741973
1373967975531782144,0,303,302,1,0.9966996699669967,0.0033003300330033004
255771703,1,1000,66,934,0.066,0.934
421620202,0,72,67,5,0.9305555555555556,0.06944444444444445
1507954430,1,187,29,158,0.15508021390374332,0.8449197860962567
3198231883,0,92,90,2,0.9782608695652174,0.021739130434782608
1363687226199080961,1,64,11,53,0.171875,0.828125
1548981332,0,157,144,13,0.9171974522292994,0.08280254777070063
1186498822966349824,1,349,86,263,0.24641833810888253,0.7535816618911175
375360437,0,856,856,0,1.0,0.0
46499338,1,1000,266,734,0.266,0.734
1482207849312927746,1,249,92,157,0.36947791164658633,0.6305220883534136
3298361433,1,273,20,253,0.07326007326007326,0.9267399267399268
1463126462,0,91,91,0,1.0,0.0
121645630,1,999,149,850,0.14914914914914915,0.8508508508508509
3805465514,0,134,134,0,1.0,0.0
1268465023,1,567,138,429,0.24338624338624337,0.7566137566137566
1064628494104227841,0,914,903,11,0.9879649890590809,0.012035010940919038
1034939897189154821,1,1000,231,769,0.231,0.769
442809263,0,617,592,25,0.9594813614262561,0.04051863857374392
529033353,1,419,47,372,0.11217183770883055,0.8878281622911695
901139759728173056,0,50,48,2,0.96,0.04
32667201,1,1000,150,850,0.15,0.85
1747880382,0,69,69,0,1.0,0.0
1061385089500766210,1,1000,139,861,0.139,0.861
413803178,0,1000,996,4,0.996,0.004
1242987750,1,246,90,156,0.36585365853658536,0.6341463414634146
1952549749,0,1000,986,14,0.986,0.014
3131183081,1,557,116,441,0.20825852782764812,0.7917414721723519
1666134386,0,1000,862,138,0.862,0.138
315551977,1,467,46,421,0.09850107066381156,0.9014989293361885
1387809821840355330,0,554,551,3,0.9945848375451264,0.005415162454873646
844746241,1,952,122,830,0.12815126050420167,0.8718487394957983
1371886897,0,1000,996,4,0.996,0.004
913048994,1,647,30,617,0.04636785162287481,0.9536321483771252
1480668008787943428,0,430,423,7,0.9837209302325581,0.01627906976744186
18248782,1,1000,197,803,0.197,0.803
101341478,0,501,495,6,0.9880239520958084,0.011976047904191617
1140745776567660544,1,404,41,363,0.10148514851485149,0.8985148514851485
14554216,0,62,60,2,0.967741935483871,0.03225806451612903
16394051,1,432,35,397,0.08101851851851852,0.9189814814814815
2322089784,0,635,593,42,0.9338582677165355,0.06614173228346457
2722423107,1,148,5,143,0.033783783783783786,0.9662162162162162
721336670,0,1000,890,110,0.89,0.11
22517337,1,670,123,547,0.18358208955223881,0.8164179104477612
1120836856621535237,0,1000,1000,0,1.0,0.0
66200952,1,1000,132,868,0.132,0.868
907603964077727744,0,522,507,15,0.9712643678160919,0.028735632183908046
929208202998308864,1,179,39,140,0.21787709497206703,0.7821229050279329
4675017558,0,63,62,1,0.9841269841269841,0.015873015873015872
295504282,1,323,40,283,0.1238390092879257,0.8761609907120743
780139088405893120,0,323,309,14,0.9566563467492261,0.043343653250773995
431258729,1,378,32,346,0.08465608465608465,0.9153439153439153
85497403,0,150,139,11,0.9266666666666666,0.07333333333333333
2360156510,1,675,38,637,0.056296296296296296,0.9437037037037037
172896183,0,39,39,0,1.0,0.0
769303361023684608,1,92,7,85,0.07608695652173914,0.9239130434782609
38234540,0,322,310,12,0.9627329192546584,0.037267080745341616
1628915708,1,353,95,258,0.26912181303116145,0.7308781869688386
592845104,0,196,187,9,0.9540816326530612,0.04591836734693878
45416544,1,733,279,454,0.3806275579809004,0.6193724420190996
58850361,0,999,950,49,0.950950950950951,0.04904904904904905
1483429328817999878,1,189,15,174,0.07936507936507936,0.9206349206349206
869491499221700609,0,45,43,2,0.9555555555555556,0.044444444444444446
1095025937043914753,1,688,101,587,0.14680232558139536,0.8531976744186046
1672478203,0,194,194,0,1.0,0.0
4883335575,0,51,50,1,0.9803921568627451,0.0196078431372549
1236425738779340803,1,831,68,763,0.08182912154031288,0.9181708784596871
961955426328829952,0,154,151,3,0.9805194805194806,0.01948051948051948
309868556,0,1000,960,40,0.96,0.04
1464080880289341442,1,134,45,89,0.3358208955223881,0.664179104477612
1468062083220930564,0,78,78,0,1.0,0.0
169856212,1,861,197,664,0.22880371660859466,0.7711962833914053
1054549419771588609,0,13,13,0,1.0,0.0
1019472596939796481,1,983,331,652,0.3367243133265514,0.6632756866734486
1403787844842360834,0,163,163,0,1.0,0.0
932654815745859586,1,121,27,94,0.2231404958677686,0.7768595041322314
454327317,0,907,794,113,0.8754134509371555,0.12458654906284454
914290762329858048,1,731,182,549,0.24897400820793433,0.7510259917920656
759805040320131072,0,412,411,1,0.9975728155339806,0.0024271844660194173
17428963,1,1000,135,865,0.135,0.865
2994343383,0,690,690,0,1.0,0.0
2590433508,1,318,46,272,0.14465408805031446,0.8553459119496856
1208271638141325318,0,1000,994,6,0.994,0.006
1208136847,1,490,25,465,0.05102040816326531,0.9489795918367347
16326951,0,90,90,0,1.0,0.0
189416211,1,1000,165,835,0.165,0.835
1539300549761171456,0,1000,997,3,0.997,0.003
3306586004,1,1000,151,849,0.151,0.849
30565597,0,436,414,22,0.9495412844036697,0.05045871559633028
16952910,1,1000,91,909,0.091,0.909
242542066,0,214,202,12,0.9439252336448598,0.056074766355140186
4253305156,1,191,26,165,0.13612565445026178,0.8638743455497382
47220321,0,565,524,41,0.9274336283185841,0.07256637168141593
1126677585038053376,1,246,48,198,0.1951219512195122,0.8048780487804879
817161819034947586,0,125,114,11,0.912,0.088
1616688006,1,1000,104,896,0.104,0.896
1658529420,1,505,59,446,0.11683168316831684,0.8831683168316832
41873232,0,1000,991,9,0.991,0.009
972529746,1,654,37,617,0.05657492354740061,0.9434250764525994
835672174316912640,0,1000,992,8,0.992,0.008
3487949115,1,433,47,386,0.10854503464203233,0.8914549653579676
734482234200096768,0,357,347,10,0.9719887955182073,0.028011204481792718
746704294989209601,1,873,284,589,0.32531500572737687,0.6746849942726232
1605045511,0,1000,997,3,0.997,0.003
2785552797,1,935,56,879,0.059893048128342244,0.9401069518716577
8245632,0,603,584,19,0.9684908789386402,0.03150912106135987
259879111,1,1000,51,949,0.051,0.949
34432682,0,201,158,43,0.7860696517412935,0.21393034825870647
1162105527419252736,1,530,36,494,0.06792452830188679,0.9320754716981132
3075537642,0,1000,917,83,0.917,0.083
44001819,1,380,116,264,0.30526315789473685,0.6947368421052632
1380676682642829313,0,7,7,0,1.0,0.0
2332148076,1,894,198,696,0.2214765100671141,0.7785234899328859
2942233058,0,652,640,12,0.9815950920245399,0.018404907975460124
2984993949,0,261,260,1,0.9961685823754789,0.0038314176245210726
773272657840275456,1,241,16,225,0.06639004149377593,0.9336099585062241
1048293023820533760,0,260,260,0,1.0,0.0
1245863246550179841,1,564,81,483,0.14361702127659576,0.8563829787234043
28417455,0,641,637,4,0.9937597503900156,0.0062402496099844
80414272,1,268,31,237,0.11567164179104478,0.8843283582089553
962742910612520960,0,107,104,3,0.9719626168224299,0.028037383177570093
868841441233174530,1,587,51,536,0.0868824531516184,0.9131175468483816
1336877742,0,189,182,7,0.9629629629629629,0.037037037037037035
1115008377653026816,1,111,22,89,0.1981981981981982,0.8018018018018018
806895267870076928,0,664,662,2,0.9969879518072289,0.0030120481927710845
2352409243,1,364,32,332,0.08791208791208792,0.9120879120879121
851841357870223362,0,999,995,4,0.995995995995996,0.004004004004004004
51381681,1,780,87,693,0.11153846153846154,0.8884615384615384
1408084381323862018,0,199,182,17,0.914572864321608,0.08542713567839195
765712518077526017,1,98,18,80,0.1836734693877551,0.8163265306122449
247611135,0,535,531,4,0.9925233644859813,0.007476635514018692
2808995038,1,789,40,749,0.050697084917617236,0.9493029150823827
1456034103728422917,0,476,460,16,0.9663865546218487,0.03361344537815126
1214379458246791169,1,999,92,907,0.0920920920920921,0.9079079079079079
346198873,1,407,132,275,0.32432432432432434,0.6756756756756757
429608025,0,232,216,16,0.9310344827586207,0.06896551724137931
2923895699,1,1000,134,866,0.134,0.866
145488339,0,1000,996,4,0.996,0.004
16064278,1,1000,68,932,0.068,0.932
418232368,0,257,253,4,0.9844357976653697,0.01556420233463035
379432043,1,378,35,343,0.09259259259259259,0.9074074074074074
829795022233038849,0,329,324,5,0.9848024316109423,0.015197568389057751
312336251,1,553,210,343,0.379746835443038,0.620253164556962
4694430270,0,88,84,4,0.9545454545454546,0.045454545454545456
241692417,1,1000,9,991,0.009,0.991
1318751360733663232,0,395,366,29,0.9265822784810127,0.07341772151898734
216482127,1,578,131,447,0.22664359861591696,0.773356401384083
1392050781608550403,0,120,120,0,1.0,0.0
1225901426955689984,1,191,51,140,0.2670157068062827,0.7329842931937173
1044627093106171905,0,94,92,2,0.9787234042553191,0.02127659574468085
981352147773083648,1,175,14,161,0.08,0.92
1045033604877881344,0,59,59,0,1.0,0.0
389379575,1,1000,150,850,0.15,0.85
511022037,0,1000,878,122,0.878,0.122
68443602,1,1000,134,866,0.134,0.866
1143580363375202305,0,88,87,1,0.9886363636363636,0.011363636363636364
605074028,1,612,86,526,0.14052287581699346,0.8594771241830066
1184603520,0,208,203,5,0.9759615384615384,0.02403846153846154
16185498,1,666,167,499,0.25075075075075076,0.7492492492492493
410169718,0,1000,989,11,0.989,0.011
2744112335,1,852,152,700,0.1784037558685446,0.8215962441314554
1531787426,0,425,330,95,0.7764705882352941,0.2235294117647059
1378262943121383424,1,154,4,150,0.025974025974025976,0.974025974025974
25486230,0,628,624,4,0.9936305732484076,0.006369426751592357
2940415261,1,869,265,604,0.3049482163406214,0.6950517836593786
1489717194674130948,0,277,277,0,1.0,0.0
1178370767869882371,1,77,6,71,0.07792207792207792,0.922077922077922
370914096,0,804,774,30,0.9626865671641791,0.03731343283582089
1033816724024578049,1,1000,37,963,0.037,0.963
425514356,0,232,230,2,0.9913793103448276,0.008620689655172414
1439874811,1,1000,123,877,0.123,0.877
27906862,0,1000,965,35,0.965,0.035
865990776983080962,1,392,72,320,0.1836734693877551,0.8163265306122449
315455029,0,310,307,3,0.9903225806451613,0.00967741935483871
1046767566964895744,1,160,13,147,0.08125,0.91875
1505853627625537537,0,47,46,1,0.9787234042553191,0.02127659574468085
1105196336390000641,1,305,75,230,0.2459016393442623,0.7540983606557377
1486330945,0,1000,991,9,0.991,0.009
3142695026,1,297,19,278,0.06397306397306397,0.936026936026936
718830222070579200,0,394,393,1,0.9974619289340102,0.0025380710659898475
939655192869564417,1,121,16,105,0.1322314049586777,0.8677685950413223
372610057,0,1000,993,7,0.993,0.007
4178639308,1,1000,108,892,0.108,0.892
3111220529,0,924,922,2,0.9978354978354979,0.0021645021645021645
832486184,1,764,55,709,0.07198952879581152,0.9280104712041884
1347325296,0,450,450,0,1.0,0.0
114612071,1,769,240,529,0.31209362808842656,0.6879063719115734
2568900823,0,525,511,14,0.9733333333333334,0.02666666666666667
25726614,1,347,60,287,0.1729106628242075,0.8270893371757925
1235709975579832320,0,5,5,0,1.0,0.0
1534763436386578433,1,35,17,18,0.4857142857142857,0.5142857142857142
708101569254805504,0,1000,997,3,0.997,0.003
2572861,1,1000,51,949,0.051,0.949
948601556668243968,0,156,156,0,1.0,0.0
1078169717788033024,1,726,189,537,0.2603305785123967,0.7396694214876033
821403600618274817,0,222,209,13,0.9414414414414415,0.05855855855855856
274340304,1,232,30,202,0.12931034482758622,0.8706896551724138
33993128,0,985,942,43,0.9563451776649746,0.04365482233502538
333245419,1,399,22,377,0.05513784461152882,0.9448621553884712
1074807000133980160,0,246,226,20,0.9186991869918699,0.08130081300813008
1345611784229535744,1,152,41,111,0.26973684210526316,0.7302631578947368
1203803377894690817,0,133,123,10,0.924812030075188,0.07518796992481203
259079443,1,649,177,472,0.2727272727272727,0.7272727272727273
4173608781,0,470,444,26,0.9446808510638298,0.05531914893617021
1176634198641168384,1,221,8,213,0.03619909502262444,0.9638009049773756
1499813675858755584,0,210,209,1,0.9952380952380953,0.004761904761904762
1487497166121848837,1,516,150,366,0.29069767441860467,0.7093023255813954
935229740851646464,0,841,811,30,0.9643281807372176,0.0356718192627824
1233822124650876928,1,511,155,356,0.30332681017612523,0.6966731898238747
254653318,0,836,787,49,0.9413875598086124,0.05861244019138756
1315445195144671234,1,303,9,294,0.0297029702970297,0.9702970297029703
24011644,0,237,229,8,0.9662447257383966,0.03375527426160337
1175602291333881857,1,177,11,166,0.062146892655367235,0.9378531073446328
1488261580181671939,0,686,674,12,0.9825072886297376,0.01749271137026239
1120866239969202176,1,112,17,95,0.15178571428571427,0.8482142857142857
2964709280,0,255,252,3,0.9882352941176471,0.011764705882352941
2605950518,1,1000,110,890,0.11,0.89
1020823655893389314,0,63,63,0,1.0,0.0
2646770046,1,173,23,150,0.1329479768786127,0.8670520231213873
14092407,0,1000,966,34,0.966,0.034
1093977981448568838,1,153,50,103,0.32679738562091504,0.673202614379085
262919874,0,545,541,4,0.9926605504587156,0.007339449541284404
3660111135,1,1000,173,827,0.173,0.827
701076478574743552,0,209,209,0,1.0,0.0
962087258642944005,0,337,323,14,0.9584569732937686,0.04154302670623145
608241089,1,191,8,183,0.041884816753926704,0.9581151832460733
1105324814867333120,0,1000,991,9,0.991,0.009
1063112034013704192,1,123,23,100,0.18699186991869918,0.8130081300813008
1902315853,0,737,735,2,0.9972862957937585,0.0027137042062415195
4597060579,1,221,13,208,0.058823529411764705,0.9411764705882353
31558739,0,205,202,3,0.9853658536585366,0.014634146341463415
1133584287587028997,1,111,3,108,0.02702702702702703,0.972972972972973
82247131,0,382,378,4,0.9895287958115183,0.010471204188481676
1054286072,1,196,44,152,0.22448979591836735,0.7755102040816326
523861830,0,693,690,3,0.9956709956709957,0.004329004329004329
294015885,1,1000,28,972,0.028,0.972
986621514249396224,0,333,333,0,1.0,0.0
