trigram,overall,he/him,she/her,they/them,he/they,she/they,multiple,pronoun list
**BIO_COUNT**,5444623,84145,120445,17905,9573,16282,2288,250638
are my own,53820,2718,3705,209,105,213,32,6982
i am a,24877,264,314,62,19,38,10,707
opinions are my,19491,1165,1439,90,48,106,10,2858
tweets are my,13116,486,695,24,15,31,4,1255
views are my,12233,596,1074,55,26,49,10,1810
official twitter account,12207,13,5,2,0,0,1,21
the official twitter,12190,18,4,1,1,0,1,25
black lives matter,9634,1156,1731,214,122,224,40,3487
at a time,9580,113,165,19,12,18,6,333
i like to,8254,224,282,44,19,51,7,627
follow me on,8241,62,84,17,13,13,2,191
to be a,8155,203,213,29,16,25,5,491
check out my,7517,164,180,37,17,35,4,437
twitter account of,7454,11,1,1,0,0,0,13
here for the,7345,108,213,21,7,13,3,365
my name is,7266,165,159,54,23,41,13,455
in the world,7243,92,98,9,4,15,4,222
born and raised,6939,78,88,5,0,5,1,177
a lot of,6921,312,369,65,34,52,10,842
i have a,6640,160,206,32,11,22,3,434
i love my,6318,73,116,23,11,14,0,237
just trying to,6317,146,187,45,19,32,1,430
r i p,6020,17,18,3,3,2,0,43
of all things,5888,137,204,17,10,12,1,381
official twitter of,5852,16,6,1,1,1,0,25
we are a,5813,1,6,1,0,0,0,8
member of the,5668,110,92,15,4,11,2,234
i love to,5559,45,81,8,10,7,0,151
twitter account for,5445,9,7,2,0,0,0,18
the university of,5257,66,65,3,4,2,0,140
trying to make,5237,134,129,16,12,15,1,307
opinions my own,5080,439,554,33,18,39,4,1087
you want to,5029,65,83,10,10,11,2,181
account of the,5016,2,3,0,1,1,2,9
just here to,4925,85,157,27,17,23,2,311
this is my,4866,111,137,27,20,24,6,325
views my own,4859,320,621,24,20,25,4,1014
lover of all,4777,106,179,16,6,8,3,318
official twitter page,4757,3,4,0,0,0,0,7
welcome to the,4707,51,55,12,4,18,2,142
just a guy,4677,128,1,0,8,0,5,142
i am the,4671,70,74,18,4,14,2,182
i want to,4652,92,139,18,8,20,4,281
just here for,4633,56,101,15,5,13,2,192
if you want,4392,107,78,18,13,9,5,230
looking for a,4317,53,40,8,3,5,2,111
one of the,4311,53,32,3,4,7,0,99
my own and,4255,244,192,18,12,11,3,480
welcome to my,4166,77,131,27,13,17,3,268
husband and father,4004,65,0,0,3,0,0,68
a good time,3980,48,100,15,6,12,3,184
and i love,3960,43,65,17,9,9,1,144
in love with,3951,70,166,20,18,38,2,314
in that order,3910,109,106,5,1,3,3,227
video games and,3808,288,153,54,28,23,7,553
father of 3,3800,44,0,1,0,0,1,46
this is the,3767,43,40,9,2,10,1,105
i am an,3764,51,67,13,7,4,3,145
of the year,3759,47,55,6,3,2,0,113
home of the,3757,5,6,2,2,1,1,17
https //www youtube,3701,47,17,4,6,1,0,75
to the fullest,3699,11,13,1,0,0,0,25
feel free to,3675,139,97,33,21,13,4,307
https //www instagram,3645,44,37,3,3,2,4,93
i am not,3635,58,74,7,6,12,1,158
my tweets are,3620,119,101,18,7,6,1,252
father of 2,3601,38,0,0,0,0,0,38
love my family,3591,14,17,0,0,0,0,31
host of the,3534,98,39,5,4,3,1,150
are not endorsements,3514,58,55,6,1,4,2,126
i believe in,3453,47,88,4,3,4,2,148
author of the,3430,105,173,6,5,8,2,299
want to be,3384,48,72,6,3,21,0,150
official account of,3335,4,6,1,1,0,1,13
life to the,3311,12,11,1,0,1,0,25
mission is to,3298,0,1,1,0,0,0,2
trying to be,3256,140,129,11,24,15,2,321
day at a,3253,38,56,8,6,5,2,115
fan of the,3247,52,47,10,5,0,0,114
of my life,3242,31,70,6,1,5,2,115
all opinions are,3235,183,285,20,7,19,3,517
account for the,3223,5,10,0,2,2,0,19
husband father of,3211,41,0,0,2,0,0,43
part of the,3208,52,57,5,6,4,2,126
living in the,3191,79,69,12,6,1,0,167
mom of 2,3173,0,147,0,0,4,1,152
opinions are mine,3161,221,251,10,9,12,0,503
father of two,3114,66,1,0,0,0,1,68
twitter page of,3112,1,3,0,0,0,0,4
i'm just a,3100,84,69,14,12,11,4,194
click the link,3064,21,38,4,2,9,0,74
and raised in,3022,25,21,2,0,3,1,52
one day at,3010,37,54,8,6,5,2,112
mom of 3,2989,0,118,1,0,5,1,125
follower of christ,2969,9,6,0,1,1,0,17
subscribe to my,2941,19,19,2,1,1,0,42
this is a,2939,75,150,22,10,24,6,287
this account for,2911,10,5,1,3,3,0,22
we are the,2901,10,12,0,0,4,0,26
not financial advice,2901,1,4,0,1,0,0,6
small business owner,2880,21,69,3,2,7,0,102
i follow back,2862,36,40,5,2,6,0,89
dm me for,2860,44,56,21,10,21,3,155
to have fun,2860,31,19,7,2,1,2,62
i tweet about,2845,120,134,11,11,9,1,286
follower of jesus,2812,12,11,1,0,0,0,24
i love the,2811,22,31,2,4,3,0,62
follow this account,2811,2,1,0,2,1,0,6
is the best,2800,48,40,3,4,2,2,99
to be the,2774,44,46,5,4,4,1,104
for a good,2773,28,62,8,5,9,1,113
to make a,2735,29,46,7,2,5,0,89
of the world,2717,42,45,3,5,9,0,104
need help tweet,2709,0,0,0,0,0,0,0
who i am,2708,35,45,6,2,1,1,90
help tweet us,2701,0,0,0,0,0,0,0
tweet us at,2696,0,0,0,0,0,0,0
as well as,2691,31,24,5,5,5,1,71
account for geo-targeted,2689,0,0,0,0,0,0,0
job tweets in,2689,0,0,0,0,0,0,0
us at careerarc,2687,0,0,0,0,0,0,0
proud member of,2669,43,43,12,3,6,0,107
big fan of,2667,102,147,18,6,10,1,284
here for a,2659,28,67,7,6,10,2,120
real estate agent,2620,2,6,0,0,0,0,8
child of god,2597,2,27,0,0,2,0,31
if you are,2587,40,42,8,3,7,3,103
and lover of,2575,60,105,9,2,9,2,187
link in bio,2552,21,18,11,0,9,1,60
the united states,2552,13,10,2,0,0,0,25
and i am,2543,31,45,9,3,7,1,96
to make it,2509,38,40,5,6,3,0,92
i do not,2478,55,65,13,14,9,2,158
all the time,2476,57,75,20,9,7,3,171
i love you,2475,24,85,11,0,11,1,132
my opinions are,2456,161,126,13,6,13,0,319
i’m just here,2452,30,60,5,1,5,0,101
around the world,2451,5,6,0,1,2,0,14
the link below,2450,24,30,5,3,5,0,67
of jesus christ,2430,8,9,1,0,3,0,21
https //www twitch,2429,64,27,13,7,9,4,124
expressed are my,2413,109,111,6,3,4,3,236
me on ig,2410,6,22,2,1,2,0,33
trying to get,2407,68,66,14,9,9,1,167
at the university,2405,45,50,3,4,1,0,103
me on instagram,2395,12,35,3,1,3,1,55
me if you,2382,52,45,10,4,2,0,113
married to my,2362,24,49,4,1,2,1,81
my youtube channel,2362,23,16,2,0,2,0,43
there is no,2352,24,44,3,2,1,1,75
life is a,2352,11,42,3,1,5,0,62
proud to be,2345,17,27,3,1,1,0,49
for all things,2326,13,28,3,0,1,0,45
on the internet,2307,147,111,18,14,15,2,307
i live in,2298,41,39,3,5,3,1,92
my family and,2294,11,17,1,0,1,0,30
tweets my own,2284,117,249,8,5,9,1,389
just your average,2277,72,66,15,7,6,3,169
twitter of the,2277,2,2,0,0,1,0,5
philippians 4 13,2272,1,6,0,0,0,0,7
play video games,2270,134,80,15,17,9,2,257
our mission is,2255,0,0,0,0,0,0,0
the love of,2251,20,48,6,1,3,1,79
and all things,2172,36,77,5,3,8,0,129
the u s,2157,11,15,0,1,1,1,29
what it is,2152,10,28,2,1,0,2,43
living the dream,2149,12,18,0,0,0,0,30
to help you,2138,6,2,2,0,1,0,11
a fan of,2135,48,46,6,4,3,0,107
a long time,2133,19,46,3,3,8,2,81
thoughts are my,2129,106,153,16,3,11,1,290
of my employer,2129,120,125,11,4,3,2,265
hit me up,2118,44,15,4,3,1,1,68
proud father of,2114,20,0,2,0,0,0,22
my best friend,2096,25,45,8,0,2,2,82
the world is,2073,23,34,4,2,1,1,65
official twitter for,2067,9,1,2,0,0,0,12
class of 2023,2063,15,13,2,0,0,0,30
a passion for,2059,28,49,7,4,2,1,91
and video games,2057,145,96,22,18,24,2,307
just a girl,2042,2,114,0,0,9,1,126
my best life,2032,16,39,6,1,2,0,64
i used to,2030,78,75,4,4,6,3,170
mother of 2,2030,2,41,1,0,0,0,44
if you don't,2017,25,32,4,2,6,2,71
who loves to,2015,27,33,6,5,6,0,77
the power of,2008,19,35,6,1,5,0,66
not affiliated with,1994,28,24,3,1,4,1,61
husband father and,1990,13,0,0,0,0,0,13
texas a m,1985,27,28,1,0,0,0,56
you need to,1973,18,29,7,4,3,0,61
lover of life,1972,11,39,2,1,2,0,55
of all trades,1969,63,46,17,5,15,0,146
this account is,1936,58,59,11,9,9,2,148
father of 4,1936,20,1,0,0,0,0,21
what i do,1935,24,29,4,1,2,2,62
for a living,1919,83,61,16,3,7,0,170
i have no,1910,49,82,14,9,15,5,174
is what it,1909,4,21,2,0,0,2,29
mental health advocate,1907,59,158,19,4,16,1,257
a better place,1906,43,54,3,3,3,0,106
i just want,1903,56,58,9,3,12,0,138
a little bit,1897,48,80,4,6,10,1,149
mother of 3,1896,3,26,1,0,0,0,30
family and friends,1896,5,10,0,0,0,0,15
add me on,1891,31,10,2,3,3,1,50
views expressed are,1890,87,86,3,3,4,1,184
a guy who,1887,65,1,1,2,0,2,71
it is what,1887,4,22,2,0,0,2,30
be the best,1884,22,16,1,5,3,0,47
goal is to,1876,11,14,3,1,2,0,31
just want to,1867,47,44,5,2,12,0,110
follow us on,1867,2,4,0,1,0,0,7
and do not,1866,90,81,8,6,8,2,195
page of the,1848,0,1,0,0,0,0,1
i’m just a,1822,31,37,7,3,12,2,92
on a mission,1803,15,25,1,0,1,0,42
u s army,1803,10,5,0,0,0,0,15
christian husband father,1795,9,0,0,0,0,0,9
and father of,1779,21,2,0,0,0,0,23
in new york,1775,29,24,1,2,1,0,57
in this world,1770,28,37,3,4,2,0,74
i can be,1770,35,18,5,6,6,1,71
the city of,1770,8,16,0,0,0,0,24
https //www facebook,1766,3,4,1,0,0,0,8
not a financial,1766,1,2,0,0,0,0,3
of the time,1765,75,77,12,5,10,3,182
all tweets are,1763,50,62,4,1,7,0,124
here are my,1762,81,66,3,1,4,1,156
is the official,1761,4,1,1,0,0,0,6
if you don’t,1750,23,49,5,3,5,1,86
i was born,1746,19,17,3,4,4,1,48
twitter page for,1742,3,1,0,0,0,0,4
in the making,1741,19,38,7,3,2,0,69
change the world,1739,23,36,5,1,2,1,68
official account for,1736,3,2,0,2,1,0,8
to make the,1735,55,58,5,3,6,0,127
on all platforms,1732,10,13,2,0,5,0,30
/ / /,1728,20,22,4,5,1,1,53
twitch http //twitch,1726,75,41,7,11,2,1,137
is not a,1725,34,45,6,4,4,2,95
and i like,1724,67,39,12,7,11,2,138
the world a,1724,59,59,5,4,5,0,132
find me on,1719,36,78,12,5,9,2,142
trying to live,1714,32,60,11,2,2,0,107
all views are,1703,67,157,14,2,12,3,255
i don't know,1701,58,55,11,7,13,2,146
lover of the,1701,21,56,3,4,5,1,90
i try to,1700,72,46,8,5,7,2,140
married to the,1698,25,32,6,2,1,0,66
married to a,1693,31,38,1,0,4,2,76
i don’t know,1687,45,71,7,5,8,4,140
mother of two,1687,0,52,0,0,2,0,54
love my country,1683,4,2,0,0,0,0,6
follow us for,1681,0,0,0,0,0,0,0
you have to,1677,16,23,6,2,2,1,50
living my best,1675,9,25,5,0,3,0,42
a financial advisor,1672,2,2,0,0,0,0,4
retweets are not,1670,35,26,3,2,1,1,68
the heart of,1670,6,6,0,0,0,0,12
check out our,1660,4,8,0,0,1,0,13
your source for,1657,0,1,0,0,0,0,1
trying to find,1654,44,46,6,3,10,1,110
dms are open,1648,124,44,12,18,7,3,208
the future of,1646,13,11,0,1,1,0,26
check me out,1643,25,14,3,2,2,2,48
to have a,1641,16,28,6,2,3,1,56
in a world,1637,20,29,5,2,5,0,61
tweets are mine,1635,81,101,2,3,6,0,193
to my youtube,1631,7,6,1,0,1,0,15
views are mine,1627,93,140,5,5,9,1,253
is my life,1625,22,29,3,2,3,1,60
talk to me,1624,66,89,22,7,15,5,204
jack of all,1621,49,23,16,5,5,0,98
trying to figure,1620,49,75,13,4,8,1,150
the official account,1619,2,3,1,1,0,1,8
and opinions are,1617,85,89,4,6,3,2,189
used to be,1610,53,62,3,1,8,3,130
me on twitch,1606,33,28,8,6,7,1,83
here to help,1604,12,8,3,0,3,0,26
your friendly neighborhood,1599,64,110,23,18,13,4,232
of the most,1590,9,12,1,0,0,0,22
living in a,1588,24,57,8,3,6,1,99
soon to be,1585,31,42,10,3,3,3,92
i can do,1582,18,20,3,2,0,0,43
and all around,1581,65,48,2,7,3,1,126
in the us,1575,21,21,2,3,1,0,48
husband father grandfather,1575,11,0,0,0,0,0,11
make the world,1569,63,54,7,4,5,0,133
make a difference,1567,11,32,1,1,0,0,45
sense of humor,1566,15,36,1,0,4,1,57
of the best,1559,7,5,0,0,2,1,15
real estate broker,1555,1,2,0,0,0,0,3
at https //t,1550,52,23,2,0,1,1,79
is dedicated to,1550,1,1,0,0,0,0,2
if you have,1549,27,29,5,3,2,2,68
mom of two,1547,0,83,1,0,2,0,86
jeremiah 29 11,1541,2,5,0,1,0,0,8
my life is,1530,22,43,5,2,5,1,78
who likes to,1527,49,32,14,8,6,0,109
do not reflect,1525,79,96,14,6,9,3,207
head football coach,1517,0,0,0,0,0,0,0
class of 2022,1513,18,13,1,2,0,0,34
in my life,1510,14,24,6,3,2,1,50
will be blocked,1504,101,66,21,12,13,6,219
a mission to,1498,12,20,1,0,1,0,34
always looking for,1492,26,30,3,4,4,1,68
the best of,1491,12,14,5,1,2,0,34
the world of,1491,10,9,2,1,1,1,24
if you like,1490,37,31,3,6,3,2,82
world a better,1480,39,47,3,3,3,0,95
what i want,1478,24,36,3,0,7,0,70
new york city,1478,20,14,1,1,1,0,37
is the only,1477,20,23,2,0,4,1,50
is my passion,1473,16,36,2,2,3,0,59
i'm just here,1471,29,45,9,3,13,2,101
i make music,1470,82,29,13,12,8,2,146
life is good,1467,5,14,1,2,0,0,22
with a passion,1459,21,34,6,3,1,0,65
huge fan of,1458,27,31,2,3,2,0,65
just a dude,1453,54,0,0,7,0,0,61
have a good,1451,33,29,11,1,6,2,82
tweets are not,1451,19,24,3,0,0,0,46
who you are,1444,16,24,4,0,4,1,49
down to earth,1438,2,7,3,1,0,0,13
to be an,1437,31,44,7,3,8,1,94
out of the,1437,15,22,6,3,4,1,51
i love god,1434,0,5,1,0,1,0,7
co-host of the,1429,80,30,1,2,3,2,118
creator of the,1426,51,27,6,3,6,0,93
opinions expressed are,1417,73,54,3,1,1,2,134
follow me for,1413,29,25,1,1,4,0,60
the state of,1406,10,8,3,1,2,0,24
official twitter feed,1404,2,0,1,0,0,0,3
and i have,1399,23,40,4,2,4,1,74
in the usa,1390,17,12,1,0,1,0,31
real estate investor,1380,2,2,0,0,0,0,4
i just be,1376,23,29,5,2,7,1,67
https //www amazon,1375,27,27,6,1,2,1,64
living life to,1375,5,4,0,0,2,0,11
love of my,1373,18,35,6,0,4,0,63
i love music,1371,22,20,4,1,4,0,51
class of 2024,1368,6,3,0,1,0,0,10
years of experience,1366,6,1,4,0,1,0,12
the end of,1362,21,26,6,1,6,0,60
to the moon,1361,3,11,2,1,0,0,17
father of three,1360,20,0,0,0,0,0,20
in los angeles,1356,19,16,0,0,2,0,37
for more info,1355,11,18,3,7,1,1,41
love to travel,1350,4,8,0,1,0,0,13
if you need,1345,28,27,9,4,4,0,72
need to know,1338,18,29,4,2,3,0,56
to my best,1329,12,29,0,0,0,0,41
a variety of,1326,22,19,7,0,1,0,49
fan for life,1322,5,9,1,0,0,0,15
you can find,1316,16,28,6,5,5,3,63
time not a,1314,16,27,3,2,4,2,54
i’m here for,1309,12,37,5,3,5,1,63
live in the,1309,14,24,2,0,1,0,41
do not represent,1302,85,62,4,9,3,0,163
not necessarily in,1302,44,47,1,1,1,3,97
never give up,1302,5,4,1,0,2,0,12
mom of 4,1300,0,36,4,0,2,0,42
saved by grace,1300,0,8,0,0,0,0,8
follow me i,1296,5,12,0,2,3,0,22
god bless america,1294,0,0,0,0,0,0,0
work in progress,1293,33,75,5,2,3,1,119
necessarily in that,1293,44,47,1,1,1,2,96
4 0 gpa,1289,0,0,0,0,0,0,0
have some fun,1286,12,6,1,3,4,0,26
high school football,1285,0,0,0,0,0,0,0
own and do,1284,81,65,5,4,6,2,163
not a long,1275,12,27,2,2,4,2,49
to know me,1269,9,16,1,0,0,0,26
wife mom of,1268,0,33,0,0,1,0,34
live life to,1265,3,4,1,0,0,0,8
your cash app,1261,0,0,0,0,0,0,0
the rest of,1260,27,30,3,0,0,0,60
a bit of,1259,39,49,9,5,4,2,108
501 c 3,1258,1,1,1,0,0,1,4
nsfw 18 only,1257,118,43,24,14,14,4,217
so i can,1254,23,44,8,3,3,1,82
a lover of,1253,21,27,4,1,1,0,54
i love all,1246,19,26,4,2,1,2,54
we are all,1246,10,23,2,2,0,1,38
i have been,1246,15,10,0,0,0,0,25
along the way,1244,22,16,1,1,3,0,43
official page of,1243,0,0,0,0,0,0,0
as long as,1242,18,19,2,2,5,2,48
grew up in,1242,18,17,0,0,1,0,36
know how to,1240,28,51,11,4,12,1,107
all the way,1240,7,16,1,0,0,0,24
my views are,1239,75,78,10,2,7,2,174
to become a,1238,24,32,6,1,4,0,67
i'm here to,1238,21,15,8,5,1,1,51
expressed here are,1235,52,45,3,1,4,5,110
and i will,1232,13,14,3,1,1,0,32
want to see,1231,20,24,3,2,7,0,56
check out the,1228,9,15,1,0,0,2,27
wife mother grandmother,1228,0,11,0,0,0,0,11
little bit of,1227,21,41,2,3,4,0,71
my own not,1225,68,83,7,2,3,4,167
follow me and,1224,3,3,2,0,1,0,9
president of the,1223,32,34,2,0,4,0,72
good time not,1221,9,25,2,2,4,1,43
wear a mask,1219,44,113,12,2,7,0,178
be kind to,1215,37,43,9,4,8,0,101
proud mom of,1215,0,36,1,0,1,0,38
love my wife,1214,12,8,3,1,3,1,28
lover of music,1211,24,39,4,2,2,1,72
want to know,1210,8,11,2,0,1,0,22
https //open spotify,1209,24,8,3,1,0,1,37
assistant professor of,1204,53,95,3,0,4,0,155
god family country,1202,1,0,0,0,0,0,1
just a simple,1201,25,18,5,2,3,0,53
not monitored 24/7,1201,0,0,0,0,0,0,0
i’m here to,1199,14,24,0,4,4,2,48
just a regular,1199,20,3,2,0,1,0,26
love all things,1197,20,26,4,1,3,1,55
am not a,1191,15,24,3,3,6,0,51
stream on twitch,1189,44,25,11,1,6,5,92
founder of the,1188,16,22,3,0,2,0,43
get to know,1188,12,15,3,2,0,0,32
all kinds of,1185,24,16,4,1,3,1,49
fan of all,1185,17,12,1,0,1,0,31
is my favorite,1183,33,35,4,2,4,0,78
call of duty,1183,13,8,1,0,0,0,22
happily married to,1180,28,23,7,0,0,1,59
to talk about,1179,39,56,9,5,7,0,116
to the world,1178,13,8,4,0,2,0,27
is what you,1176,5,11,0,0,0,1,17
can call me,1175,56,72,30,16,20,3,197
if you know,1173,36,34,14,5,6,1,96
is one of,1173,2,1,0,1,0,0,4
own and not,1172,60,43,5,0,2,0,110
all over the,1172,7,18,0,2,3,0,30
http //www hudl,1172,0,0,0,0,0,0,0
of my own,1170,28,31,2,4,1,0,66
content creator for,1169,27,10,3,3,0,0,43
i talk about,1167,65,97,13,7,20,1,203
track and field,1167,3,0,0,0,0,0,3
dm me if,1166,31,17,6,2,2,0,58
if you wanna,1162,37,22,13,4,5,1,82
life is short,1162,5,22,1,0,3,0,31
the world and,1159,12,20,2,0,0,0,34
a bunch of,1156,45,46,7,3,3,1,105
she / her,1154,1,0,0,0,0,0,1
god is good,1153,4,0,0,0,0,0,4
stay at home,1152,28,33,2,3,1,0,67
take care of,1152,16,27,2,1,4,1,51
i am just,1152,14,22,5,0,4,0,45
in the heart,1147,3,2,0,0,0,0,5
new to twitter,1143,10,12,2,3,2,0,29
at http //www,1143,7,9,0,1,1,0,18
for the best,1141,6,21,1,0,1,1,30
to figure out,1140,35,53,10,4,6,0,108
season ticket holder,1137,3,3,0,0,1,0,7
as much as,1135,17,21,0,2,2,0,42
to the best,1135,5,11,1,1,1,1,20
one and only,1130,16,16,0,2,2,0,36
guy who loves,1125,29,0,0,1,0,2,32
are mine alone,1123,66,61,3,1,2,1,134
wife mother of,1122,0,24,0,0,0,0,24
you can call,1118,50,67,28,14,19,3,181
most of the,1118,49,42,5,3,3,3,105
what you want,1117,6,14,0,0,4,0,24
source for all,1116,1,0,0,0,0,0,1
is better than,1113,11,16,0,1,1,0,29
to change the,1110,8,24,2,1,1,0,36
i am who,1109,5,8,1,0,0,1,15
be a good,1108,31,33,5,5,4,0,78
for more information,1108,0,5,0,0,0,0,5
no matter what,1107,12,9,0,0,2,0,23
hi my name,1104,23,29,11,5,10,1,79
dedicated to the,1104,4,3,1,0,0,1,9
in my own,1103,9,23,1,3,1,1,38
here to talk,1101,19,26,5,1,2,0,53
things in life,1101,9,11,1,0,2,0,23
you know me,1097,34,32,16,5,6,1,94
by way of,1096,25,54,1,2,2,1,85
no dms please,1096,2,34,0,0,1,0,37
i play games,1094,57,33,15,5,11,3,124
out now on,1092,16,12,3,2,3,2,38
is to be,1088,7,20,1,1,1,0,30
owner of the,1085,22,14,4,3,2,2,47
i was a,1083,15,30,4,3,7,0,59
i will be,1081,12,17,3,4,1,1,38
father and husband,1081,28,0,0,0,0,0,28
i will not,1079,15,38,3,1,4,0,61
i love jesus,1079,4,11,0,0,0,0,15
music is my,1078,12,26,3,0,0,0,41
not investment advice,1078,2,0,0,0,0,0,2
is out now,1075,23,35,4,3,0,1,66
my wife and,1073,16,7,2,0,1,1,27
i stand with,1069,29,21,3,2,7,0,62
believe in the,1068,14,18,0,1,0,0,33
i am also,1065,24,14,2,3,1,1,45
to the most,1063,5,10,0,0,0,0,15
the views of,1062,51,39,2,2,0,0,94
i also love,1062,22,22,2,2,2,1,51
ask me about,1058,64,100,19,9,23,1,216
husband father son,1053,6,0,0,0,0,0,6
if you can,1052,13,18,2,1,1,0,35
love is love,1051,40,136,6,2,5,0,189
discord http //discord,1049,22,9,1,4,3,0,39
a member of,1047,13,4,3,2,1,0,23
what i like,1046,13,20,3,2,2,1,41
and much more,1045,6,10,1,0,2,0,19
he / him,1045,0,0,0,0,0,0,0
check us out,1043,4,3,1,0,0,1,9
at http //twitch,1041,86,21,12,5,4,2,130
here to make,1041,26,31,7,1,5,0,70
live laugh love,1040,5,9,3,1,4,0,22
are mine and,1039,65,35,5,4,2,1,112
you can be,1039,8,18,1,1,1,1,30
the intersection of,1038,26,37,4,1,1,0,69
am who i,1034,5,6,1,0,0,1,13
the only thing,1033,15,17,1,4,2,0,39
raised in the,1033,10,16,1,0,3,1,31
will always be,1032,13,13,0,1,1,0,28
i’m not a,1031,12,29,7,1,6,1,56
rest in peace,1030,7,9,1,1,2,0,20
into the void,1028,74,136,15,7,20,1,253
do what i,1028,5,18,3,1,3,1,31
to an amazing,1028,14,11,0,0,1,0,26
to the official,1028,0,2,0,0,0,1,3
a part of,1027,11,14,2,0,0,0,27
all of the,1025,13,24,6,1,5,1,50
in a red,1020,12,46,0,0,0,0,58
gmail com for,1017,21,15,3,5,8,2,54
at the same,1016,28,44,0,2,6,2,82
playing video games,1012,34,22,5,1,7,1,70
owned and operated,1012,0,2,0,0,0,0,2
green bay packers,1009,9,7,0,0,0,0,16
this is not,1008,20,29,3,3,1,2,58
visit our website,1008,0,0,0,0,0,0,0
do what you,1006,8,18,2,0,1,0,29
rts are not,1005,14,17,1,0,1,0,33
the most high,1004,2,1,0,0,0,0,3
who wants to,1002,28,10,3,5,4,1,51
and have fun,1002,11,15,1,0,2,0,29
i just wanna,1001,20,42,9,4,6,0,81
looking for the,1001,8,16,3,0,0,1,28
we specialize in,999,0,2,0,0,0,0,2
just a man,997,20,0,0,1,0,0,21
but i am,995,20,34,10,1,6,1,72
i am here,991,13,9,1,0,3,0,26
life is too,990,7,10,0,0,1,0,18
i write about,989,40,72,5,3,4,0,124
you will be,988,30,14,2,4,2,1,53
i'm not a,988,17,19,4,3,0,0,43
here for fun,988,17,3,0,0,3,0,23
what i’m doing,987,25,68,10,4,12,1,120
on the side,986,35,32,4,9,3,1,84
i have to,986,19,21,0,0,1,3,44
looking for fun,986,6,2,1,0,0,0,9
follow my ig,985,3,4,0,0,0,0,7
all about the,984,11,11,1,0,1,0,24
commercial real estate,984,1,1,0,0,0,0,2
living my life,983,6,11,1,0,0,2,20
class of 2025,982,7,2,0,0,0,1,10
wife and mother,981,0,25,0,0,0,0,25
husband to a,980,14,0,0,0,0,0,14
do your own,979,1,0,0,0,0,0,1
have no idea,977,24,58,11,7,6,2,108
profile pic by,973,183,84,44,18,20,7,356
streamer on twitch,973,42,33,3,3,5,1,87
at your own,973,19,14,4,4,3,1,45
for all the,970,9,19,1,2,1,0,32
trying to do,968,34,40,6,5,3,1,89
the art of,968,15,8,0,0,1,0,24
basketball coach at,968,0,0,0,0,0,0,0
and founder of,966,12,7,0,3,3,0,25
is where i,965,33,38,9,2,6,0,88
in real life,964,18,24,2,0,6,0,50
the lives of,959,3,5,0,0,0,1,9
god family and,959,0,0,0,0,0,0,0
for business inquiries,957,49,21,3,5,3,0,81
school class of,957,3,3,0,0,0,0,6
the same time,956,26,44,0,2,5,2,79
for a better,955,16,23,1,2,1,0,43
guy trying to,955,17,0,0,0,0,0,17
girl living in,954,0,42,1,0,2,0,45
me and my,954,8,9,1,2,3,0,23
us army veteran,953,7,9,1,0,0,0,17
of the university,952,9,3,0,0,0,0,12
my best to,951,30,44,7,1,8,2,92
i also like,950,49,29,4,6,0,0,88
you have a,949,22,13,2,4,2,1,44
1 of 1,948,1,5,0,0,0,0,6
http //www instagram,946,17,12,0,1,1,0,31
to be here,945,19,33,4,7,4,1,68
i have the,944,19,28,2,3,4,2,58
i'm here for,944,18,17,2,3,2,0,42
page for the,943,0,0,0,0,0,0,0
thank you for,942,18,21,5,2,0,0,46
of the united,942,6,2,2,0,1,0,11
be the change,940,12,26,0,1,2,0,41
proud of it,940,14,15,5,0,2,1,37
i play video,938,61,31,6,8,9,1,116
only here for,938,5,23,3,0,2,0,33
all you need,937,11,21,3,0,1,0,36
high school class,936,2,1,0,0,0,0,3
spending time with,935,4,4,0,0,0,0,8
try to be,933,47,18,2,4,3,0,74
located in the,933,1,1,0,0,0,0,2
to live in,932,10,28,2,2,2,0,44
and ceo of,932,7,7,1,0,0,0,15
the pursuit of,931,3,5,0,0,0,0,8
social media manager,930,31,74,7,4,5,0,121
is too short,930,6,11,0,0,1,0,18
in search of,929,21,28,2,1,1,0,53
and have a,929,16,13,6,2,2,1,40
twitter for the,928,4,3,1,1,0,0,9
twitter feed of,928,0,1,0,0,0,0,1
i hope you,927,18,19,6,6,3,0,52
child of the,927,8,14,3,2,3,0,30
events and more,927,0,0,0,0,0,0,0
so much more,926,9,25,3,0,4,0,41
wife and mom,926,0,30,0,0,0,0,30
the new york,924,14,6,1,0,0,1,22
just living life,924,10,8,1,0,2,0,21
not to be,923,18,24,5,5,6,0,58
have fun and,923,9,3,3,2,0,1,18
for all your,923,5,5,0,0,0,0,10
me on my,921,2,12,3,2,2,0,21
live your life,918,2,7,2,0,0,0,11
happy to be,917,12,35,3,5,4,0,59
in my bio,917,20,17,6,0,4,1,48
a small town,917,5,21,4,0,1,1,32
associate professor of,914,38,40,4,0,3,0,85
i like the,914,28,35,5,1,5,2,76
time to time,913,30,21,5,4,0,2,62
born in the,911,16,17,4,2,2,1,42
lover of books,910,17,95,1,1,1,0,115
the latest news,909,0,0,0,0,0,0,0
born raised in,908,10,16,0,0,1,0,27
executive director of,907,14,24,0,0,2,0,40
to see the,907,7,6,0,0,1,0,14
out my youtube,906,17,9,2,0,0,0,28
and love to,905,3,9,3,1,0,1,17
some of the,905,9,5,0,0,2,0,16
gmail com http,904,32,34,10,4,6,1,87
and i'm a,904,16,15,9,2,1,1,44
in the middle,903,6,24,3,1,2,0,36
to a beautiful,903,8,6,0,0,0,0,14
here to have,902,15,16,4,2,2,2,41
a red state,900,9,41,0,0,0,0,50
is what i,900,14,17,0,0,1,0,32
me and i,900,1,7,1,0,2,0,11
http //www facebook,900,2,3,0,0,0,0,5
this is where,898,30,38,10,1,8,0,87
me in the,898,15,25,3,2,2,0,47
trying my best,896,70,92,21,9,25,1,218
check it out,894,24,9,1,3,3,0,40
husband and dad,894,27,0,0,0,0,0,27
quality of life,891,1,4,0,0,0,0,5
we are an,891,0,0,0,0,0,0,0
director of the,890,13,24,2,1,2,0,42
mother of 4,890,0,13,0,0,0,0,13
i feel like,889,21,24,2,6,1,0,54
youtube http //youtube,889,22,13,2,1,2,0,40
dad of 3,889,15,0,0,0,0,0,15
they call me,888,15,14,5,2,1,0,37
life in the,888,5,17,3,0,1,0,26
most of my,887,30,18,3,4,5,1,61
life one day,886,5,11,2,3,1,1,23
a collection of,885,8,13,3,1,0,0,25
based out of,885,10,3,1,1,0,0,15
hall of fame,885,7,4,0,0,1,0,12
but you can,884,25,27,6,2,10,6,76
and trying to,883,21,28,3,3,1,1,57
my life and,883,5,13,1,1,2,0,22
http //www twitch,882,20,11,2,2,3,0,38
for a reason,882,4,11,0,0,0,0,15
in order to,881,4,6,1,0,0,0,11
do all things,881,1,4,0,0,0,0,5
be a better,880,26,31,0,2,4,0,63
from time to,880,30,19,5,4,0,2,60
for the people,880,16,22,3,2,1,1,45
in las vegas,880,7,5,1,0,0,0,13
your own risk,878,17,13,3,4,2,1,40
what you do,878,5,5,0,0,0,0,10
in the u,875,6,5,0,1,1,0,13
out of my,874,15,31,1,2,3,1,53
for the latest,871,0,1,0,0,0,0,1
all of my,869,21,26,6,3,3,0,59
what you see,869,7,10,1,0,0,2,20
sign up for,869,7,7,0,0,1,0,15
of a kind,869,1,3,0,0,3,0,7
all types of,868,4,5,1,1,0,0,11
can do all,868,2,5,0,0,0,0,7
the grace of,867,7,3,0,0,2,0,12
that i am,866,9,20,2,0,1,0,32
would like to,865,12,13,1,2,3,1,32
i work in,864,33,32,5,0,4,0,74
in life is,864,10,14,0,2,0,0,26
for all of,864,8,6,0,0,1,0,15
at the end,863,11,17,4,1,2,0,35
love to read,863,6,22,0,0,0,0,28
my pronouns are,861,41,49,36,7,17,8,158
for those who,861,9,12,2,1,1,1,26
to talk to,860,26,20,10,0,0,0,56
just an average,859,15,7,2,0,0,1,25
i stream on,856,34,18,10,1,3,5,71
going to be,856,10,25,5,0,0,0,40
us on instagram,856,0,1,0,0,0,0,1
a full service,856,0,0,0,0,0,0,0
follow me if,854,30,18,5,1,1,1,56
end of the,853,15,11,3,1,3,0,33
to do with,852,14,15,2,0,8,0,39
to each other,851,73,42,7,5,2,2,131
a girl who,851,4,44,0,1,3,0,52
guy who likes,848,38,0,1,2,0,0,41
in the end,848,8,17,2,1,2,0,30
free to dm,846,45,27,8,4,1,1,86
justice for all,845,12,28,1,1,0,0,42
to learn more,845,5,8,0,0,2,0,15
the ohio state,844,10,13,0,1,0,0,24
not a bot,843,13,17,3,0,1,0,34
you can do,842,5,12,2,1,0,0,20
dad of 2,841,27,0,0,1,0,0,28
have to be,841,9,13,2,2,0,0,26
is the greatest,841,8,10,0,0,0,0,18
stand with ukraine,838,31,26,7,1,6,0,71
mom to 3,838,0,29,0,0,1,0,30
real estate professional,835,0,1,0,0,0,0,1
girl who loves,834,1,32,0,0,2,0,35
now living in,834,10,5,1,0,0,1,17
in my head,833,18,33,5,4,4,1,65
is the way,833,18,11,3,0,2,1,35
a better world,832,25,22,4,4,1,1,57
is in the,832,10,7,3,1,3,0,24
back the blue,832,0,1,0,0,0,0,1
the world one,831,9,13,2,0,0,1,25
with my family,831,3,6,0,0,0,0,9
live in a,830,19,15,3,1,4,0,42
in the united,829,6,3,0,1,0,0,10
at university of,828,32,28,2,0,1,1,64
give me a,828,20,12,2,1,1,1,37
you are not,828,12,15,3,2,2,0,34
and my family,826,3,7,0,0,0,0,10
is a non-profit,824,0,0,0,0,0,0,0
trying to survive,823,24,38,5,2,3,0,72
to see here,823,8,15,3,1,2,1,30
a man of,823,8,2,0,0,0,0,10
the best in,822,1,1,0,2,0,1,5
is the most,821,5,20,3,1,1,0,30
in front of,820,21,24,5,1,2,0,53
this page is,820,10,8,3,1,2,1,25
i have an,819,25,24,5,4,7,2,67
the best i,817,20,18,3,1,1,0,43
the one and,817,13,13,0,2,1,0,29
university of texas,816,9,15,0,0,0,0,24
3 5 gpa,816,0,0,0,0,0,0,0
best i can,815,20,21,4,2,1,0,48
cash app account,815,0,0,0,0,0,0,0
just a kid,814,11,4,0,3,3,0,21
to your cash,813,0,0,0,0,0,0,0
i got a,811,12,18,4,2,3,0,39
guy with a,810,24,1,0,0,0,0,25
of my tweets,809,23,21,3,3,3,0,53
doing my best,808,29,75,15,5,9,1,134
as i can,807,18,20,0,2,2,0,42
there is a,807,13,13,1,1,0,0,28
my family my,807,2,4,0,0,0,0,6
what i am,806,15,23,3,1,0,0,42
friends and family,806,9,7,0,1,0,0,17
trust the process,806,6,5,0,0,0,0,11
one of a,805,1,3,0,0,3,0,7
to build a,804,7,4,0,1,0,0,12
of the people,801,11,6,2,2,1,0,22
i am me,801,9,7,2,0,1,0,19
in the city,800,9,9,1,0,0,1,20
those of my,799,47,50,4,3,3,2,109
thoughts and opinions,799,48,44,1,5,2,1,101
need to be,799,11,17,2,0,1,0,31
is like a,799,2,5,2,3,0,0,12
grace of god,799,3,2,0,0,2,0,7
up to date,799,1,2,0,0,1,0,4
news alerts events,799,0,0,0,0,0,0,0
alerts events and,799,0,0,0,0,0,0,0
i do is,798,10,32,7,5,9,1,64
to be happy,798,6,21,1,1,4,0,33
here i am,795,19,22,7,0,4,0,52
of 2 boys,795,2,7,0,0,0,0,9
christ follower husband,795,2,0,0,0,0,0,2
father husband and,794,8,0,0,0,0,0,8
like to play,790,25,22,1,1,2,0,51
you make it,790,5,13,0,0,0,0,18
father of 5,790,0,0,0,0,0,0,0
don't follow me,789,23,18,3,1,4,1,50
and owner of,789,8,9,2,2,1,0,22
your real estate,788,0,0,0,0,0,0,0
us on facebook,788,0,0,0,0,0,0,0
like video games,787,94,41,12,6,9,0,162
don’t know what,787,20,32,3,1,7,2,65
to create a,787,4,7,3,0,2,0,16
u s navy,787,6,1,0,0,0,1,8
a lot about,785,44,62,11,2,9,0,128
local news alerts,785,0,0,0,0,0,0,0
just a small,784,6,24,6,0,3,1,40
the voice of,784,7,5,1,0,0,0,13
love video games,783,34,10,4,5,5,1,59
master of none,783,27,18,5,1,2,0,53
gmail com ig,783,3,6,0,0,2,0,11
make it in,782,10,8,3,2,3,0,26
proud dad of,782,7,0,0,0,0,1,8
john 3 16,782,2,3,0,0,0,1,6
for the future,781,5,6,1,0,0,0,12
good vibes only,780,10,5,1,0,3,0,19
man of god,780,1,0,0,0,0,0,1
of the day,779,10,9,2,3,0,0,24
that loves to,779,7,9,1,0,1,1,19
most of all,779,8,6,2,1,0,2,19
the next generation,779,3,7,0,0,1,0,11
boston sports fan,778,14,12,0,0,0,0,26
air force veteran,778,12,9,1,0,1,0,23
just for fun,775,7,5,1,1,1,1,16
life is what,774,1,3,0,0,0,0,4
hello my name,773,15,16,8,1,3,2,45
i'm also a,771,17,14,2,1,1,2,37
working on my,770,20,32,4,4,0,0,60
discord https //discord,770,14,6,2,3,2,1,28
up in the,770,7,17,2,0,1,0,27
keep up with,767,10,17,1,1,2,0,31
so you can,767,5,8,0,0,0,0,13
sports fan and,766,12,3,1,1,0,0,17
and of course,766,8,7,0,0,0,0,15
all i do,765,9,32,8,5,10,1,65
the world to,765,7,13,2,2,1,0,25
of the american,765,3,6,1,0,0,0,10
some of my,764,22,23,6,4,1,1,57
with a big,764,9,15,2,0,3,1,30
mom to 2,763,0,50,1,0,2,0,53
to be better,763,25,16,0,5,1,0,47
to make you,763,10,18,3,0,0,1,32
father son brother,762,3,0,0,0,0,0,3
may not be,761,19,23,4,4,4,1,55
the link in,761,4,12,3,0,1,1,21
looking forward to,761,8,8,1,0,0,1,18
a group of,761,4,2,0,0,1,1,8
in all things,760,8,20,0,3,3,0,34
be able to,760,7,9,1,0,3,0,20
in my heart,759,10,18,1,0,4,0,33
to make my,758,26,17,2,5,1,0,51
on my mind,758,12,13,0,1,2,0,28
high school sports,758,2,0,0,0,0,0,2
is to provide,758,0,0,0,0,0,0,0
all of your,757,3,2,0,0,0,1,6
3 8 gpa,757,0,0,0,0,0,0,0
born and bred,756,7,15,0,0,3,0,25
student of life,756,4,15,0,0,0,0,19
we have a,756,4,9,0,0,0,0,13
by the grace,755,7,2,0,0,2,0,11
over 30 years,755,1,2,0,0,0,0,3
can find me,754,8,23,4,2,3,2,42
too short to,754,4,11,0,1,2,0,18
no idea what,753,31,53,9,10,7,2,112
wife mother and,753,0,8,0,0,0,0,8
is the key,753,2,2,0,0,1,0,5
are human rights,751,165,134,22,7,15,6,349
is just a,751,13,15,4,0,2,1,35
utm medium copy,750,1,7,0,1,0,0,9
ohio state university,749,8,17,0,1,1,0,27
in the state,749,4,3,2,2,0,0,11
time with my,748,7,3,0,0,0,0,10
my own opinions,747,34,37,5,1,1,0,78
to meet you,747,32,24,2,5,5,2,70
my own retweets,746,19,23,1,1,1,1,46
to help people,746,11,6,0,0,0,0,17
proud husband and,746,5,0,0,1,0,0,6
a good day,744,24,17,6,0,5,1,53
of life and,744,4,8,0,0,0,1,13
i need to,743,17,20,3,1,3,0,44
views of my,742,42,35,2,2,0,0,81
you don't like,742,7,14,1,1,2,1,26
and host of,741,23,8,0,0,0,0,31
me out on,740,14,9,3,1,1,0,28
mother of three,740,0,21,0,0,1,0,22
i love sports,740,6,2,1,0,0,0,9
pursuit of happiness,740,1,6,0,0,1,0,8
special education teacher,739,5,17,0,0,0,1,23
owner of a,738,20,25,3,4,2,0,54
my own opinion,738,22,27,0,2,1,1,53
and a little,738,14,26,2,1,5,0,48
a simple man,738,13,0,0,2,0,1,16
over the world,738,4,9,0,0,0,0,13
a man who,738,11,0,0,1,0,0,12
love to laugh,737,2,7,0,0,1,0,10
nothing to see,735,5,14,2,1,2,1,25
streamer http //twitch,733,29,15,9,0,3,1,57
for the next,733,5,7,2,0,1,0,15
now on all,733,6,4,0,1,0,1,12
to keep up,732,10,19,1,1,3,0,34
you are a,732,15,11,1,1,2,0,30
the only way,732,7,11,6,0,2,0,26
and other stuff,731,45,25,6,2,3,0,81
philly sports fan,730,11,8,0,0,1,0,20
citizen of the,730,7,10,0,1,1,0,19
don’t be late,730,0,0,0,0,0,0,0
is a leading,730,0,0,0,0,0,0,0
working on a,729,32,29,9,7,3,2,82
trades master of,729,25,15,4,1,2,0,47
learn how to,729,9,4,0,2,0,0,15
love god love,729,2,6,1,0,0,0,9
and proud of,727,11,9,5,0,1,0,26
of all time,727,12,9,3,0,0,0,24
believer in the,725,10,22,1,0,3,0,36
way too much,724,45,54,6,6,6,0,117
i work for,724,28,23,1,1,1,2,56
in the future,724,12,23,2,1,3,1,42
with a focus,723,16,19,3,0,1,0,39
a focus on,723,15,18,3,0,1,0,37
what you make,723,1,6,0,0,1,0,8
visit my website,723,1,2,1,0,0,0,4
rights are human,722,161,132,22,7,14,5,341
what i'm doing,722,27,52,9,6,7,2,103
views and opinions,722,34,30,5,2,0,0,71
to make friends,722,28,23,2,4,5,0,62
to live life,721,6,12,2,0,0,0,20
all things through,721,1,4,0,0,0,0,5
to those who,720,6,5,0,0,1,0,12
can help you,720,3,4,0,0,0,0,7
a community of,720,4,0,0,0,0,0,4
st louis cardinals,720,2,1,0,0,1,0,4
work hard play,720,1,2,0,0,0,0,3
supporter of the,719,14,13,0,1,0,0,28
just a normal,718,11,7,1,1,0,0,20
day by day,718,5,7,3,0,1,0,16
life is to,717,4,17,1,2,0,0,24
would love to,717,12,7,1,2,1,0,23
of video games,716,73,42,9,6,5,1,136
love to play,716,9,9,1,1,0,0,20
for more than,716,0,3,1,0,0,0,4
is committed to,716,0,0,0,0,0,0,0
for the memes,715,15,19,1,1,1,0,37
to do the,715,14,13,2,0,1,0,30
is not monitored,715,0,0,0,0,0,0,0
the official page,714,0,0,0,0,0,0,0
lover of god,713,1,5,0,0,0,0,6
united states of,713,1,2,0,0,0,0,3
let me know,712,18,11,4,4,1,0,38
are the best,712,17,14,0,0,2,0,33
in the south,711,12,28,1,0,1,1,43
ig http //instagram,711,12,19,2,1,1,0,35
i do what,711,3,12,2,0,1,0,18
non-metro need help,711,0,0,0,0,0,0,0
views expressed here,710,26,25,1,0,5,0,57
want to make,710,22,13,3,2,4,0,44
looking to make,710,29,8,3,2,0,0,42
not here to,709,7,17,1,0,3,0,28
the most beautiful,708,3,9,2,0,2,0,16
is my personal,707,21,29,4,1,3,1,59
in real estate,707,0,0,0,0,0,0,0
equality for all,706,17,28,1,1,0,0,47
real estate and,706,2,2,0,0,0,0,4
with the best,705,4,6,1,0,0,0,11
medium copy link,705,1,7,0,1,0,0,9
me with your,705,2,3,1,0,0,0,6
i like video,704,87,34,12,5,7,0,145
don't know what,704,19,20,6,4,4,0,53
that likes to,704,24,13,8,0,4,0,49
not here for,704,4,18,3,0,3,0,28
and surrounding areas,704,0,0,0,0,0,0,0
mom to a,703,0,61,0,0,2,0,63
dm me to,703,13,14,3,4,1,0,35
i do it,703,10,10,2,0,2,0,24
know what to,702,14,16,0,4,1,1,36
adult content creator,702,7,11,4,4,1,0,27
my own rt,700,28,32,3,1,2,0,66
when i was,700,11,16,3,0,4,0,34
side of the,700,13,14,2,1,3,1,34
phil 4 13,700,0,3,0,0,0,0,3
amante de la,700,0,1,0,0,0,0,1
looking for some,699,11,5,1,0,0,0,17
in your life,699,6,7,1,0,0,0,14
i don't have,698,24,23,4,2,2,0,55
the link to,698,8,13,1,1,3,0,26
no matter how,698,5,8,0,0,1,0,14
my goal is,698,4,5,1,0,1,0,11
leave me alone,697,6,13,4,0,5,0,28
link in my,697,4,11,2,0,2,1,20
1st team all,697,1,0,0,0,0,0,1
to share my,696,15,8,2,1,4,0,30
and if you,696,4,10,1,1,1,0,17
and the world,696,3,8,2,0,2,0,15
it is the,696,3,3,0,0,0,0,6
real estate needs,696,0,0,0,0,0,0,0
live my life,692,4,8,0,2,0,0,14
positive vibes only,692,2,9,0,0,0,0,11
a love for,691,19,17,5,3,3,1,48
i like sports,691,5,4,1,1,1,0,12
family friends and,690,0,2,0,0,0,0,2
lot of things,689,32,39,10,4,6,2,93
to the love,689,9,10,3,0,0,0,22
when it comes,689,4,5,1,1,0,0,11
the way you,688,3,11,1,0,1,0,16
the home of,688,2,1,1,0,0,0,4
to get a,687,15,13,1,3,2,0,34
new to this,687,11,6,1,3,0,0,21
man with a,687,16,1,1,0,0,0,18
where you can,687,2,8,0,0,0,0,10
i live for,686,9,18,6,0,1,0,34
i don’t care,686,7,14,0,0,1,2,24
the way i,686,9,11,1,1,1,0,23
have a great,686,9,6,3,2,0,1,21
love god my,686,0,1,0,0,1,0,2
i need a,685,16,17,3,1,3,0,40
of the universe,685,10,12,1,2,2,0,27
everything in between,685,7,5,0,0,0,0,12
at this point,684,15,38,9,4,7,0,73
don’t follow me,684,12,17,1,0,2,0,32
don't have to,684,9,10,2,2,2,0,25
is to help,684,0,1,0,0,0,0,1
i think i,683,10,27,2,2,2,0,43
on the beach,683,10,7,5,1,3,0,26
18 only nsfw,682,51,22,11,3,7,1,95
i just like,682,27,22,3,3,5,2,62
back to the,682,7,10,0,0,0,0,17
https //m youtube,682,5,2,0,1,0,0,8
currently working on,681,45,17,11,1,4,0,78
to a wonderful,681,8,5,0,0,0,0,13
on the planet,681,4,6,0,0,0,1,11
on http //twitch,680,22,10,7,0,3,1,43
on twitch and,680,17,10,5,1,2,1,36
in san diego,680,7,1,0,1,1,0,10
i make art,679,39,68,28,20,26,4,185
also known as,679,17,25,3,0,9,0,54
years old and,679,14,11,2,1,2,1,31
to be in,679,8,12,3,1,3,0,27
and content creator,678,27,10,3,1,5,0,46
breast cancer survivor,678,0,33,0,0,1,0,34
i don’t have,678,11,14,6,1,1,0,33
a child of,678,4,3,0,0,3,0,10
our goal is,678,0,0,0,0,0,0,0
high school baseball,678,0,0,0,0,0,0,0
to follow me,677,12,7,2,0,2,0,23
blessed to be,677,0,1,0,0,0,0,1
of christ husband,677,0,0,0,0,0,0,0
my own rts,676,23,27,2,1,1,0,54
till i die,676,10,8,1,2,2,1,24
on the way,676,5,9,0,1,2,0,17
father of four,676,11,0,0,0,0,0,11
all views my,675,41,91,6,4,4,1,147
and other things,675,43,35,4,7,2,1,92
just a little,675,21,32,5,9,7,0,74
formerly known as,675,21,17,7,6,4,1,56
i don't care,675,15,13,2,1,1,2,34
voice of the,675,3,2,0,1,0,0,6
you don't have,674,6,10,2,2,1,0,21
over 20 years,674,2,1,0,0,0,0,3
and a good,673,6,13,1,2,2,0,24
believe in god,673,2,2,0,0,0,0,4
organization dedicated to,673,0,0,0,0,0,0,0
from around the,672,1,2,0,0,0,0,3
high school c/o,671,0,0,0,0,0,0,0
listen to my,670,20,11,3,4,4,0,42
years in the,670,5,2,1,0,0,0,8
bit of a,669,33,28,6,5,2,0,74
all trades master,669,23,14,4,1,2,0,44
to find my,669,14,15,3,3,4,0,39
up and coming,669,14,3,2,0,4,0,23
married father of,669,11,0,0,0,0,0,11
like to make,668,26,24,5,1,5,0,61
on the road,668,1,7,3,1,0,0,12
of your life,667,8,11,0,0,1,0,20
just looking for,666,8,3,2,0,0,0,13
university of south,665,4,9,0,1,0,0,14
a world of,664,10,10,3,0,2,0,25
what you love,664,9,15,0,0,0,0,24
to find the,664,8,13,2,0,1,0,24
in the morning,664,9,8,0,1,0,0,18
student of the,664,7,5,0,0,1,0,13
girl with a,663,0,42,1,0,7,0,50
are my life,663,12,13,1,0,1,2,29
a place to,662,12,10,2,0,3,0,27
love the outdoors,662,3,3,0,0,0,0,6
de la vida,662,0,1,0,0,0,0,1
have a lot,661,19,44,4,1,2,0,70
what to do,661,20,14,1,0,5,1,41
but i love,661,12,19,4,1,0,1,37
a k a,661,24,8,0,1,2,1,36
please do not,660,27,51,16,6,11,2,113
i care about,659,18,26,5,4,3,0,56
for fun and,659,19,16,1,1,0,0,37
is my only,659,7,12,2,1,4,0,26
the future is,659,8,9,0,1,2,0,20
we are here,659,2,1,1,0,0,0,4
live love laugh,659,1,0,0,0,0,0,1
ph d student,658,20,37,5,1,3,0,66
nice to meet,658,29,22,2,4,5,2,64
new to the,658,9,8,1,0,2,0,20
son of a,658,15,2,1,0,0,0,18
i like my,657,16,18,4,2,2,0,42
like to be,657,15,19,1,1,5,1,42
who believes in,657,6,9,0,1,0,0,16
is not an,655,14,11,1,2,2,0,30
music is life,655,5,9,1,0,0,0,15
to help others,655,6,5,1,1,0,1,14
of the new,655,5,5,0,0,0,0,10
the best way,654,6,9,1,1,1,0,18
father of a,654,11,0,1,1,0,0,13
glory to god,654,2,0,0,0,0,0,2
my spare time,653,16,16,5,0,1,1,39
of all the,653,8,21,2,2,1,0,34
states of america,653,2,1,0,0,0,0,3
and more we’re,653,0,0,0,0,0,0,0
in need of,652,17,28,1,0,3,0,49
dreams come true,652,2,3,1,1,2,0,9
the mission of,652,0,0,0,0,0,0,0
phd student at,651,49,69,7,4,4,2,135
more than a,651,12,15,0,0,0,1,28
more we’re your,651,0,0,0,0,0,0,0
we’re your source,651,0,0,0,0,0,0,0
was born in,650,6,4,1,0,0,0,11
just a young,650,6,4,1,0,0,0,11
when i can,649,21,12,5,0,4,1,43
is a new,649,2,4,2,1,0,0,9
i help people,648,8,4,0,0,1,0,13
meet new people,647,12,4,0,1,0,0,17
you think you,647,6,4,1,0,2,0,13
love my life,647,0,4,0,0,0,0,4
are my opinion,646,11,10,0,0,0,0,21
the life of,646,5,6,1,0,0,0,12
jesus is my,646,1,0,0,0,0,0,1
love god family,646,0,1,0,0,0,0,1
is a nonprofit,646,0,0,0,0,0,0,0
the right thing,645,11,10,0,0,1,1,23
league of legends,644,36,19,2,5,1,0,63
a work in,644,13,24,3,1,1,0,42
you don’t like,644,9,10,3,0,2,0,24
wife mom and,644,0,14,0,0,0,0,14
family and my,644,2,4,0,0,0,0,6
football coach at,644,0,0,0,0,0,0,0
looking for friends,643,23,12,4,5,0,0,44
we are not,643,3,12,1,1,1,0,18
for you to,643,6,4,5,1,1,0,17
and real estate,643,0,1,0,0,0,0,1
things i like,642,36,20,5,5,6,2,74
new york times,642,23,25,1,1,1,0,51
do it for,642,7,10,1,1,2,0,21
the key to,642,4,1,0,0,2,0,7
to improve the,642,5,2,0,0,0,0,7
a 501 c,642,1,0,0,0,0,0,1
trying to keep,641,12,26,0,2,1,0,41
lost in the,641,12,17,1,2,4,0,36
leader of the,641,14,5,1,0,2,0,22
man trying to,641,16,0,0,2,0,0,18
on all streaming,641,4,3,0,2,2,1,12
if you can't,640,8,12,1,0,0,0,21
crazy cat lady,639,0,100,0,0,5,1,106
hi i am,639,11,10,3,1,3,0,28
and all the,638,13,21,2,2,2,1,41
instagram http //instagram,638,19,16,1,0,1,1,38
with the world,638,9,3,0,0,2,0,14
and mother of,638,1,9,1,0,2,0,13
what we do,637,2,8,1,0,0,0,11
i wish i,636,19,28,3,2,6,3,61
not an endorsement,636,16,5,1,0,2,0,24
i love it,636,6,13,2,0,2,0,23
meeting new people,635,8,4,2,0,1,0,15
it comes to,635,5,5,1,1,0,0,12
joshua 1 9,635,2,2,0,0,0,0,4
play games and,634,35,24,9,3,7,3,81
with a love,634,23,19,7,5,5,1,60
are here to,634,2,2,0,0,0,0,4
things through christ,634,0,2,0,0,0,0,2
all opinions my,633,44,85,7,5,4,1,146
for me to,633,11,20,4,2,2,2,41
no one is,633,9,21,2,1,0,0,33
teacher of the,633,7,20,0,0,0,0,27
a big fan,632,19,16,2,1,0,0,38
daughter of the,632,1,16,0,0,1,0,18
who loves the,632,4,7,1,0,1,0,13
twitter feed for,632,2,0,1,0,0,0,3
just out here,631,13,31,2,0,3,2,51
more than i,631,20,25,3,1,2,0,51
my life i,631,4,11,1,1,0,0,17
am here to,631,3,5,1,0,0,0,9
the department of,631,3,1,0,0,0,0,4
high school in,631,0,1,0,0,0,0,1
3 7 gpa,631,0,0,0,0,0,0,0
and author of,630,12,9,2,0,2,1,26
you know what,630,12,10,0,1,1,0,24
love to cook,630,4,3,0,2,0,0,9
youtube com/watch v,630,3,4,0,1,0,0,8
you are the,628,5,17,0,2,2,0,26
love is the,628,8,10,1,0,0,0,19
social media marketing,627,1,11,1,0,0,0,13
dms always open,626,78,12,10,9,5,1,115
but i do,626,16,18,3,1,3,1,42
and social media,626,12,15,1,1,1,0,30
on my own,626,6,7,3,1,2,0,19
has to offer,626,3,4,1,0,0,0,8
do not follow,625,27,23,16,2,7,2,77
- - -,625,11,13,6,3,6,1,40
will not be,625,10,18,0,0,1,0,29
rock n roll,625,4,12,1,0,1,1,19
life is not,625,5,4,0,0,0,0,9
is my president,625,0,3,1,1,1,0,6
king of the,623,23,9,5,5,0,1,43
i am in,623,12,14,2,3,3,0,34
oh and i,623,18,6,3,1,0,1,29
trying to learn,622,32,14,1,1,1,0,49
here to be,622,12,15,4,4,6,1,42
with a little,622,7,23,1,0,0,0,31
what i love,622,3,8,3,1,0,0,15
the most important,622,4,5,0,0,1,0,10
and i do,621,13,13,7,2,0,1,36
not looking for,621,3,7,1,1,0,0,12
dm if you,620,19,4,3,1,4,1,32
to see in,620,10,15,1,2,4,0,32
tweet at a,620,11,11,1,2,0,1,26
on a journey,620,12,6,1,1,1,0,21
i will never,620,4,10,4,0,2,1,21
hello i am,619,21,12,2,3,3,0,41
my free time,618,18,22,6,0,4,0,50
mom of three,618,0,26,0,0,0,0,26
to my onlyfans,618,4,7,0,0,1,0,12
link below to,617,3,7,0,2,3,0,15
of new york,617,5,7,0,0,0,0,12
follow my instagram,616,7,6,0,1,0,1,15
see in the,615,10,15,2,2,4,0,33
it is a,615,3,4,0,2,1,1,11
love to have,615,2,1,0,0,0,0,3
a real estate,615,0,0,0,0,0,0,0
video game enthusiast,614,49,39,7,4,3,2,104
to put here,614,27,22,2,7,5,1,64
to the next,614,5,3,0,0,1,0,9
god my family,614,0,1,0,0,1,0,2
minding my business,612,0,7,0,0,3,0,10
what you think,612,2,6,0,1,1,0,10
at the intersection,611,13,22,3,1,1,0,40
social studies teacher,611,16,18,1,1,0,0,36
vice president of,611,5,11,1,0,2,0,19
university of kentucky,611,10,9,0,0,0,0,19
of 3 boys,611,2,5,0,0,0,0,7
my own i,610,49,33,2,2,3,1,90
these are my,610,12,23,2,1,3,1,42
mom of a,610,0,30,0,0,2,0,32
in san francisco,609,13,14,0,0,2,0,29
you follow me,609,9,14,1,1,1,2,28
is going to,609,7,6,1,1,1,0,16
doing what i,608,10,7,1,2,0,0,20
meant to be,608,5,10,2,0,0,0,17
the things i,607,13,17,2,1,3,1,37
waiting for the,607,14,10,0,1,0,0,25
is all about,607,2,6,0,2,0,2,12
and loving it,606,11,6,2,0,1,1,21
i love being,606,6,8,1,1,1,0,17
founder and ceo,606,4,6,0,0,0,0,10
love my kids,606,2,7,0,0,0,0,9
a guy that,606,8,1,0,0,0,0,9
like to draw,605,34,46,15,3,19,2,119
to get my,605,10,16,3,1,3,0,33
ref wl share,605,8,15,4,1,0,0,28
will be the,604,7,3,1,1,0,0,12
health and wellness,604,0,4,0,0,0,0,4
is the future,604,1,1,1,0,0,0,3
is not the,603,7,15,0,0,0,1,23
lover of jesus,603,3,8,0,0,0,0,11
avid sports fan,603,3,3,0,0,0,0,6
of 2 beautiful,603,1,3,0,0,0,0,4
daughter sister friend,602,0,19,1,0,0,0,20
love the lord,602,2,1,0,0,0,0,3
a person who,601,10,11,6,2,4,0,33
red sox fan,601,6,20,0,0,2,0,28
the bay area,601,16,8,0,1,2,0,27
u s a,601,4,9,0,0,0,0,13
is an independent,601,1,0,1,0,1,0,3
to my twitter,600,13,8,4,1,0,0,26
what makes you,600,8,9,0,1,1,1,20
seeker of truth,600,3,10,0,0,0,1,14
for the love,599,7,16,1,1,1,1,27
rock and roll,599,10,11,0,1,0,0,22
my country and,599,3,0,0,0,0,0,3
you know the,598,10,11,1,0,1,0,23
proverbs 3 5-6,598,0,2,0,0,0,0,2
are always open,597,42,25,9,7,6,0,89
still trying to,597,13,27,1,1,1,0,43
i am very,597,11,23,4,1,3,0,42
on here to,597,13,10,2,0,3,2,30
a good person,597,16,9,1,1,3,0,30
to get to,597,8,8,2,3,0,0,21
lord and savior,597,2,5,0,0,3,0,10
learn more about,597,5,2,0,1,0,0,8
love me some,596,12,15,2,3,0,0,32
like what i,595,13,7,1,0,1,0,22
the right to,595,4,7,1,0,2,0,14
available on all,595,5,3,0,0,1,0,9
dm me with,595,4,2,0,0,0,0,6
are my opinions,594,13,13,0,1,1,0,28
don't want to,594,8,13,1,0,5,1,28
to meet new,594,10,4,1,1,1,0,17
do the same,594,7,8,0,0,0,0,15
de coraz n,594,1,0,0,1,0,0,2
the oxford comma,593,30,81,2,1,5,1,120
a great day,592,6,10,2,2,0,2,22
3 0 gpa,592,0,0,0,0,0,0,0
content creator and,591,22,8,2,2,0,0,34
and so much,590,6,16,1,0,2,0,25
and everything in,590,5,4,0,0,0,0,9
the american dream,590,5,4,0,0,0,0,9
a full time,589,5,17,2,0,2,0,26
if you do,589,4,13,0,0,0,0,17
dms open for,588,34,16,12,7,9,2,80
here to learn,588,11,24,0,1,1,0,37
you don't know,588,7,4,1,2,0,0,14
men and women,588,3,2,0,0,1,0,6
the good life,588,3,2,0,0,0,0,5
can be found,587,20,15,7,1,5,0,48
youtube https //www,587,7,3,1,2,0,0,13
join me on,587,3,7,2,1,0,0,13
ph d candidate,586,26,60,4,0,5,1,96
i wanna be,586,14,24,3,1,4,0,46
fall in love,586,5,22,3,2,3,1,36
a mother of,586,0,4,0,0,0,0,4
in the country,586,1,2,0,0,0,0,3
my way through,585,17,19,2,2,4,1,45
once in a,585,12,23,0,2,6,0,43
on twitch http,585,20,10,3,2,1,0,36
lover of animals,585,2,31,0,0,2,0,35
that is all,585,6,15,0,1,0,1,23
proud mother of,585,1,12,0,0,0,0,13
s s s,585,1,5,2,0,0,0,8
county high school,585,0,1,0,0,0,0,1
small town girl,584,1,23,1,0,1,0,26
to live a,584,10,12,1,0,0,0,23
the land of,584,8,7,2,0,0,0,17
have fun with,584,2,7,1,0,0,0,10
the people of,583,8,4,1,0,0,0,13
los angeles ca,583,3,4,0,0,2,0,9
what to put,582,19,14,2,5,3,1,44
and creator of,582,12,15,1,1,1,1,31
in the link,582,11,7,3,0,4,0,25
school of medicine,582,7,11,0,1,0,0,19
of the king,582,0,3,0,0,0,0,3
high school athletics,581,0,0,0,0,0,0,0
striving to be,580,13,18,1,0,2,0,34
http //www youtube,580,3,4,0,0,0,0,7
the change you,579,4,14,0,1,1,0,20
founder ceo of,579,7,11,0,1,0,0,19
in the moment,579,2,7,1,0,1,0,11
in my spare,578,15,16,4,0,1,1,37
i also have,578,18,6,1,0,2,3,30
all streaming platforms,577,3,3,0,1,2,1,10
podcast hosted by,577,4,5,0,0,0,0,9
i will follow,577,3,1,1,0,0,1,6
keep it real,577,0,5,1,0,0,0,6
me i follow,577,1,3,0,0,0,0,4
advocate for the,576,6,13,0,0,0,0,19
and having fun,576,8,7,0,0,1,0,16
proud owner of,575,19,10,3,3,4,0,39
the name of,575,12,7,1,0,3,0,23
my old account,575,8,9,1,1,2,0,21
i love animals,574,1,22,0,0,2,0,25
old enough to,573,17,24,3,2,0,0,46
no one can,573,5,12,3,0,0,0,20
i love life,573,4,6,0,0,0,0,10
as seen on,572,18,9,1,0,3,0,31
to do it,572,10,6,3,0,0,0,19
the world with,572,3,6,0,0,1,0,10
to live my,571,7,22,3,1,0,0,33
ceo of the,571,6,12,0,0,1,0,19
love god and,571,3,6,0,0,0,0,9
i know you,570,9,18,3,1,1,0,32
it's all about,570,6,4,1,0,1,0,12
i do art,569,44,54,35,16,19,7,175
all the things,569,14,48,1,1,1,1,66
not reflect the,569,24,29,4,1,0,0,58
am also a,569,14,5,0,1,0,0,20
peace love and,569,6,5,1,2,1,0,15
i'm just me,569,3,6,1,1,1,0,12
believe in yourself,569,5,3,0,0,1,0,9
one of my,568,6,15,1,2,3,0,27
life long learner,568,4,9,0,0,1,0,14
https //music apple,568,1,0,0,0,0,0,1
head baseball coach,568,0,0,0,0,0,0,0
in the midwest,567,21,19,2,0,6,2,50
twitch affiliate http,566,22,11,1,4,1,0,39
makes you happy,566,7,10,1,1,1,1,21
wife mom grandma,566,0,9,0,0,0,0,9
phd candidate in,565,34,65,6,3,6,1,115
and pop culture,565,28,27,2,1,3,0,61
of the game,565,8,2,0,0,1,2,13
star wars fan,564,40,18,1,1,0,0,60
me to be,564,7,8,2,0,3,1,21
life is like,564,3,5,1,2,1,0,12
next generation of,564,3,5,0,0,0,0,8
want to do,563,14,11,2,1,2,1,31
just having fun,563,9,5,1,2,1,1,19
founder of http,563,10,8,0,0,0,0,18
and loving life,563,0,5,0,1,0,0,6
b s in,562,12,19,2,2,5,0,40
person of the,562,18,9,1,0,1,0,29
wife of a,562,0,15,1,0,1,0,17
we live in,562,9,4,1,0,1,1,16
of two beautiful,562,4,2,0,0,1,0,7
the quality of,562,4,1,0,0,0,1,6
follow if you,561,14,13,6,3,3,3,42
like to have,561,5,4,1,0,0,0,10
and father to,561,6,0,0,0,0,0,6
opinions expressed here,560,28,22,2,1,0,5,58
give a fuck,560,6,5,3,1,0,0,15
to find out,560,1,5,3,1,0,0,10
the life you,560,2,5,0,0,0,0,7
old account got,560,3,3,0,0,1,0,7
are not financial,560,1,1,0,0,0,0,2
to dm me,559,19,11,5,3,1,0,39
the little things,559,7,18,1,0,1,0,27
mother of a,559,0,9,0,0,2,0,11
husband father brother,559,9,0,0,1,0,0,10
a m university,559,3,3,2,0,0,0,8
dedicated to providing,559,0,0,0,0,0,0,0
securities offered through,559,0,0,0,0,0,0,0
im just a,558,5,13,4,4,2,0,28
d m v,558,5,8,2,0,2,0,17
it to the,558,3,6,0,2,0,0,11
21 years old,557,38,19,4,1,6,3,71
proud supporter of,557,10,9,4,0,0,0,23
at https //www,557,7,3,1,0,0,0,11
go pack go,556,6,7,0,0,0,0,13
and you will,556,6,3,1,0,1,0,11
husband to an,556,8,0,0,0,0,0,8
looking for my,555,22,10,2,2,2,0,38
me i am,555,3,11,5,1,2,0,22
to get the,555,3,10,1,0,0,0,14
way of life,555,3,5,1,0,0,0,9
is the leading,555,0,0,0,0,0,0,0
lover of nature,554,5,19,1,0,1,0,26
here to share,554,13,7,2,1,1,0,24
psalm 46 5,554,0,7,0,0,1,0,8
my own views,553,37,25,1,1,4,0,68
kind of a,553,31,30,3,3,0,0,67
a way to,553,5,7,0,0,0,0,12
god is great,553,1,1,0,0,0,0,2
video games i,552,29,13,3,3,3,0,51
with my wife,552,16,3,1,1,2,0,23
i can help,552,5,5,0,0,0,0,10
the beauty of,552,1,7,0,1,0,0,9
for a free,552,2,1,0,0,2,0,5
to see what,551,5,11,1,0,3,0,20
for the city,551,0,3,0,0,0,0,3
a regular guy,550,10,0,0,0,0,0,10
a difference in,550,0,6,1,0,0,0,7
business owner and,550,0,7,0,0,0,0,7
telegram https //t,550,3,1,0,0,0,0,4
i really like,549,31,39,7,7,9,3,96
software engineer at,549,60,14,2,2,1,4,83
one of those,549,22,22,8,2,7,0,61
looking for new,549,14,12,2,2,2,0,32
but if you,549,4,8,1,0,1,1,15
freedom of speech,549,2,0,1,0,0,0,3
god bless the,549,0,0,0,0,0,0,0
assistant professor at,548,37,32,0,2,0,0,71
this is an,548,22,24,9,1,5,2,63
my thoughts are,548,22,32,2,1,4,0,61
know what i,548,11,16,1,0,2,1,31
and many more,548,9,12,1,1,1,0,24
sub to my,548,3,9,0,0,5,0,17
to be with,548,1,5,1,0,1,0,8
us navy veteran,548,4,0,2,0,0,0,6
in the universe,547,17,4,0,2,1,0,24
trying to stay,547,8,12,3,0,0,0,23
we the people,547,3,0,0,0,0,0,3
a world where,546,7,12,2,0,1,0,22
great state of,546,3,1,1,0,0,0,5
crypto and nft,546,0,0,0,0,0,0,0
account don’t be,546,0,0,0,0,0,0,0
i go by,545,24,34,15,14,10,5,102
lover of dogs,545,10,40,1,0,1,0,52
of my favorite,545,7,16,1,1,0,0,25
out now link,545,8,3,3,0,1,0,15
you don’t know,545,4,3,1,1,2,0,11
